"Season","team","tier","gameno","Cumpts","CumGF","CumGA","CumGD","pts.pg","GF.pg","GA.pg","GD.pg","england_position","league_position","total_teams_in_league","adjusted_league_bottom","next_year","number_of_seasons","change","moving_change"
1888,"Accrington F.C.",1,22,26,48,48,0,1.18181818181818,2.18181818181818,2.18181818181818,0,8,8,12,12,6,5,2,NA
1888,"Aston Villa",1,22,41,61,43,18,1.86363636363636,2.77272727272727,1.95454545454545,0.818181818181818,2,2,12,12,9,121,-7,0.1
1888,"Blackburn Rovers",1,22,36,66,45,21,1.63636363636364,3,2.04545454545455,0.954545454545455,4,4,12,12,3,121,1,-0.2
1888,"Bolton Wanderers",1,22,32,63,59,4,1.45454545454545,2.86363636363636,2.68181818181818,0.181818181818182,5,5,12,12,8,121,-3,-1.2
1888,"Burnley",1,22,24,42,62,-20,1.09090909090909,1.90909090909091,2.81818181818182,-0.909090909090909,9,9,12,12,11,121,-2,0.6
1888,"Derby County",1,22,23,41,61,-20,1.04545454545455,1.86363636363636,2.77272727272727,-0.909090909090909,10,10,12,12,7,121,3,0
1888,"Everton",1,22,29,35,46,-11,1.31818181818182,1.59090909090909,2.09090909090909,-0.5,7,7,12,12,2,121,5,0.3
1888,"Notts County",1,22,17,40,73,-33,0.772727272727273,1.81818181818182,3.31818181818182,-1.5,11,11,12,12,10,120,1,0.3
1888,"Preston North End",1,22,58,74,15,59,2.63636363636364,3.36363636363636,0.681818181818182,2.68181818181818,1,1,12,12,1,121,0,-1.4
1888,"Stoke City",1,22,16,26,51,-25,0.727272727272727,1.18181818181818,2.31818181818182,-1.13636363636364,12,12,12,12,12,113,0,0.2
1888,"West Bromwich Albion",1,22,32,40,46,-6,1.45454545454545,1.81818181818182,2.09090909090909,-0.272727272727273,6,6,12,12,4,121,2,-0.7
1888,"Wolverhampton Wanderers",1,22,40,50,37,13,1.81818181818182,2.27272727272727,1.68181818181818,0.590909090909091,3,3,12,12,5,121,-2,-0.6
1889,"Accrington F.C.",1,22,33,53,56,-3,1.5,2.40909090909091,2.54545454545455,-0.136363636363636,6,6,12,12,10,5,-4,NA
1889,"Aston Villa",1,22,26,43,51,-8,1.18181818181818,1.95454545454545,2.31818181818182,-0.363636363636364,9,9,12,12,9,121,0,0.8
1889,"Blackburn Rovers",1,22,39,78,41,37,1.77272727272727,3.54545454545455,1.86363636363636,1.68181818181818,3,3,12,12,6,121,-3,-1
1889,"Bolton Wanderers",1,22,28,54,65,-11,1.27272727272727,2.45454545454545,2.95454545454545,-0.5,8,8,12,12,4,121,4,-1.2
1889,"Burnley",1,22,17,36,65,-29,0.772727272727273,1.63636363636364,2.95454545454545,-1.31818181818182,11,11,12,12,8,121,3,-0.5
1889,"Derby County",1,22,30,43,55,-12,1.36363636363636,1.95454545454545,2.5,-0.545454545454545,7,7,12,12,11,121,-4,0.2
1889,"Everton",1,22,45,65,40,25,2.04545454545455,2.95454545454545,1.81818181818182,1.13636363636364,2,2,12,12,1,121,1,-0.9
1889,"Notts County",1,22,23,43,51,-8,1.04545454545455,1.95454545454545,2.31818181818182,-0.363636363636364,10,10,12,12,5,120,5,-0.7
1889,"Preston North End",1,22,48,71,30,41,2.18181818181818,3.22727272727273,1.36363636363636,1.86363636363636,1,1,12,12,2,121,-1,-1.4
1889,"Stoke City",1,22,13,27,69,-42,0.590909090909091,1.22727272727273,3.13636363636364,-1.90909090909091,12,12,12,12,13,113,-1,-0.4
1889,"West Bromwich Albion",1,22,36,47,50,-3,1.63636363636364,2.13636363636364,2.27272727272727,-0.136363636363636,4,4,12,12,12,121,-8,-1
1889,"Wolverhampton Wanderers",1,22,35,51,38,13,1.59090909090909,2.31818181818182,1.72727272727273,0.590909090909091,5,5,12,12,3,121,2,0.1
1890,"Accrington F.C.",1,22,22,28,50,-22,1,1.27272727272727,2.27272727272727,-1,10,10,12,12,11,5,-1,NA
1890,"Aston Villa",1,22,25,45,58,-13,1.13636363636364,2.04545454545455,2.63636363636364,-0.590909090909091,9,9,12,12,4,121,5,-0.5
1890,"Blackburn Rovers",1,22,35,52,43,9,1.59090909090909,2.36363636363636,1.95454545454545,0.409090909090909,6,6,12,12,9,121,-3,-0.4
1890,"Bolton Wanderers",1,22,37,47,34,13,1.68181818181818,2.13636363636364,1.54545454545455,0.590909090909091,4,4,12,12,3,121,1,-0.5
1890,"Burnley",1,22,30,52,63,-11,1.36363636363636,2.36363636363636,2.86363636363636,-0.5,8,8,12,12,6,121,2,-1.3
1890,"Derby County",1,22,22,47,81,-34,1,2.13636363636364,3.68181818181818,-1.54545454545455,11,11,12,12,10,121,1,-0.1
1890,"Everton",1,22,43,63,29,34,1.95454545454545,2.86363636363636,1.31818181818182,1.54545454545455,1,1,12,12,5,121,-4,-0.5
1890,"Notts County",1,22,37,52,35,17,1.68181818181818,2.36363636363636,1.59090909090909,0.772727272727273,5,5,12,12,7,120,-2,0.3
1890,"Preston North End",1,22,39,44,23,21,1.77272727272727,2,1.04545454545455,0.954545454545455,2,2,12,12,2,121,0,-1.5
1890,"Sunderland",1,22,35,51,31,20,1.59090909090909,2.31818181818182,1.40909090909091,0.909090909090909,7,7,12,12,1,119,6,0.4
1890,"West Bromwich Albion",1,22,17,34,57,-23,0.772727272727273,1.54545454545455,2.59090909090909,-1.04545454545455,12,12,12,12,12,121,0,-0.6
1890,"Wolverhampton Wanderers",1,22,38,39,50,-11,1.72727272727273,1.77272727272727,2.27272727272727,-0.5,3,3,12,12,8,121,-5,-1.2
1891,"Accrington F.C.",1,26,28,40,78,-38,1.07692307692308,1.53846153846154,3,-1.46153846153846,11,11,14,14,15,5,-4,NA
1891,"Aston Villa",1,26,45,89,56,33,1.73076923076923,3.42307692307692,2.15384615384615,1.26923076923077,4,4,14,14,4,121,0,-0.3
1891,"Blackburn Rovers",1,26,36,58,65,-7,1.38461538461538,2.23076923076923,2.5,-0.269230769230769,9,9,14,14,12,121,-3,0.6
1891,"Bolton Wanderers",1,26,53,51,37,14,2.03846153846154,1.96153846153846,1.42307692307692,0.538461538461538,3,3,14,14,5,121,-2,-1.1
1891,"Burnley",1,26,37,49,45,4,1.42307692307692,1.88461538461538,1.73076923076923,0.153846153846154,6,6,14,14,6,121,0,-2.5
1891,"Darwen",1,26,15,38,112,-74,0.576923076923077,1.46153846153846,4.30769230769231,-2.84615384615385,14,14,14,14,19,8,-5,NA
1891,"Derby County",1,26,34,46,52,-6,1.30769230769231,1.76923076923077,2,-0.230769230769231,10,10,14,14,13,121,-3,0.5
1891,"Everton",1,26,40,49,49,0,1.53846153846154,1.88461538461538,1.88461538461538,0,5,5,14,14,3,121,2,0.3
1891,"Notts County",1,26,37,55,51,4,1.42307692307692,2.11538461538462,1.96153846153846,0.153846153846154,7,7,14,14,14,120,-7,-0.3
1891,"Preston North End",1,26,55,61,31,30,2.11538461538462,2.34615384615385,1.19230769230769,1.15384615384615,2,2,14,14,2,121,0,-2
1891,"Stoke City",1,26,19,38,61,-23,0.730769230769231,1.46153846153846,2.34615384615385,-0.884615384615385,13,13,14,14,7,113,6,-0.3
1891,"Sunderland",1,26,63,93,36,57,2.42307692307692,3.57692307692308,1.38461538461538,2.19230769230769,1,1,14,14,1,119,0,0
1891,"West Bromwich Albion",1,26,24,51,58,-7,0.923076923076923,1.96153846153846,2.23076923076923,-0.269230769230769,12,12,14,14,8,121,4,-0.7
1891,"Wolverhampton Wanderers",1,26,37,59,46,13,1.42307692307692,2.26923076923077,1.76923076923077,0.5,8,8,14,14,9,121,-1,-0.5
1892,"Accrington F.C.",1,30,29,57,81,-24,0.966666666666667,1.9,2.7,-0.8,15,15,16,16,NA,5,NA,NA
1892,"Aston Villa",1,30,51,73,62,11,1.7,2.43333333333333,2.06666666666667,0.366666666666667,4,4,16,16,1,121,3,0.2
1892,"Birmingham City",2,22,53,90,35,55,2.40909090909091,4.09090909090909,1.59090909090909,2.5,17,1,12,28,18,117,-1,-0.3
1892,"Blackburn Rovers",1,30,37,47,56,-9,1.23333333333333,1.56666666666667,1.86666666666667,-0.3,12,12,16,16,4,121,8,-0.4
1892,"Bolton Wanderers",1,30,45,56,55,1,1.5,1.86666666666667,1.83333333333333,0.0333333333333333,5,5,16,16,13,121,-8,-1.3
1892,"Bootle",2,22,27,49,63,-14,1.22727272727273,2.22727272727273,2.86363636363636,-0.636363636363636,24,8,12,28,NA,1,NA,NA
1892,"Burnley",1,30,43,51,44,7,1.43333333333333,1.7,1.46666666666667,0.233333333333333,6,6,16,16,5,121,1,-3
1892,"Burton Swifts",2,22,29,47,47,0,1.31818181818182,2.13636363636364,2.13636363636364,0,22,6,12,28,22,9,0,NA
1892,"Crewe Alexandra",2,22,21,42,69,-27,0.954545454545455,1.90909090909091,3.13636363636364,-1.22727272727273,26,10,12,28,29,96,-3,-5.2
1892,"Darwen",2,22,44,60,36,24,2,2.72727272727273,1.63636363636364,1.09090909090909,19,3,12,28,15,8,4,NA
1892,"Derby County",1,30,36,52,64,-12,1.2,1.73333333333333,2.13333333333333,-0.4,13,13,16,16,3,121,10,0.4
1892,"Everton",1,30,52,74,51,23,1.73333333333333,2.46666666666667,1.7,0.766666666666667,3,3,16,16,6,121,-3,-1.1
1892,"Grimsby Town",2,22,34,42,41,1,1.54545454545455,1.90909090909091,1.86363636363636,0.0454545454545455,20,4,12,28,21,110,-1,0.3
1892,"Lincoln City",2,22,24,45,51,-6,1.09090909090909,2.04545454545455,2.31818181818182,-0.272727272727273,25,9,12,28,25,107,0,-0.3
1892,"Manchester City",2,22,30,45,40,5,1.36363636363636,2.04545454545455,1.81818181818182,0.227272727272727,21,5,12,28,28,117,-7,0.2
1892,"Manchester United",1,30,24,50,85,-35,0.8,1.66666666666667,2.83333333333333,-1.16666666666667,16,16,16,16,16,117,0,-0.7
1892,"Northwich Victoria",2,22,29,42,58,-16,1.31818181818182,1.90909090909091,2.63636363636364,-0.727272727272727,23,7,12,28,31,2,-8,NA
1892,"Nottingham Forest",1,30,38,48,52,-4,1.26666666666667,1.6,1.73333333333333,-0.133333333333333,11,11,16,16,7,117,4,0.1
1892,"Notts County",1,30,34,53,61,-8,1.13333333333333,1.76666666666667,2.03333333333333,-0.266666666666667,14,14,16,16,19,120,-5,-0.1
1892,"Port Vale",2,22,21,30,57,-27,0.954545454545455,1.36363636363636,2.59090909090909,-1.22727272727273,27,11,12,28,23,107,4,-0.7
1892,"Preston North End",1,30,54,57,39,18,1.8,1.9,1.3,0.6,2,2,16,16,14,121,-12,-2.3
1892,"Sheffield United",2,22,51,62,19,43,2.31818181818182,2.81818181818182,0.863636363636364,1.95454545454545,18,2,12,28,10,117,8,1.4
1892,"Sheffield Wednesday",1,30,39,55,65,-10,1.3,1.83333333333333,2.16666666666667,-0.333333333333333,10,10,16,16,12,117,-2,0.9
1892,"Stoke City",1,30,41,58,48,10,1.36666666666667,1.93333333333333,1.6,0.333333333333333,7,7,16,16,11,113,-4,0.1
1892,"Sunderland",1,30,70,100,36,64,2.33333333333333,3.33333333333333,1.2,2.13333333333333,1,1,16,16,2,119,-1,-0.2
1892,"Walsall",2,22,18,37,75,-38,0.818181818181818,1.68181818181818,3.40909090909091,-1.72727272727273,28,12,12,28,26,100,2,-4.6
1892,"West Bromwich Albion",1,30,41,58,69,-11,1.36666666666667,1.93333333333333,2.3,-0.366666666666667,8,8,16,16,8,121,0,0.1
1892,"Wolverhampton Wanderers",1,30,40,47,68,-21,1.33333333333333,1.56666666666667,2.26666666666667,-0.7,9,9,16,16,9,121,0,-0.2
1893,"Arsenal",2,28,40,52,55,-3,1.42857142857143,1.85714285714286,1.96428571428571,-0.107142857142857,24,8,15,31,24,116,0,0.5
1893,"Aston Villa",1,30,63,84,42,42,2.1,2.8,1.4,1.4,1,1,16,16,3,121,-2,-0.4
1893,"Birmingham City",2,28,63,103,44,59,2.25,3.67857142857143,1.57142857142857,2.10714285714286,18,2,15,31,10,117,8,0.8
1893,"Blackburn Rovers",1,30,50,69,53,16,1.66666666666667,2.3,1.76666666666667,0.533333333333333,4,4,16,16,7,121,-3,-0.8
1893,"Bolton Wanderers",1,30,34,38,52,-14,1.13333333333333,1.26666666666667,1.73333333333333,-0.466666666666667,13,13,16,16,11,121,2,-1.2
1893,"Burnley",1,30,49,61,51,10,1.63333333333333,2.03333333333333,1.7,0.333333333333333,5,5,16,16,9,121,-4,-1.8
1893,"Burton Swifts",2,28,45,79,61,18,1.60714285714286,2.82142857142857,2.17857142857143,0.642857142857143,22,6,15,31,27,9,-5,NA
1893,"Crewe Alexandra",2,28,25,42,73,-31,0.892857142857143,1.5,2.60714285714286,-1.10714285714286,29,13,15,31,32,96,-3,-3.3
1893,"Darwen",1,30,26,37,83,-46,0.866666666666667,1.23333333333333,2.76666666666667,-1.53333333333333,15,15,16,16,22,8,-7,NA
1893,"Derby County",1,30,52,73,62,11,1.73333333333333,2.43333333333333,2.06666666666667,0.366666666666667,3,3,16,16,15,121,-12,-1.1
1893,"Everton",1,30,48,90,57,33,1.6,3,1.9,1.1,6,6,16,16,2,121,4,0.3
1893,"Grimsby Town",2,28,47,71,58,13,1.67857142857143,2.53571428571429,2.07142857142857,0.464285714285714,21,5,15,31,19,110,2,-0.3
1893,"Lincoln City",2,28,39,59,58,1,1.39285714285714,2.10714285714286,2.07142857142857,0.0357142857142857,25,9,15,31,29,107,-4,-0.5
1893,"Liverpool",2,28,72,77,18,59,2.57142857142857,2.75,0.642857142857143,2.10714285714286,17,1,15,31,16,116,1,0
1893,"Manchester City",2,28,26,47,71,-24,0.928571428571429,1.67857142857143,2.53571428571429,-0.857142857142857,28,12,15,31,25,117,3,2.6
1893,"Manchester United",1,30,20,36,72,-36,0.666666666666667,1.2,2.4,-1.2,16,16,16,16,21,117,-5,-0.5
1893,"Middlesbrough Ironopolis",2,28,28,37,72,-35,1,1.32142857142857,2.57142857142857,-1.25,27,11,15,31,NA,1,NA,NA
1893,"Newcastle United",2,28,51,66,39,27,1.82142857142857,2.35714285714286,1.39285714285714,0.964285714285714,20,4,15,31,26,116,-6,1.6
1893,"Northwich Victoria",2,28,12,30,98,-68,0.428571428571429,1.07142857142857,3.5,-2.42857142857143,31,15,15,31,NA,2,NA,NA
1893,"Nottingham Forest",1,30,46,57,48,9,1.53333333333333,1.9,1.6,0.3,7,7,16,16,6,117,1,-0.2
1893,"Notts County",2,28,57,70,31,39,2.03571428571429,2.5,1.10714285714286,1.39285714285714,19,3,15,31,18,120,1,0.8
1893,"Port Vale",2,28,43,66,64,2,1.53571428571429,2.35714285714286,2.28571428571429,0.0714285714285714,23,7,15,31,31,107,-8,-1.2
1893,"Preston North End",1,30,33,44,56,-12,1.1,1.46666666666667,1.86666666666667,-0.4,14,14,16,16,4,121,10,-0.6
1893,"Rotherham Town",2,28,21,44,91,-47,0.75,1.57142857142857,3.25,-1.67857142857143,30,14,15,31,28,3,2,NA
1893,"Sheffield United",1,30,44,47,61,-14,1.46666666666667,1.56666666666667,2.03333333333333,-0.466666666666667,10,10,16,16,5,117,5,0.3
1893,"Sheffield Wednesday",1,30,35,48,57,-9,1.16666666666667,1.6,1.9,-0.3,12,12,16,16,8,117,4,1.1
1893,"Stoke City",1,30,42,65,79,-14,1.4,2.16666666666667,2.63333333333333,-0.466666666666667,11,11,16,16,14,113,-3,-0.4
1893,"Sunderland",1,30,55,72,44,28,1.83333333333333,2.4,1.46666666666667,0.933333333333333,2,2,16,16,1,119,1,-0.4
1893,"Walsall",2,28,33,51,61,-10,1.17857142857143,1.82142857142857,2.17857142857143,-0.357142857142857,26,10,15,31,30,100,-4,-5.4
1893,"West Bromwich Albion",1,30,46,66,59,7,1.53333333333333,2.2,1.96666666666667,0.233333333333333,8,8,16,16,12,121,-4,-1
1893,"Wolverhampton Wanderers",1,30,45,52,63,-11,1.5,1.73333333333333,2.1,-0.366666666666667,9,9,16,16,13,121,-4,0.1
1894,"Arsenal",2,30,48,75,58,17,1.6,2.5,1.93333333333333,0.566666666666667,24,8,16,32,23,116,1,1.4
1894,"Aston Villa",1,30,56,82,43,39,1.86666666666667,2.73333333333333,1.43333333333333,1.3,3,3,16,16,1,121,2,-0.1
1894,"Birmingham City",1,30,34,50,74,-24,1.13333333333333,1.66666666666667,2.46666666666667,-0.8,10,10,16,16,15,117,-5,0.4
1894,"Blackburn Rovers",1,30,43,59,49,10,1.43333333333333,1.96666666666667,1.63333333333333,0.333333333333333,7,7,16,16,7,121,0,-0.6
1894,"Bolton Wanderers",1,30,34,61,62,-1,1.13333333333333,2.03333333333333,2.06666666666667,-0.0333333333333333,11,11,16,16,4,121,7,-0.9
1894,"Burnley",1,30,37,44,56,-12,1.23333333333333,1.46666666666667,1.86666666666667,-0.4,9,9,16,16,11,121,-2,-2
1894,"Burton Swifts",2,30,36,52,74,-22,1.2,1.73333333333333,2.46666666666667,-0.733333333333333,27,11,16,32,27,9,0,NA
1894,"Burton Wanderers",2,30,49,67,39,28,1.63333333333333,2.23333333333333,1.3,0.933333333333333,23,7,16,32,20,3,3,NA
1894,"Bury",2,30,71,78,33,45,2.36666666666667,2.6,1.1,1.5,17,1,16,32,9,114,8,0.1
1894,"Crewe Alexandra",2,30,13,26,103,-77,0.433333333333333,0.866666666666667,3.43333333333333,-2.56666666666667,32,16,16,32,32,96,0,-3.1
1894,"Darwen",2,30,52,74,43,31,1.73333333333333,2.46666666666667,1.43333333333333,1.03333333333333,22,6,16,32,25,8,-3,NA
1894,"Derby County",1,30,30,45,68,-23,1,1.5,2.26666666666667,-0.766666666666667,15,15,16,16,2,121,13,0.4
1894,"Everton",1,30,60,82,50,32,2,2.73333333333333,1.66666666666667,1.06666666666667,2,2,16,16,3,121,-1,0
1894,"Grimsby Town",2,30,55,79,52,27,1.83333333333333,2.63333333333333,1.73333333333333,0.9,19,3,16,32,19,110,0,-1.1
1894,"Leicester City",2,30,53,72,53,19,1.76666666666667,2.4,1.76666666666667,0.633333333333333,20,4,16,32,24,115,-4,-1.2
1894,"Lincoln City",2,30,30,52,92,-40,1,1.73333333333333,3.06666666666667,-1.33333333333333,29,13,16,32,29,107,0,0.2
1894,"Liverpool",1,30,29,51,70,-19,0.966666666666667,1.7,2.33333333333333,-0.633333333333333,16,16,16,16,17,116,-1,-0.3
1894,"Manchester City",2,30,45,82,72,10,1.5,2.73333333333333,2.4,0.333333333333333,25,9,16,32,18,117,7,2.2
1894,"Manchester United",2,30,53,78,44,34,1.76666666666667,2.6,1.46666666666667,1.13333333333333,21,5,16,32,22,117,-1,0
1894,"Newcastle United",2,30,39,72,84,-12,1.3,2.4,2.8,-0.4,26,10,16,32,21,116,5,2.5
1894,"Nottingham Forest",1,30,44,50,56,-6,1.46666666666667,1.66666666666667,1.86666666666667,-0.2,6,6,16,16,12,117,-6,-1.1
1894,"Notts County",2,30,56,75,45,30,1.86666666666667,2.5,1.5,1,18,2,16,32,26,120,-8,0
1894,"Port Vale",2,30,25,39,77,-38,0.833333333333333,1.3,2.56666666666667,-1.26666666666667,31,15,16,32,30,107,1,-0.5
1894,"Preston North End",1,30,50,62,46,16,1.66666666666667,2.06666666666667,1.53333333333333,0.533333333333333,4,4,16,16,10,121,-6,-0.4
1894,"Rotherham Town",2,30,35,55,62,-7,1.16666666666667,1.83333333333333,2.06666666666667,-0.233333333333333,28,12,16,32,31,3,-3,NA
1894,"Sheffield United",1,30,46,57,55,2,1.53333333333333,1.9,1.83333333333333,0.0666666666666667,5,5,16,16,13,117,-8,0
1894,"Sheffield Wednesday",1,30,40,50,55,-5,1.33333333333333,1.66666666666667,1.83333333333333,-0.166666666666667,8,8,16,16,8,117,0,-0.1
1894,"Stoke City",1,30,33,50,67,-17,1.1,1.66666666666667,2.23333333333333,-0.566666666666667,14,14,16,16,6,113,8,0.2
1894,"Sunderland",1,30,68,80,37,43,2.26666666666667,2.66666666666667,1.23333333333333,1.43333333333333,1,1,16,16,5,119,-4,-0.6
1894,"Walsall",2,30,30,47,92,-45,1,1.56666666666667,3.06666666666667,-1.5,30,14,16,32,29,100,1,-5.6
1894,"West Bromwich Albion",1,30,34,51,66,-15,1.13333333333333,1.7,2.2,-0.5,12,12,16,16,16,121,-4,-1.6
1894,"Wolverhampton Wanderers",1,30,34,43,63,-20,1.13333333333333,1.43333333333333,2.1,-0.666666666666667,13,13,16,16,14,121,-1,-0.1
1895,"Arsenal",2,30,46,58,42,16,1.53333333333333,1.93333333333333,1.4,0.533333333333333,23,7,16,32,24,116,-1,1.2
1895,"Aston Villa",1,30,65,78,45,33,2.16666666666667,2.6,1.5,1.1,1,1,16,16,1,121,0,-0.7
1895,"Birmingham City",1,30,28,39,79,-40,0.933333333333333,1.3,2.63333333333333,-1.33333333333333,15,15,16,16,20,117,-5,0.9
1895,"Blackburn Rovers",1,30,41,40,50,-10,1.36666666666667,1.33333333333333,1.66666666666667,-0.333333333333333,7,7,16,16,11,121,-4,-0.2
1895,"Bolton Wanderers",1,30,53,49,37,12,1.76666666666667,1.63333333333333,1.23333333333333,0.4,4,4,16,16,7,121,-3,-0.3
1895,"Burnley",1,30,37,48,44,4,1.23333333333333,1.6,1.46666666666667,0.133333333333333,11,11,16,16,16,121,-5,-1.8
1895,"Burton Swifts",2,30,34,39,69,-30,1.13333333333333,1.3,2.3,-1,27,11,16,32,30,9,-3,NA
1895,"Burton Wanderers",2,30,61,69,40,29,2.03333333333333,2.3,1.33333333333333,0.966666666666667,20,4,16,32,31,3,-11,NA
1895,"Bury",1,30,39,50,54,-4,1.3,1.66666666666667,1.8,-0.133333333333333,9,9,16,16,9,114,0,-0.9
1895,"Crewe Alexandra",2,30,18,30,95,-65,0.6,1,3.16666666666667,-2.16666666666667,32,16,16,32,57,96,-25,-4.8
1895,"Darwen",2,30,42,72,67,5,1.4,2.4,2.23333333333333,0.166666666666667,25,9,16,32,27,8,-2,NA
1895,"Derby County",1,30,58,68,35,33,1.93333333333333,2.26666666666667,1.16666666666667,1.1,2,2,16,16,2,121,0,-1.3
1895,"Everton",1,30,55,66,43,23,1.83333333333333,2.2,1.43333333333333,0.766666666666667,3,3,16,16,4,121,-1,-0.9
1895,"Grimsby Town",2,30,62,82,38,44,2.06666666666667,2.73333333333333,1.26666666666667,1.46666666666667,19,3,16,32,19,110,0,-0.9
1895,"Leicester City",2,30,46,57,44,13,1.53333333333333,1.9,1.46666666666667,0.433333333333333,24,8,16,32,26,115,-2,-0.3
1895,"Lincoln City",2,30,31,53,75,-22,1.03333333333333,1.76666666666667,2.5,-0.733333333333333,29,13,16,32,32,107,-3,-0.4
1895,"Liverpool",2,30,68,106,32,74,2.26666666666667,3.53333333333333,1.06666666666667,2.46666666666667,17,1,16,32,5,116,12,1.6
1895,"Loughborough",2,30,32,40,66,-26,1.06666666666667,1.33333333333333,2.2,-0.866666666666667,28,12,16,32,28,5,0,NA
1895,"Manchester City",2,30,67,63,38,25,2.23333333333333,2.1,1.26666666666667,0.833333333333333,18,2,16,32,23,117,-5,1.5
1895,"Manchester United",2,30,48,66,57,9,1.6,2.2,1.9,0.3,22,6,16,32,18,117,4,0
1895,"Newcastle United",2,30,50,73,50,23,1.66666666666667,2.43333333333333,1.66666666666667,0.766666666666667,21,5,16,32,21,116,0,1.6
1895,"Nottingham Forest",1,30,36,42,57,-15,1.2,1.4,1.9,-0.5,12,12,16,16,14,117,-2,-0.5
1895,"Notts County",2,30,38,57,54,3,1.26666666666667,1.9,1.8,0.1,26,10,16,32,17,120,9,1
1895,"Port Vale",2,30,25,43,78,-35,0.833333333333333,1.43333333333333,2.6,-1.16666666666667,30,14,16,32,27,107,3,-1
1895,"Preston North End",1,30,39,44,48,-4,1.3,1.46666666666667,1.6,-0.133333333333333,10,10,16,16,6,121,4,0.8
1895,"Rotherham Town",2,30,24,34,97,-63,0.8,1.13333333333333,3.23333333333333,-2.1,31,15,16,32,NA,3,NA,NA
1895,"Sheffield United",1,30,36,40,50,-10,1.2,1.33333333333333,1.66666666666667,-0.333333333333333,13,13,16,16,3,117,10,0
1895,"Sheffield Wednesday",1,30,41,44,53,-9,1.36666666666667,1.46666666666667,1.76666666666667,-0.3,8,8,16,16,8,117,0,0.4
1895,"Stoke City",1,30,45,56,47,9,1.5,1.86666666666667,1.56666666666667,0.3,6,6,16,16,12,113,-6,-0.4
1895,"Sunderland",1,30,52,52,41,11,1.73333333333333,1.73333333333333,1.36666666666667,0.366666666666667,5,5,16,16,15,119,-10,-0.9
1895,"West Bromwich Albion",1,30,25,30,59,-29,0.833333333333333,1,1.96666666666667,-0.966666666666667,16,16,16,16,13,121,3,-0.8
1895,"Wolverhampton Wanderers",1,30,31,61,65,-4,1.03333333333333,2.03333333333333,2.16666666666667,-0.133333333333333,14,14,16,16,10,121,4,-0.6
1896,"Arsenal",2,30,43,68,70,-2,1.43333333333333,2.26666666666667,2.33333333333333,-0.0666666666666667,24,8,16,32,21,116,3,2
1896,"Aston Villa",1,30,68,73,38,35,2.26666666666667,2.43333333333333,1.26666666666667,1.16666666666667,1,1,16,16,6,121,-5,-0.4
1896,"Birmingham City",2,30,53,69,47,22,1.76666666666667,2.3,1.56666666666667,0.733333333333333,20,4,16,32,22,117,-2,1.1
1896,"Blackburn Rovers",1,30,36,35,62,-27,1.2,1.16666666666667,2.06666666666667,-0.9,11,11,16,16,16,121,-5,-0.1
1896,"Blackpool",2,30,44,59,56,3,1.46666666666667,1.96666666666667,1.86666666666667,0.1,22,6,16,32,27,112,-5,-1.4
1896,"Bolton Wanderers",1,30,42,40,43,-3,1.4,1.33333333333333,1.43333333333333,-0.1,7,7,16,16,11,121,-4,0.1
1896,"Burnley",1,30,25,43,61,-18,0.833333333333333,1.43333333333333,2.03333333333333,-0.6,16,16,16,16,17,121,-1,-1.1
1896,"Burton Swifts",2,30,33,46,61,-15,1.1,1.53333333333333,2.03333333333333,-0.5,30,14,16,32,29,9,1,NA
1896,"Burton Wanderers",2,30,29,31,67,-36,0.966666666666667,1.03333333333333,2.23333333333333,-1.2,31,15,16,32,NA,3,NA,NA
1896,"Bury",1,30,40,39,44,-5,1.33333333333333,1.3,1.46666666666667,-0.166666666666667,9,9,16,16,12,114,-3,-0.7
1896,"Darwen",2,30,42,67,61,6,1.4,2.23333333333333,2.03333333333333,0.2,27,11,16,32,31,8,-4,NA
1896,"Derby County",1,30,52,70,50,20,1.73333333333333,2.33333333333333,1.66666666666667,0.666666666666667,2,2,16,16,9,121,-7,-1.7
1896,"Everton",1,30,45,62,57,5,1.5,2.06666666666667,1.9,0.166666666666667,4,4,16,16,4,121,0,0.1
1896,"Gainsborough Trinity",2,30,43,50,47,3,1.43333333333333,1.66666666666667,1.56666666666667,0.1,25,9,16,32,25,16,0,-0.7
1896,"Grimsby Town",2,30,55,66,45,21,1.83333333333333,2.2,1.5,0.7,19,3,16,32,28,110,-9,-1.1
1896,"Leicester City",2,30,43,59,57,2,1.43333333333333,1.96666666666667,1.9,0.0666666666666667,26,10,16,32,23,115,3,0.2
1896,"Lincoln City",2,30,17,27,85,-58,0.566666666666667,0.9,2.83333333333333,-1.93333333333333,32,16,16,32,30,107,2,-0.7
1896,"Liverpool",1,30,45,46,38,8,1.5,1.53333333333333,1.26666666666667,0.266666666666667,5,5,16,16,10,116,-5,-1
1896,"Loughborough",2,30,37,50,64,-14,1.23333333333333,1.66666666666667,2.13333333333333,-0.466666666666667,28,12,16,32,32,5,-4,NA
1896,"Manchester City",2,30,44,58,50,8,1.46666666666667,1.93333333333333,1.66666666666667,0.266666666666667,23,7,16,32,19,117,4,0.6
1896,"Manchester United",2,30,56,56,34,22,1.86666666666667,1.86666666666667,1.13333333333333,0.733333333333333,18,2,16,32,20,117,-2,1
1896,"Newcastle United",2,30,52,56,52,4,1.73333333333333,1.86666666666667,1.73333333333333,0.133333333333333,21,5,16,32,18,116,3,2
1896,"Nottingham Forest",1,30,35,44,49,-5,1.16666666666667,1.46666666666667,1.63333333333333,-0.166666666666667,14,14,16,16,8,117,6,-0.7
1896,"Notts County",2,30,61,92,43,49,2.03333333333333,3.06666666666667,1.43333333333333,1.63333333333333,17,1,16,32,13,120,4,-0.1
1896,"Preston North End",1,30,45,55,40,15,1.5,1.83333333333333,1.33333333333333,0.5,6,6,16,16,14,121,-8,-0.7
1896,"Sheffield United",1,30,49,42,29,13,1.63333333333333,1.4,0.966666666666667,0.433333333333333,3,3,16,16,1,117,2,-0.4
1896,"Sheffield Wednesday",1,30,41,42,37,5,1.36666666666667,1.4,1.23333333333333,0.166666666666667,8,8,16,16,5,117,3,-0.6
1896,"Stoke City",1,30,36,48,59,-11,1.2,1.6,1.96666666666667,-0.366666666666667,12,12,16,16,15,113,-3,-0.8
1896,"Sunderland",1,30,30,34,47,-13,1,1.13333333333333,1.56666666666667,-0.433333333333333,15,15,16,16,2,119,13,0.4
1896,"Walsall",2,30,37,54,69,-15,1.23333333333333,1.8,2.3,-0.5,29,13,16,32,26,100,3,-4.3
1896,"West Bromwich Albion",1,30,36,33,56,-23,1.2,1.1,1.86666666666667,-0.766666666666667,13,13,16,16,7,121,6,-1.2
1896,"Wolverhampton Wanderers",1,30,39,45,41,4,1.3,1.5,1.36666666666667,0.133333333333333,10,10,16,16,3,121,7,-1.6
1897,"Arsenal",2,30,53,69,49,20,1.76666666666667,2.3,1.63333333333333,0.666666666666667,21,5,16,32,24,116,-3,0.8
1897,"Aston Villa",1,30,47,61,51,10,1.56666666666667,2.03333333333333,1.7,0.333333333333333,6,6,16,16,1,121,5,0.3
1897,"Birmingham City",2,30,52,58,50,8,1.73333333333333,1.93333333333333,1.66666666666667,0.266666666666667,22,6,16,32,25,117,-3,0.2
1897,"Blackburn Rovers",1,30,31,39,54,-15,1.03333333333333,1.3,1.8,-0.5,16,16,16,16,6,121,10,0.2
1897,"Blackpool",2,30,35,49,61,-12,1.16666666666667,1.63333333333333,2.03333333333333,-0.4,27,11,16,32,34,112,-7,-1.3
1897,"Bolton Wanderers",1,30,37,28,41,-13,1.23333333333333,0.933333333333333,1.36666666666667,-0.433333333333333,11,11,16,16,17,121,-6,-0.6
1897,"Burnley",2,30,68,80,24,56,2.26666666666667,2.66666666666667,0.8,1.86666666666667,17,1,16,32,3,121,14,-1
1897,"Burton Swifts",2,30,29,38,69,-31,0.966666666666667,1.26666666666667,2.3,-1.03333333333333,29,13,16,32,31,9,-2,NA
1897,"Bury",1,30,32,39,51,-12,1.06666666666667,1.3,1.7,-0.4,12,12,16,16,7,114,5,0.4
1897,"Darwen",2,30,20,31,76,-45,0.666666666666667,1.03333333333333,2.53333333333333,-1.5,31,15,16,32,36,8,-5,NA
1897,"Derby County",1,30,39,57,61,-4,1.3,1.9,2.03333333333333,-0.133333333333333,9,9,16,16,10,121,-1,-1.6
1897,"Everton",1,30,48,48,39,9,1.6,1.6,1.3,0.3,4,4,16,16,4,121,0,-0.5
1897,"Gainsborough Trinity",2,30,42,50,54,-4,1.4,1.66666666666667,1.8,-0.133333333333333,25,9,16,32,32,16,-7,-0.6
1897,"Grimsby Town",2,30,34,52,62,-10,1.13333333333333,1.73333333333333,2.06666666666667,-0.333333333333333,28,12,16,32,28,110,0,-1
1897,"Leicester City",2,30,46,46,35,11,1.53333333333333,1.53333333333333,1.16666666666667,0.366666666666667,23,7,16,32,21,115,2,0.1
1897,"Lincoln City",2,30,23,43,82,-39,0.766666666666667,1.43333333333333,2.73333333333333,-1.3,30,14,16,32,30,107,0,-0.9
1897,"Liverpool",1,30,39,48,45,3,1.3,1.6,1.5,0.1,10,10,16,16,2,116,8,0.3
1897,"Loughborough",2,30,20,24,87,-63,0.666666666666667,0.8,2.9,-2.1,32,16,16,32,35,5,-3,NA
1897,"Luton Town",2,30,43,68,50,18,1.43333333333333,2.26666666666667,1.66666666666667,0.6,24,8,16,32,33,91,-9,-4.5
1897,"Manchester City",2,30,54,66,36,30,1.8,2.2,1.2,1,19,3,16,32,19,117,0,1.5
1897,"Manchester United",2,30,54,64,35,29,1.8,2.13333333333333,1.16666666666667,0.966666666666667,20,4,16,32,22,117,-2,1.9
1897,"Newcastle United",2,30,66,64,32,32,2.2,2.13333333333333,1.06666666666667,1.06666666666667,18,2,16,32,14,116,4,1.2
1897,"Nottingham Forest",1,30,42,47,49,-2,1.4,1.56666666666667,1.63333333333333,-0.0666666666666667,8,8,16,16,12,117,-4,-0.4
1897,"Notts County",1,30,32,36,46,-10,1.06666666666667,1.2,1.53333333333333,-0.333333333333333,13,13,16,16,8,120,5,-0.5
1897,"Preston North End",1,30,32,35,43,-8,1.06666666666667,1.16666666666667,1.43333333333333,-0.266666666666667,14,14,16,16,15,121,-1,-0.2
1897,"Sheffield United",1,30,59,56,31,25,1.96666666666667,1.86666666666667,1.03333333333333,0.833333333333333,1,1,16,16,16,117,-15,-1.8
1897,"Sheffield Wednesday",1,30,48,51,42,9,1.6,1.7,1.4,0.3,5,5,16,16,18,117,-13,0.3
1897,"Stoke City",1,30,32,35,55,-20,1.06666666666667,1.16666666666667,1.83333333333333,-0.666666666666667,15,15,16,16,11,113,4,-1.4
1897,"Sunderland",1,30,53,43,30,13,1.76666666666667,1.43333333333333,1,0.433333333333333,2,2,16,16,5,119,-3,-0.8
1897,"Walsall",2,30,41,58,58,0,1.36666666666667,1.93333333333333,1.93333333333333,0,26,10,16,32,26,100,0,-5.4
1897,"West Bromwich Albion",1,30,43,44,45,-1,1.43333333333333,1.46666666666667,1.5,-0.0333333333333333,7,7,16,16,13,121,-6,-2.1
1897,"Wolverhampton Wanderers",1,30,49,57,41,16,1.63333333333333,1.9,1.36666666666667,0.533333333333333,3,3,16,16,9,121,-6,-2.7
1898,"Arsenal",2,34,59,72,41,31,1.73529411764706,2.11764705882353,1.20588235294118,0.911764705882353,24,6,18,36,26,116,-2,1.8
1898,"Aston Villa",1,34,64,76,40,36,1.88235294117647,2.23529411764706,1.17647058823529,1.05882352941176,1,1,18,18,1,121,0,-0.6
1898,"Barnsley",2,34,43,52,56,-4,1.26470588235294,1.52941176470588,1.64705882352941,-0.117647058823529,29,11,18,36,34,111,-5,-0.9
1898,"Birmingham City",2,34,58,85,50,35,1.70588235294118,2.5,1.47058823529412,1.02941176470588,25,7,18,36,21,117,4,-0.5
1898,"Blackburn Rovers",1,34,50,60,52,8,1.47058823529412,1.76470588235294,1.52941176470588,0.235294117647059,6,6,18,18,13,121,-7,0.1
1898,"Blackpool",2,34,28,49,90,-41,0.823529411764706,1.44117647058824,2.64705882352941,-1.20588235294118,34,16,18,36,29,112,5,0.2
1898,"Bolton Wanderers",1,34,34,37,51,-14,1,1.08823529411765,1.5,-0.411764705882353,17,17,18,18,20,121,-3,-0.4
1898,"Burnley",1,34,54,45,47,-2,1.58823529411765,1.32352941176471,1.38235294117647,-0.0588235294117647,3,3,18,18,16,121,-13,-3.1
1898,"Burton Swifts",2,34,38,51,70,-19,1.11764705882353,1.5,2.05882352941176,-0.558823529411765,31,13,18,36,32,9,-1,NA
1898,"Bury",1,34,49,48,49,-1,1.44117647058824,1.41176470588235,1.44117647058824,-0.0294117647058824,7,7,18,18,12,114,-5,-0.7
1898,"Darwen",2,34,11,22,141,-119,0.323529411764706,0.647058823529412,4.14705882352941,-3.5,36,18,18,36,NA,8,NA,NA
1898,"Derby County",1,34,47,62,57,5,1.38235294117647,1.82352941176471,1.67647058823529,0.147058823529412,10,10,18,18,5,121,5,-1.5
1898,"Everton",1,34,53,48,41,7,1.55882352941176,1.41176470588235,1.20588235294118,0.205882352941176,4,4,18,18,11,121,-7,0.1
1898,"Gainsborough Trinity",2,34,35,56,72,-16,1.02941176470588,1.64705882352941,2.11764705882353,-0.470588235294118,32,14,18,36,31,16,1,0.5
1898,"Glossop North End",2,34,66,76,38,38,1.94117647058824,2.23529411764706,1.11764705882353,1.11764705882353,20,2,18,36,18,17,2,-0.8
1898,"Grimsby Town",2,34,50,71,60,11,1.47058823529412,2.08823529411765,1.76470588235294,0.323529411764706,28,10,18,36,24,110,4,-0.4
1898,"Leicester City",2,34,63,64,42,22,1.85294117647059,1.88235294117647,1.23529411764706,0.647058823529412,21,3,18,36,23,115,-2,0.1
1898,"Lincoln City",2,34,43,51,56,-5,1.26470588235294,1.5,1.64705882352941,-0.147058823529412,30,12,18,36,27,107,3,-0.6
1898,"Liverpool",1,34,62,49,33,16,1.82352941176471,1.44117647058824,0.970588235294118,0.470588235294118,2,2,18,18,7,116,-5,-0.9
1898,"Loughborough",2,34,24,38,92,-54,0.705882352941177,1.11764705882353,2.70588235294118,-1.58823529411765,35,17,18,36,36,5,-1,NA
1898,"Luton Town",2,34,33,51,95,-44,0.970588235294118,1.5,2.79411764705882,-1.29411764705882,33,15,18,36,35,91,-2,-2.5
1898,"Manchester City",2,34,75,92,35,57,2.20588235294118,2.70588235294118,1.02941176470588,1.67647058823529,19,1,18,36,8,117,11,0.1
1898,"Manchester United",2,34,62,67,43,24,1.82352941176471,1.97058823529412,1.26470588235294,0.705882352941177,22,4,18,36,22,117,0,1.4
1898,"New Brighton Tower",2,34,61,71,52,19,1.79411764705882,2.08823529411765,1.52941176470588,0.558823529411765,23,5,18,36,28,3,-5,NA
1898,"Newcastle United",1,34,41,49,48,1,1.20588235294118,1.44117647058824,1.41176470588235,0.0294117647058824,14,14,18,18,6,116,8,1.3
1898,"Nottingham Forest",1,34,44,42,42,0,1.29411764705882,1.23529411764706,1.23529411764706,0,12,12,18,18,9,117,3,-0.3
1898,"Notts County",1,34,49,47,51,-4,1.44117647058824,1.38235294117647,1.5,-0.117647058823529,8,8,18,18,17,120,-9,-0.8
1898,"Port Vale",2,34,56,56,34,22,1.64705882352941,1.64705882352941,1,0.647058823529412,27,9,18,36,29,107,-2,-1.4
1898,"Preston North End",1,34,39,44,47,-3,1.14705882352941,1.29411764705882,1.38235294117647,-0.0882352941176471,15,15,18,18,15,121,0,-0.2
1898,"Sheffield United",1,34,38,45,51,-6,1.11764705882353,1.32352941176471,1.5,-0.176470588235294,16,16,18,18,2,117,14,0.3
1898,"Sheffield Wednesday",1,34,32,32,61,-29,0.941176470588235,0.941176470588235,1.79411764705882,-0.852941176470588,18,18,18,18,19,117,-1,1.4
1898,"Stoke City",1,34,46,47,52,-5,1.35294117647059,1.38235294117647,1.52941176470588,-0.147058823529412,11,11,18,18,10,113,1,-2
1898,"Sunderland",1,34,51,41,41,0,1.5,1.20588235294118,1.20588235294118,0,5,5,18,18,3,119,2,0.3
1898,"Walsall",2,34,57,79,36,43,1.67647058823529,2.32352941176471,1.05882352941176,1.26470588235294,26,8,18,36,30,100,-4,-4.9
1898,"West Bromwich Albion",1,34,42,42,57,-15,1.23529411764706,1.23529411764706,1.67647058823529,-0.441176470588235,13,13,18,18,14,121,-1,-1
1898,"Wolverhampton Wanderers",1,34,49,54,48,6,1.44117647058824,1.58823529411765,1.41176470588235,0.176470588235294,9,9,18,18,4,121,5,-2
1899,"Arsenal",2,34,52,61,43,18,1.52941176470588,1.79411764705882,1.26470588235294,0.529411764705882,26,8,18,36,25,116,1,0.9
1899,"Aston Villa",1,34,72,77,35,42,2.11764705882353,2.26470588235294,1.02941176470588,1.23529411764706,1,1,18,18,14,121,-13,0
1899,"Barnsley",2,34,31,46,79,-33,0.911764705882353,1.35294117647059,2.32352941176471,-0.970588235294118,34,16,18,36,32,111,2,0.6
1899,"Birmingham City",2,34,66,78,38,40,1.94117647058824,2.29411764705882,1.11764705882353,1.17647058823529,21,3,18,36,20,117,1,-1.9
1899,"Blackburn Rovers",1,34,43,49,61,-12,1.26470588235294,1.44117647058824,1.79411764705882,-0.352941176470588,13,13,18,18,10,121,3,0.8
1899,"Bolton Wanderers",2,34,74,79,25,54,2.17647058823529,2.32352941176471,0.735294117647059,1.58823529411765,20,2,18,36,9,121,11,0
1899,"Burnley",1,34,38,34,54,-20,1.11764705882353,1,1.58823529411765,-0.588235294117647,16,16,18,18,21,121,-5,-1.7
1899,"Burton Swifts",2,34,33,43,84,-41,0.970588235294118,1.26470588235294,2.47058823529412,-1.20588235294118,32,14,18,36,36,9,-4,NA
1899,"Bury",1,34,45,40,44,-4,1.32352941176471,1.17647058823529,1.29411764705882,-0.117647058823529,12,12,18,18,4,114,8,-0.1
1899,"Chesterfield",2,34,54,65,60,5,1.58823529411765,1.91176470588235,1.76470588235294,0.147058823529412,25,7,18,36,33,100,-8,-4.4
1899,"Derby County",1,34,50,45,43,2,1.47058823529412,1.32352941176471,1.26470588235294,0.0588235294117647,5,5,18,18,12,121,-7,-1.9
1899,"Everton",1,34,46,47,49,-2,1.35294117647059,1.38235294117647,1.44117647058824,-0.0588235294117647,11,11,18,18,6,121,5,0.2
1899,"Gainsborough Trinity",2,34,34,47,75,-28,1,1.38235294117647,2.20588235294118,-0.823529411764706,31,13,18,36,31,16,0,-0.7
1899,"Glossop North End",1,34,22,31,74,-43,0.647058823529412,0.911764705882353,2.17647058823529,-1.26470588235294,18,18,18,18,23,17,-5,-0.8
1899,"Grimsby Town",2,34,57,67,46,21,1.67647058823529,1.97058823529412,1.35294117647059,0.617647058823529,24,6,18,36,19,110,5,-1.5
1899,"Leicester City",2,34,60,53,36,17,1.76470588235294,1.55882352941176,1.05882352941176,0.5,23,5,18,36,30,115,-7,-0.2
1899,"Lincoln City",2,34,50,46,43,3,1.47058823529412,1.35294117647059,1.26470588235294,0.0882352941176471,27,9,18,36,26,107,1,-1.3
1899,"Liverpool",1,34,47,49,45,4,1.38235294117647,1.44117647058824,1.32352941176471,0.117647058823529,7,7,18,18,1,116,6,0.5
1899,"Loughborough",2,34,9,18,100,-82,0.264705882352941,0.529411764705882,2.94117647058824,-2.41176470588235,36,18,18,36,NA,5,NA,NA
1899,"Luton Town",2,34,23,40,75,-35,0.676470588235294,1.17647058823529,2.20588235294118,-1.02941176470588,35,17,18,36,53,91,-18,-3.7
1899,"Manchester City",1,34,47,50,44,6,1.38235294117647,1.47058823529412,1.29411764705882,0.176470588235294,8,8,18,18,11,117,-3,-1.3
1899,"Manchester United",2,34,64,63,27,36,1.88235294117647,1.85294117647059,0.794117647058823,1.05882352941176,22,4,18,36,27,117,-5,1.9
1899,"Middlesbrough",2,34,32,39,69,-30,0.941176470588235,1.14705882352941,2.02941176470588,-0.882352941176471,33,15,18,36,24,110,9,1.5
1899,"New Brighton Tower",2,34,48,66,58,8,1.41176470588235,1.94117647058824,1.70588235294118,0.235294117647059,28,10,18,36,22,3,6,NA
1899,"Newcastle United",1,34,49,53,43,10,1.44117647058824,1.55882352941176,1.26470588235294,0.294117647058824,6,6,18,18,7,116,-1,0.2
1899,"Nottingham Forest",1,34,47,56,55,1,1.38235294117647,1.64705882352941,1.61764705882353,0.0294117647058824,9,9,18,18,5,117,4,-0.6
1899,"Notts County",1,34,38,46,60,-14,1.11764705882353,1.35294117647059,1.76470588235294,-0.411764705882353,17,17,18,18,2,120,15,0.7
1899,"Port Vale",2,34,48,39,49,-10,1.41176470588235,1.14705882352941,1.44117647058824,-0.294117647058824,29,11,18,36,28,107,1,-1.1
1899,"Preston North End",1,34,40,38,48,-10,1.17647058823529,1.11764705882353,1.41176470588235,-0.294117647058824,15,15,18,18,17,121,-2,0.3
1899,"Sheffield United",1,34,66,63,33,30,1.94117647058824,1.85294117647059,0.970588235294118,0.882352941176471,2,2,18,18,13,117,-11,-0.6
1899,"Sheffield Wednesday",2,34,79,84,22,62,2.32352941176471,2.47058823529412,0.647058823529412,1.82352941176471,19,1,18,36,8,117,11,0.8
1899,"Stoke City",1,34,47,37,45,-8,1.38235294117647,1.08823529411765,1.32352941176471,-0.235294117647059,10,10,18,18,16,113,-6,-3.2
1899,"Sunderland",1,34,60,50,35,15,1.76470588235294,1.47058823529412,1.02941176470588,0.441176470588235,3,3,18,18,3,119,0,-0.4
1899,"Walsall",2,34,44,50,55,-5,1.29411764705882,1.47058823529412,1.61764705882353,-0.147058823529412,30,12,18,36,35,100,-5,-4.7
1899,"West Bromwich Albion",1,34,41,43,51,-8,1.20588235294118,1.26470588235294,1.5,-0.235294117647059,14,14,18,18,18,121,-4,-1.7
1899,"Wolverhampton Wanderers",1,34,54,48,37,11,1.58823529411765,1.41176470588235,1.08823529411765,0.323529411764706,4,4,18,18,15,121,-11,-2.3
1900,"Arsenal",2,34,51,39,35,4,1.5,1.14705882352941,1.02941176470588,0.117647058823529,25,7,18,36,21,116,4,1.3
1900,"Aston Villa",1,34,40,45,51,-6,1.17647058823529,1.32352941176471,1.5,-0.176470588235294,14,14,18,18,7,121,7,1.2
1900,"Barnsley",2,34,38,47,60,-13,1.11764705882353,1.38235294117647,1.76470588235294,-0.382352941176471,32,14,18,36,26,111,6,-0.7
1900,"Birmingham City",2,34,67,57,24,33,1.97058823529412,1.67647058823529,0.705882352941177,0.970588235294118,20,2,18,36,17,117,3,-1.6
1900,"Blackburn Rovers",1,34,45,39,47,-8,1.32352941176471,1.14705882352941,1.38235294117647,-0.235294117647059,10,10,18,18,3,121,7,-0.3
1900,"Blackpool",2,34,43,33,58,-25,1.26470588235294,0.970588235294118,1.70588235294118,-0.735294117647059,29,11,18,36,30,112,-1,0.3
1900,"Bolton Wanderers",1,34,46,39,55,-16,1.35294117647059,1.14705882352941,1.61764705882353,-0.470588235294118,9,9,18,18,14,121,-5,-1.3
1900,"Burnley",2,34,64,53,29,24,1.88235294117647,1.55882352941176,0.852941176470588,0.705882352941177,21,3,18,36,31,121,-10,-0.7
1900,"Burton Swifts",2,34,28,34,66,-32,0.823529411764706,1,1.94117647058824,-0.941176470588235,36,18,18,36,NA,9,NA,NA
1900,"Bury",1,34,55,53,37,16,1.61764705882353,1.55882352941176,1.08823529411765,0.470588235294118,4,4,18,18,8,114,-4,-1.5
1900,"Chesterfield",2,34,37,46,58,-12,1.08823529411765,1.35294117647059,1.70588235294118,-0.352941176470588,33,15,18,36,32,100,1,-2.1
1900,"Derby County",1,34,43,55,42,13,1.26470588235294,1.61764705882353,1.23529411764706,0.382352941176471,12,12,18,18,5,121,7,-1.3
1900,"Everton",1,34,53,55,42,13,1.55882352941176,1.61764705882353,1.23529411764706,0.382352941176471,6,6,18,18,2,121,4,0.2
1900,"Gainsborough Trinity",2,34,40,45,60,-15,1.17647058823529,1.32352941176471,1.76470588235294,-0.441176470588235,31,13,18,36,36,16,-5,-0.7
1900,"Glossop North End",2,34,53,51,33,18,1.55882352941176,1.5,0.970588235294118,0.529411764705882,23,5,18,36,27,17,-4,-1
1900,"Grimsby Town",2,34,69,60,33,27,2.02941176470588,1.76470588235294,0.970588235294118,0.794117647058823,19,1,18,36,12,110,7,-1
1900,"Leicester City",2,34,43,39,37,2,1.26470588235294,1.14705882352941,1.08823529411765,0.0588235294117647,30,12,18,36,29,115,1,-0.5
1900,"Lincoln City",2,34,46,43,39,4,1.35294117647059,1.26470588235294,1.14705882352941,0.117647058823529,26,8,18,36,24,107,2,-0.3
1900,"Liverpool",1,34,64,59,35,24,1.88235294117647,1.73529411764706,1.02941176470588,0.705882352941177,1,1,18,18,15,116,-14,-0.9
1900,"Manchester City",1,34,45,48,58,-10,1.32352941176471,1.41176470588235,1.70588235294118,-0.294117647058824,11,11,18,18,18,117,-7,-0.6
1900,"Manchester United",2,34,46,42,38,4,1.35294117647059,1.23529411764706,1.11764705882353,0.117647058823529,27,9,18,36,33,117,-6,2.6
1900,"Middlesbrough",2,34,52,50,40,10,1.52941176470588,1.47058823529412,1.17647058823529,0.294117647058824,24,6,18,36,20,110,4,0.8
1900,"New Brighton Tower",2,34,59,57,38,19,1.73529411764706,1.67647058823529,1.11764705882353,0.558823529411765,22,4,18,36,NA,3,NA,NA
1900,"Newcastle United",1,34,52,42,37,5,1.52941176470588,1.23529411764706,1.08823529411765,0.147058823529412,7,7,18,18,4,116,3,-0.1
1900,"Nottingham Forest",1,34,55,53,36,17,1.61764705882353,1.55882352941176,1.05882352941176,0.5,5,5,18,18,6,117,-1,-1.5
1900,"Notts County",1,34,58,54,46,8,1.70588235294118,1.58823529411765,1.35294117647059,0.235294117647059,2,2,18,18,10,120,-8,-0.9
1900,"Port Vale",2,34,44,45,47,-2,1.29411764705882,1.32352941176471,1.38235294117647,-0.0588235294117647,28,10,18,36,34,107,-6,-1
1900,"Preston North End",1,34,34,49,75,-26,1,1.44117647058824,2.20588235294118,-0.764705882352941,17,17,18,18,22,121,-5,0.3
1900,"Sheffield United",1,34,43,35,52,-17,1.26470588235294,1.02941176470588,1.52941176470588,-0.5,13,13,18,18,11,117,2,0.4
1900,"Sheffield Wednesday",1,34,49,52,42,10,1.44117647058824,1.52941176470588,1.23529411764706,0.294117647058824,8,8,18,18,9,117,-1,0.2
1900,"Stockport County",2,34,36,38,68,-30,1.05882352941176,1.11764705882353,2,-0.882352941176471,34,16,18,36,35,99,-1,-0.3
1900,"Stoke City",1,34,38,46,57,-11,1.11764705882353,1.35294117647059,1.67647058823529,-0.323529411764706,16,16,18,18,16,113,0,-0.9
1900,"Sunderland",1,34,58,57,26,31,1.70588235294118,1.67647058823529,0.764705882352941,0.911764705882353,3,3,18,18,1,119,2,-0.2
1900,"Walsall",2,34,34,40,56,-16,1,1.17647058823529,1.64705882352941,-0.470588235294118,35,17,18,36,61,100,-26,-4.1
1900,"West Bromwich Albion",1,34,29,35,62,-27,0.852941176470588,1.02941176470588,1.82352941176471,-0.794117647058823,18,18,18,18,19,121,-1,-0.3
1900,"Wolverhampton Wanderers",1,34,40,39,55,-16,1.17647058823529,1.14705882352941,1.61764705882353,-0.470588235294118,15,15,18,18,13,121,2,-1.4
1901,"Arsenal",2,34,60,50,26,24,1.76470588235294,1.47058823529412,0.764705882352941,0.705882352941177,21,3,18,36,21,116,0,1.2
1901,"Aston Villa",1,34,47,42,40,2,1.38235294117647,1.23529411764706,1.17647058823529,0.0588235294117647,7,7,18,18,2,121,5,0.2
1901,"Barnsley",2,34,42,51,63,-12,1.23529411764706,1.5,1.85294117647059,-0.352941176470588,26,8,18,36,26,111,0,-0.1
1901,"Birmingham City",1,34,41,47,45,2,1.20588235294118,1.38235294117647,1.32352941176471,0.0588235294117647,17,17,18,18,20,117,-3,-1.4
1901,"Blackburn Rovers",1,34,51,52,48,4,1.5,1.52941176470588,1.41176470588235,0.117647058823529,3,3,18,18,16,121,-13,0.2
1901,"Blackpool",2,34,40,40,56,-16,1.17647058823529,1.17647058823529,1.64705882352941,-0.470588235294118,30,12,18,36,33,112,-3,-0.4
1901,"Bolton Wanderers",1,34,44,51,56,-5,1.29411764705882,1.5,1.64705882352941,-0.147058823529412,14,14,18,18,18,121,-4,1.1
1901,"Bristol City",2,34,57,52,35,17,1.67647058823529,1.52941176470588,1.02941176470588,0.5,23,5,18,36,22,108,1,-1
1901,"Burnley",2,34,40,41,45,-4,1.17647058823529,1.20588235294118,1.32352941176471,-0.117647058823529,31,13,18,36,36,121,-5,0.8
1901,"Burton United",2,34,41,46,54,-8,1.20588235294118,1.35294117647059,1.58823529411765,-0.235294117647059,28,10,18,36,29,6,-1,NA
1901,"Bury",1,34,47,44,38,6,1.38235294117647,1.29411764705882,1.11764705882353,0.176470588235294,8,8,18,18,8,114,0,-1.2
1901,"Chesterfield",2,34,39,47,68,-21,1.14705882352941,1.38235294117647,2,-0.617647058823529,32,14,18,36,24,100,8,-1.7
1901,"Derby County",1,34,48,39,41,-2,1.41176470588235,1.14705882352941,1.20588235294118,-0.0588235294117647,5,5,18,18,9,121,-4,-1.7
1901,"Doncaster Rovers",2,34,47,49,58,-9,1.38235294117647,1.44117647058824,1.70588235294118,-0.264705882352941,25,7,18,36,34,88,-9,-5.2
1901,"Everton",1,34,58,53,35,18,1.70588235294118,1.55882352941176,1.02941176470588,0.529411764705882,2,2,18,18,14,121,-12,0
1901,"Gainsborough Trinity",2,34,23,30,80,-50,0.676470588235294,0.882352941176471,2.35294117647059,-1.47058823529412,36,18,18,36,30,16,6,-0.4
1901,"Glossop North End",2,34,42,36,40,-4,1.23529411764706,1.05882352941176,1.17647058823529,-0.117647058823529,27,9,18,36,31,17,-4,-1.2
1901,"Grimsby Town",1,34,45,44,60,-16,1.32352941176471,1.29411764705882,1.76470588235294,-0.470588235294118,12,12,18,18,17,110,-5,-1.5
1901,"Leicester City",2,34,41,38,56,-18,1.20588235294118,1.11764705882353,1.64705882352941,-0.529411764705882,29,11,18,36,32,115,-3,-0.1
1901,"Lincoln City",2,34,55,45,35,10,1.61764705882353,1.32352941176471,1.02941176470588,0.294117647058824,24,6,18,36,28,107,-4,-1.5
1901,"Liverpool",1,34,42,42,38,4,1.23529411764706,1.23529411764706,1.11764705882353,0.117647058823529,15,15,18,18,5,116,10,-0.2
1901,"Manchester City",1,34,39,42,58,-16,1.14705882352941,1.23529411764706,1.70588235294118,-0.470588235294118,18,18,18,18,19,117,-1,0.2
1901,"Manchester United",2,34,39,38,53,-15,1.14705882352941,1.11764705882353,1.55882352941176,-0.441176470588235,33,15,18,36,23,117,10,2
1901,"Middlesbrough",2,34,74,90,24,66,2.17647058823529,2.64705882352941,0.705882352941177,1.94117647058824,20,2,18,36,12,110,8,1.3
1901,"Newcastle United",1,34,51,48,34,14,1.5,1.41176470588235,1,0.411764705882353,4,4,18,18,13,116,-9,0
1901,"Nottingham Forest",1,34,48,43,43,0,1.41176470588235,1.26470588235294,1.26470588235294,0,6,6,18,18,10,117,-4,-2.9
1901,"Notts County",1,34,46,51,57,-6,1.35294117647059,1.5,1.67647058823529,-0.176470588235294,10,10,18,18,15,120,-5,-0.4
1901,"Port Vale",2,34,39,43,59,-16,1.14705882352941,1.26470588235294,1.73529411764706,-0.470588235294118,34,16,18,36,27,107,7,-0.4
1901,"Preston North End",2,34,60,71,32,39,1.76470588235294,2.08823529411765,0.941176470588235,1.14705882352941,22,4,18,36,25,121,-3,0.3
1901,"Sheffield United",1,34,46,53,48,5,1.35294117647059,1.55882352941176,1.41176470588235,0.147058823529412,11,11,18,18,4,117,7,-0.4
1901,"Sheffield Wednesday",1,34,47,48,52,-4,1.38235294117647,1.41176470588235,1.52941176470588,-0.117647058823529,9,9,18,18,1,117,8,0.3
1901,"Stockport County",2,34,31,36,72,-36,0.911764705882353,1.05882352941176,2.11764705882353,-1.05882352941176,35,17,18,36,35,99,0,-0.5
1901,"Stoke City",1,34,42,45,55,-10,1.23529411764706,1.32352941176471,1.61764705882353,-0.294117647058824,16,16,18,18,6,113,10,-0.6
1901,"Sunderland",1,34,63,50,35,15,1.85294117647059,1.47058823529412,1.02941176470588,0.441176470588235,1,1,18,18,3,119,-2,-1
1901,"West Bromwich Albion",2,34,80,82,29,53,2.35294117647059,2.41176470588235,0.852941176470588,1.55882352941176,19,1,18,36,7,121,12,1.1
1901,"Wolverhampton Wanderers",1,34,45,46,57,-11,1.32352941176471,1.35294117647059,1.67647058823529,-0.323529411764706,13,13,18,18,11,121,2,-1.3
1902,"Arsenal",2,34,68,66,30,36,2,1.94117647058824,0.882352941176471,1.05882352941176,21,3,18,36,19,116,2,0.1
1902,"Aston Villa",1,34,60,61,40,21,1.76470588235294,1.79411764705882,1.17647058823529,0.617647058823529,2,2,18,18,5,121,-3,-0.1
1902,"Barnsley",2,34,47,55,51,4,1.38235294117647,1.61764705882353,1.5,0.117647058823529,26,8,18,36,27,111,-1,0.3
1902,"Birmingham City",2,34,75,74,36,38,2.20588235294118,2.17647058823529,1.05882352941176,1.11764705882353,20,2,18,36,10,117,10,-0.4
1902,"Blackburn Rovers",1,34,41,44,63,-19,1.20588235294118,1.29411764705882,1.85294117647059,-0.558823529411765,16,16,18,18,12,121,4,1
1902,"Blackpool",2,34,37,44,59,-15,1.08823529411765,1.29411764705882,1.73529411764706,-0.441176470588235,33,15,18,36,33,112,0,-0.6
1902,"Bolton Wanderers",1,34,27,37,73,-36,0.794117647058823,1.08823529411765,2.14705882352941,-1.05882352941176,18,18,18,18,25,121,-7,1
1902,"Bristol City",2,34,59,59,38,21,1.73529411764706,1.73529411764706,1.11764705882353,0.617647058823529,22,4,18,36,22,108,0,-1.6
1902,"Burnley",2,34,26,30,77,-47,0.764705882352941,0.882352941176471,2.26470588235294,-1.38235294117647,36,18,18,36,23,121,13,1.4
1902,"Burton United",2,34,40,39,59,-20,1.17647058823529,1.14705882352941,1.73529411764706,-0.588235294117647,29,11,18,36,31,6,-2,NA
1902,"Bury",1,34,51,54,43,11,1.5,1.58823529411765,1.26470588235294,0.323529411764706,8,8,18,18,16,114,-8,-2.2
1902,"Chesterfield",2,34,51,67,40,27,1.5,1.97058823529412,1.17647058823529,0.794117647058823,24,6,18,36,29,100,-5,-3.6
1902,"Derby County",1,34,51,50,47,3,1.5,1.47058823529412,1.38235294117647,0.0882352941176471,9,9,18,18,14,121,-5,0.2
1902,"Doncaster Rovers",2,34,34,35,72,-37,1,1.02941176470588,2.11764705882353,-1.08823529411765,34,16,18,36,36,88,-2,-3.8
1902,"Everton",1,34,45,45,47,-2,1.32352941176471,1.32352941176471,1.38235294117647,-0.0588235294117647,14,14,18,18,3,121,11,0.3
1902,"Gainsborough Trinity",2,34,40,41,59,-18,1.17647058823529,1.20588235294118,1.73529411764706,-0.529411764705882,30,12,18,36,26,16,4,NA
1902,"Glossop North End",2,34,40,43,57,-14,1.17647058823529,1.26470588235294,1.67647058823529,-0.411764705882353,31,13,18,36,34,17,-3,-0.4
1902,"Grimsby Town",1,34,33,43,62,-19,0.970588235294118,1.26470588235294,1.82352941176471,-0.558823529411765,17,17,18,18,24,110,-7,-1.6
1902,"Leicester City",2,34,38,41,65,-24,1.11764705882353,1.20588235294118,1.91176470588235,-0.705882352941177,32,14,18,36,36,115,-4,-0.2
1902,"Lincoln City",2,34,42,46,53,-7,1.23529411764706,1.35294117647059,1.55882352941176,-0.205882352941176,28,10,18,36,30,107,-2,-0.9
1902,"Liverpool",1,34,55,68,49,19,1.61764705882353,2,1.44117647058824,0.558823529411765,5,5,18,18,17,116,-12,-0.5
1902,"Manchester City",2,34,79,95,29,66,2.32352941176471,2.79411764705882,0.852941176470588,1.94117647058824,19,1,18,36,2,117,17,1.4
1902,"Manchester United",2,34,53,53,38,15,1.55882352941176,1.55882352941176,1.11764705882353,0.441176470588235,23,5,18,36,21,117,2,1.9
1902,"Middlesbrough",1,34,46,41,50,-9,1.35294117647059,1.20588235294118,1.47058823529412,-0.264705882352941,12,12,18,18,13,110,-1,-0.4
1902,"Newcastle United",1,34,46,41,51,-10,1.35294117647059,1.20588235294118,1.5,-0.294117647058824,13,13,18,18,4,116,9,-0.2
1902,"Nottingham Forest",1,34,49,49,47,2,1.44117647058824,1.44117647058824,1.38235294117647,0.0588235294117647,10,10,18,18,9,117,1,-2.7
1902,"Notts County",1,34,43,41,49,-8,1.26470588235294,1.20588235294118,1.44117647058824,-0.235294117647059,15,15,18,18,11,120,4,-0.4
1902,"Port Vale",2,34,47,57,62,-5,1.38235294117647,1.67647058823529,1.82352941176471,-0.147058823529412,27,9,18,36,32,107,-5,-0.2
1902,"Preston North End",2,34,49,56,40,16,1.44117647058824,1.64705882352941,1.17647058823529,0.470588235294118,25,7,18,36,20,121,5,0.4
1902,"Sheffield United",1,34,56,58,44,14,1.64705882352941,1.70588235294118,1.29411764705882,0.411764705882353,4,4,18,18,7,117,-3,-0.9
1902,"Sheffield Wednesday",1,34,61,54,36,18,1.79411764705882,1.58823529411765,1.05882352941176,0.529411764705882,1,1,18,18,1,117,0,-0.1
1902,"Stockport County",2,34,27,38,74,-36,0.794117647058823,1.11764705882353,2.17647058823529,-1.05882352941176,35,17,18,36,35,99,0,0.3
1902,"Stoke City",1,34,52,46,38,8,1.52941176470588,1.35294117647059,1.11764705882353,0.235294117647059,6,6,18,18,15,113,-9,-2.4
1902,"Sunderland",1,34,57,51,36,15,1.67647058823529,1.5,1.05882352941176,0.441176470588235,3,3,18,18,6,119,-3,0.2
1902,"West Bromwich Albion",1,34,52,54,53,1,1.52941176470588,1.58823529411765,1.55882352941176,0.0294117647058824,7,7,18,18,18,121,-11,-0.5
1902,"Wolverhampton Wanderers",1,34,47,48,57,-9,1.38235294117647,1.41176470588235,1.67647058823529,-0.264705882352941,11,11,18,18,8,121,3,-2
1903,"Arsenal",2,34,70,91,22,69,2.05882352941176,2.67647058823529,0.647058823529412,2.02941176470588,19,1,18,36,10,116,9,-0.4
1903,"Aston Villa",1,34,58,70,48,22,1.70588235294118,2.05882352941176,1.41176470588235,0.647058823529412,5,5,18,18,4,121,1,0.3
1903,"Barnsley",2,34,43,38,57,-19,1.26470588235294,1.11764705882353,1.67647058823529,-0.558823529411765,27,9,18,36,25,111,2,0.2
1903,"Birmingham City",1,34,41,39,52,-13,1.20588235294118,1.14705882352941,1.52941176470588,-0.382352941176471,10,10,18,18,6,117,4,-2.5
1903,"Blackburn Rovers",1,34,39,48,60,-12,1.14705882352941,1.41176470588235,1.76470588235294,-0.352941176470588,12,12,18,18,13,121,-1,1.1
1903,"Blackpool",2,34,38,40,67,-27,1.11764705882353,1.17647058823529,1.97058823529412,-0.794117647058823,33,15,18,36,33,112,0,-0.3
1903,"Bolton Wanderers",2,34,46,59,41,18,1.35294117647059,1.73529411764706,1.20588235294118,0.529411764705882,25,7,18,36,20,121,5,2
1903,"Bradford City",2,34,43,45,59,-14,1.26470588235294,1.32352941176471,1.73529411764706,-0.411764705882353,28,10,18,36,26,106,2,1.7
1903,"Bristol City",2,34,60,73,41,32,1.76470588235294,2.14705882352941,1.20588235294118,0.941176470588235,22,4,18,36,22,108,0,-0.6
1903,"Burnley",2,34,54,50,55,-5,1.58823529411765,1.47058823529412,1.61764705882353,-0.147058823529412,23,5,18,36,29,121,-6,0.8
1903,"Burton United",2,34,40,45,61,-16,1.17647058823529,1.32352941176471,1.79411764705882,-0.470588235294118,31,13,18,36,35,6,-4,NA
1903,"Bury",1,34,36,40,53,-13,1.05882352941176,1.17647058823529,1.55882352941176,-0.382352941176471,16,16,18,18,16,114,0,-1.4
1903,"Chesterfield",2,34,41,37,45,-8,1.20588235294118,1.08823529411765,1.32352941176471,-0.235294117647059,29,11,18,36,23,100,6,-1.9
1903,"Derby County",1,34,37,58,60,-2,1.08823529411765,1.70588235294118,1.76470588235294,-0.0588235294117647,14,14,18,18,11,121,3,-0.6
1903,"Everton",1,34,62,59,32,27,1.82352941176471,1.73529411764706,0.941176470588235,0.794117647058823,3,3,18,18,2,121,1,-1.3
1903,"Gainsborough Trinity",2,34,45,53,60,-7,1.32352941176471,1.55882352941176,1.76470588235294,-0.205882352941176,26,8,18,36,24,16,2,NA
1903,"Glossop North End",2,34,36,57,64,-7,1.05882352941176,1.67647058823529,1.88235294117647,-0.205882352941176,34,16,18,36,31,17,3,-0.3
1903,"Grimsby Town",2,34,50,50,49,1,1.47058823529412,1.47058823529412,1.44117647058824,0.0294117647058824,24,6,18,36,30,110,-6,-1.2
1903,"Leicester City",2,34,28,42,82,-40,0.823529411764706,1.23529411764706,2.41176470588235,-1.17647058823529,36,18,18,36,32,115,4,-0.2
1903,"Lincoln City",2,34,41,41,58,-17,1.20588235294118,1.20588235294118,1.70588235294118,-0.5,30,12,18,36,27,107,3,-1.3
1903,"Liverpool",1,34,35,49,62,-13,1.02941176470588,1.44117647058824,1.82352941176471,-0.382352941176471,17,17,18,18,19,116,-2,0.3
1903,"Manchester City",1,34,63,71,45,26,1.85294117647059,2.08823529411765,1.32352941176471,0.764705882352941,2,2,18,18,3,117,-1,-1
1903,"Manchester United",2,34,68,65,33,32,2,1.91176470588235,0.970588235294118,0.941176470588235,21,3,18,36,21,117,0,1.1
1903,"Middlesbrough",1,34,39,46,47,-1,1.14705882352941,1.35294117647059,1.38235294117647,-0.0294117647058824,13,13,18,18,15,110,-2,1
1903,"Newcastle United",1,34,60,58,45,13,1.76470588235294,1.70588235294118,1.32352941176471,0.382352941176471,4,4,18,18,1,116,3,-0.9
1903,"Nottingham Forest",1,34,42,57,57,0,1.23529411764706,1.67647058823529,1.67647058823529,0,9,9,18,18,17,117,-8,-3.1
1903,"Notts County",1,34,41,37,61,-24,1.20588235294118,1.08823529411765,1.79411764705882,-0.705882352941177,11,11,18,18,18,120,-7,-1
1903,"Port Vale",2,34,39,54,52,2,1.14705882352941,1.58823529411765,1.52941176470588,0.0588235294117647,32,14,18,36,34,107,-2,0.3
1903,"Preston North End",2,34,70,62,24,38,2.05882352941176,1.82352941176471,0.705882352941177,1.11764705882353,20,2,18,36,8,121,12,0.1
1903,"Sheffield United",1,34,53,62,57,5,1.55882352941176,1.82352941176471,1.67647058823529,0.147058823529412,7,7,18,18,5,117,2,-0.2
1903,"Sheffield Wednesday",1,34,67,48,28,20,1.97058823529412,1.41176470588235,0.823529411764706,0.588235294117647,1,1,18,18,9,117,-8,-1.6
1903,"Stockport County",2,34,35,40,72,-32,1.02941176470588,1.17647058823529,2.11764705882353,-0.941176470588235,35,17,18,36,30,99,5,0.1
1903,"Stoke City",1,34,37,54,57,-3,1.08823529411765,1.58823529411765,1.67647058823529,-0.0882352941176471,15,15,18,18,12,113,3,-2.7
1903,"Sunderland",1,34,56,63,49,14,1.64705882352941,1.85294117647059,1.44117647058824,0.411764705882353,6,6,18,18,7,119,-1,-0.1
1903,"West Bromwich Albion",1,34,31,36,60,-24,0.911764705882353,1.05882352941176,1.76470588235294,-0.705882352941177,18,18,18,18,28,121,-10,1.2
1903,"Wolverhampton Wanderers",1,34,50,44,66,-22,1.47058823529412,1.29411764705882,1.94117647058824,-0.647058823529412,8,8,18,18,14,121,-6,-1.9
1904,"Arsenal",1,34,45,36,40,-4,1.32352941176471,1.05882352941176,1.17647058823529,-0.117647058823529,10,10,18,18,11,116,-1,-1.5
1904,"Aston Villa",1,34,61,63,43,20,1.79411764705882,1.85294117647059,1.26470588235294,0.588235294117647,4,4,18,18,8,121,-4,-1
1904,"Barnsley",2,34,47,38,56,-18,1.38235294117647,1.11764705882353,1.64705882352941,-0.529411764705882,25,7,18,36,32,111,-7,0.2
1904,"Birmingham City",1,34,56,54,38,16,1.64705882352941,1.58823529411765,1.11764705882353,0.470588235294118,6,6,18,18,6,117,0,-2.1
1904,"Blackburn Rovers",1,34,38,40,51,-11,1.11764705882353,1.17647058823529,1.5,-0.323529411764706,13,13,18,18,9,121,4,1
1904,"Blackpool",2,34,37,36,48,-12,1.08823529411765,1.05882352941176,1.41176470588235,-0.352941176470588,33,15,18,36,36,112,-3,0.3
1904,"Bolton Wanderers",2,34,83,87,32,55,2.44117647058824,2.55882352941176,0.941176470588235,1.61764705882353,20,2,18,36,7,121,13,0.4
1904,"Bradford City",2,34,44,45,49,-4,1.29411764705882,1.32352941176471,1.44117647058824,-0.117647058823529,26,8,18,36,31,106,-5,1.5
1904,"Bristol City",2,34,61,66,45,21,1.79411764705882,1.94117647058824,1.32352941176471,0.617647058823529,22,4,18,36,21,108,1,-1
1904,"Burnley",2,34,42,43,52,-9,1.23529411764706,1.26470588235294,1.52941176470588,-0.264705882352941,29,11,18,36,29,121,0,2.5
1904,"Burton United",2,34,28,30,84,-54,0.823529411764706,0.882352941176471,2.47058823529412,-1.58823529411765,35,17,18,36,39,6,-4,NA
1904,"Bury",1,34,34,47,67,-20,1,1.38235294117647,1.97058823529412,-0.588235294117647,16,16,18,18,18,114,-2,-1.5
1904,"Chesterfield",2,34,53,44,35,9,1.55882352941176,1.29411764705882,1.02941176470588,0.264705882352941,23,5,18,36,37,100,-14,-3.3
1904,"Derby County",1,34,44,37,48,-11,1.29411764705882,1.08823529411765,1.41176470588235,-0.323529411764706,11,11,18,18,15,121,-4,-1
1904,"Doncaster Rovers",2,34,11,23,81,-58,0.323529411764706,0.676470588235294,2.38235294117647,-1.70588235294118,36,18,18,36,63,88,-27,-2.1
1904,"Everton",1,34,68,63,36,27,2,1.85294117647059,1.05882352941176,0.794117647058823,2,2,18,18,12,121,-10,0.1
1904,"Gainsborough Trinity",2,34,50,61,58,3,1.47058823529412,1.79411764705882,1.70588235294118,0.0882352941176471,24,6,18,36,34,16,-10,NA
1904,"Glossop North End",2,34,40,37,46,-9,1.17647058823529,1.08823529411765,1.35294117647059,-0.264705882352941,31,13,18,36,38,17,-7,-0.9
1904,"Grimsby Town",2,34,41,33,46,-13,1.20588235294118,0.970588235294118,1.35294117647059,-0.382352941176471,30,12,18,36,28,110,2,-1.4
1904,"Leicester City",2,34,40,40,55,-15,1.17647058823529,1.17647058823529,1.61764705882353,-0.441176470588235,32,14,18,36,27,115,5,-0.7
1904,"Lincoln City",2,34,43,42,40,2,1.26470588235294,1.23529411764706,1.17647058823529,0.0588235294117647,27,9,18,36,33,107,-6,-4.9
1904,"Liverpool",2,34,85,93,25,68,2.5,2.73529411764706,0.735294117647059,2,19,1,18,36,1,116,18,0.7
1904,"Manchester City",1,34,66,66,37,29,1.94117647058824,1.94117647058824,1.08823529411765,0.852941176470588,3,3,18,18,3,117,0,-0.4
1904,"Manchester United",2,34,77,81,30,51,2.26470588235294,2.38235294117647,0.882352941176471,1.5,21,3,18,36,22,117,-1,0.3
1904,"Middlesbrough",1,34,35,36,56,-20,1.02941176470588,1.05882352941176,1.64705882352941,-0.588235294117647,15,15,18,18,19,110,-4,0.2
1904,"Newcastle United",1,34,71,72,33,39,2.08823529411765,2.11764705882353,0.970588235294118,1.14705882352941,1,1,18,18,5,116,-4,-1.4
1904,"Nottingham Forest",1,34,34,40,61,-21,1,1.17647058823529,1.79411764705882,-0.617647058823529,17,17,18,18,17,117,0,-2.1
1904,"Notts County",1,34,23,36,69,-33,0.676470588235294,1.05882352941176,2.02941176470588,-0.970588235294118,18,18,18,18,16,120,2,0.1
1904,"Port Vale",2,34,37,47,72,-25,1.08823529411765,1.38235294117647,2.11764705882353,-0.735294117647059,34,16,18,36,35,107,-1,0.2
1904,"Preston North End",1,34,49,42,37,5,1.44117647058824,1.23529411764706,1.08823529411765,0.147058823529412,8,8,18,18,2,121,6,-1.4
1904,"Sheffield United",1,34,59,64,56,8,1.73529411764706,1.88235294117647,1.64705882352941,0.235294117647059,5,5,18,18,13,117,-8,-0.3
1904,"Sheffield Wednesday",1,34,47,61,57,4,1.38235294117647,1.79411764705882,1.67647058823529,0.117647058823529,9,9,18,18,4,117,5,0
1904,"Stoke City",1,34,43,40,58,-18,1.26470588235294,1.17647058823529,1.70588235294118,-0.529411764705882,12,12,18,18,10,113,2,-3.1
1904,"Sunderland",1,34,56,60,44,16,1.64705882352941,1.76470588235294,1.29411764705882,0.470588235294118,7,7,18,18,14,119,-7,0.2
1904,"West Bromwich Albion",2,34,43,56,48,8,1.26470588235294,1.64705882352941,1.41176470588235,0.235294117647059,28,10,18,36,24,121,4,1.8
1904,"Wolverhampton Wanderers",1,34,37,47,73,-26,1.08823529411765,1.38235294117647,2.14705882352941,-0.764705882352941,14,14,18,18,20,121,-6,-1
1905,"Arsenal",1,38,52,62,64,-2,1.36842105263158,1.63157894736842,1.68421052631579,-0.0526315789473684,11,11,20,20,4,116,7,0.1
1905,"Aston Villa",1,38,57,72,56,16,1.5,1.89473684210526,1.47368421052632,0.421052631578947,8,8,20,20,5,121,3,0
1905,"Barnsley",2,38,45,60,62,-2,1.18421052631579,1.57894736842105,1.63157894736842,-0.0526315789473684,32,12,20,40,28,111,4,-0.2
1905,"Birmingham City",1,38,58,65,59,6,1.52631578947368,1.71052631578947,1.55263157894737,0.157894736842105,6,6,20,20,9,117,-3,-1.9
1905,"Blackburn Rovers",1,38,56,54,52,2,1.47368421052632,1.42105263157895,1.36842105263158,0.0526315789473684,9,9,20,20,12,121,-3,-1
1905,"Blackpool",2,38,39,37,62,-25,1.02631578947368,0.973684210526316,1.63157894736842,-0.657894736842105,36,16,20,40,35,112,1,1
1905,"Bolton Wanderers",1,38,58,81,67,14,1.52631578947368,2.13157894736842,1.76315789473684,0.368421052631579,7,7,20,20,6,121,1,0.1
1905,"Bradford City",2,38,47,46,60,-14,1.23684210526316,1.21052631578947,1.57894736842105,-0.368421052631579,31,11,20,40,23,106,8,1.7
1905,"Bristol City",2,38,96,83,28,55,2.52631578947368,2.18421052631579,0.736842105263158,1.44736842105263,21,1,20,40,2,108,19,-1.2
1905,"Burnley",2,38,53,42,53,-11,1.39473684210526,1.10526315789474,1.39473684210526,-0.289473684210526,29,9,20,40,27,121,2,2.7
1905,"Burton United",2,38,36,34,67,-33,0.947368421052632,0.894736842105263,1.76315789473684,-0.868421052631579,39,19,20,40,40,6,-1,NA
1905,"Bury",1,38,43,57,74,-17,1.13157894736842,1.5,1.94736842105263,-0.447368421052632,18,18,20,20,16,114,2,-0.9
1905,"Chelsea",2,38,75,90,37,53,1.97368421052632,2.36842105263158,0.973684210526316,1.39473684210526,23,3,20,40,22,104,1,2
1905,"Chesterfield",2,38,38,40,72,-32,1,1.05263157894737,1.89473684210526,-0.842105263157895,37,17,20,40,38,100,-1,-3.9
1905,"Derby County",1,38,49,39,58,-19,1.28947368421053,1.02631578947368,1.52631578947368,-0.5,15,15,20,20,19,121,-4,-0.3
1905,"Everton",1,38,52,70,66,4,1.36842105263158,1.84210526315789,1.73684210526316,0.105263157894737,12,12,20,20,3,121,9,-0.8
1905,"Gainsborough Trinity",2,38,40,44,57,-13,1.05263157894737,1.15789473684211,1.5,-0.342105263157895,34,14,20,40,32,16,2,NA
1905,"Glossop North End",2,38,38,49,71,-22,1,1.28947368421053,1.86842105263158,-0.578947368421053,38,18,20,40,34,17,4,NA
1905,"Grimsby Town",2,38,55,46,46,0,1.44736842105263,1.21052631578947,1.21052631578947,0,28,8,20,40,30,110,-2,-2.7
1905,"Hull City",2,38,63,67,54,13,1.65789473684211,1.76315789473684,1.42105263157895,0.342105263157895,25,5,20,40,29,104,-4,-0.5
1905,"Leeds City",2,38,60,59,47,12,1.57894736842105,1.55263157894737,1.23684210526316,0.315789473684211,26,6,20,40,31,11,-5,-1.9
1905,"Leicester City",2,38,57,53,48,5,1.5,1.39473684210526,1.26315789473684,0.131578947368421,27,7,20,40,24,115,3,-0.8
1905,"Leyton Orient",2,38,28,35,78,-43,0.736842105263158,0.921052631578947,2.05263157894737,-1.13157894736842,40,20,20,40,37,102,3,0.4
1905,"Lincoln City",2,38,42,69,72,-3,1.10526315789474,1.81578947368421,1.89473684210526,-0.0789473684210526,33,13,20,40,39,107,-6,-3.8
1905,"Liverpool",1,38,74,79,46,33,1.94736842105263,2.07894736842105,1.21052631578947,0.868421052631579,1,1,20,20,15,116,-14,-0.4
1905,"Manchester City",1,38,62,73,54,19,1.63157894736842,1.92105263157895,1.42105263157895,0.5,3,3,20,20,17,117,-14,-0.4
1905,"Manchester United",2,38,90,90,28,62,2.36842105263158,2.36842105263158,0.736842105263158,1.63157894736842,22,2,20,40,8,117,14,0.7
1905,"Middlesbrough",1,38,41,56,71,-15,1.07894736842105,1.47368421052632,1.86842105263158,-0.394736842105263,19,19,20,20,10,110,9,0.6
1905,"Newcastle United",1,38,61,74,48,26,1.60526315789474,1.94736842105263,1.26315789473684,0.684210526315789,5,5,20,20,1,116,4,-0.4
1905,"Nottingham Forest",1,38,44,58,79,-21,1.15789473684211,1.52631578947368,2.07894736842105,-0.552631578947368,17,17,20,20,21,117,-4,-2.2
1905,"Notts County",1,38,45,55,71,-16,1.18421052631579,1.44736842105263,1.86842105263158,-0.421052631578947,16,16,20,20,18,120,-2,-0.5
1905,"Port Vale",2,38,40,49,82,-33,1.05263157894737,1.28947368421053,2.15789473684211,-0.868421052631579,35,15,20,40,36,107,-1,0.4
1905,"Preston North End",1,38,64,54,39,15,1.68421052631579,1.42105263157895,1.02631578947368,0.394736842105263,2,2,20,20,13,121,-11,-1.5
1905,"Sheffield United",1,38,51,57,62,-5,1.34210526315789,1.5,1.63157894736842,-0.131578947368421,13,13,20,20,7,117,6,0.1
1905,"Sheffield Wednesday",1,38,62,63,52,11,1.63157894736842,1.65789473684211,1.36842105263158,0.289473684210526,4,4,20,20,14,117,-10,-1.8
1905,"Stockport County",2,38,48,44,56,-12,1.26315789473684,1.15789473684211,1.47368421052632,-0.315789473684211,30,10,20,40,33,99,-3,-0.7
1905,"Stoke City",1,38,55,54,55,-1,1.44736842105263,1.42105263157895,1.44736842105263,-0.0263157894736842,10,10,20,20,20,113,-10,-3.5
1905,"Sunderland",1,38,50,61,70,-9,1.31578947368421,1.60526315789474,1.84210526315789,-0.236842105263158,14,14,20,20,11,119,3,1
1905,"West Bromwich Albion",2,38,74,79,36,43,1.94736842105263,2.07894736842105,0.947368421052632,1.13157894736842,24,4,20,40,25,121,-1,2.3
1905,"Wolverhampton Wanderers",1,38,31,58,99,-41,0.815789473684211,1.52631578947368,2.60526315789474,-1.07894736842105,20,20,20,20,26,121,-6,-2.1
1906,"Arsenal",1,38,64,66,59,7,1.68421052631579,1.73684210526316,1.55263157894737,0.184210526315789,4,4,20,20,13,116,-9,-0.6
1906,"Aston Villa",1,38,63,78,52,26,1.65789473684211,2.05263157894737,1.36842105263158,0.684210526315789,5,5,20,20,3,121,2,-0.4
1906,"Barnsley",2,38,53,73,55,18,1.39473684210526,1.92105263157895,1.44736842105263,0.473684210526316,28,8,20,40,35,111,-7,-1.5
1906,"Birmingham City",1,38,53,52,52,0,1.39473684210526,1.36842105263158,1.36842105263158,0,9,9,20,20,20,117,-11,-1.4
1906,"Blackburn Rovers",1,38,49,56,59,-3,1.28947368421053,1.47368421052632,1.55263157894737,-0.0789473684210526,12,12,20,20,14,121,-2,-0.1
1906,"Blackpool",2,38,44,33,51,-18,1.15789473684211,0.868421052631579,1.34210526315789,-0.473684210526316,35,15,20,40,36,112,-1,1
1906,"Bolton Wanderers",1,38,62,59,47,12,1.63157894736842,1.55263157894737,1.23684210526316,0.315789473684211,6,6,20,20,17,121,-11,0.3
1906,"Bradford City",2,38,68,70,53,17,1.78947368421053,1.84210526315789,1.39473684210526,0.447368421052632,23,3,20,40,21,106,2,0.5
1906,"Bristol City",1,38,68,66,47,19,1.78947368421053,1.73684210526316,1.23684210526316,0.5,2,2,20,20,15,108,-13,-2.4
1906,"Burnley",2,38,57,62,47,15,1.5,1.63157894736842,1.23684210526316,0.394736842105263,27,7,20,40,27,121,0,2.6
1906,"Burton United",2,38,31,34,68,-34,0.815789473684211,0.894736842105263,1.78947368421053,-0.894736842105263,40,20,20,40,NA,6,NA,NA
1906,"Bury",1,38,45,58,68,-10,1.18421052631579,1.52631578947368,1.78947368421053,-0.263157894736842,16,16,20,20,8,114,8,-1.7
1906,"Chelsea",2,38,83,80,34,46,2.18421052631579,2.10526315789474,0.894736842105263,1.21052631578947,22,2,20,40,11,104,11,0.5
1906,"Chesterfield",2,38,40,50,66,-16,1.05263157894737,1.31578947368421,1.73684210526316,-0.421052631578947,38,18,20,40,40,100,-2,-2.6
1906,"Derby County",1,38,36,41,59,-18,0.947368421052632,1.07894736842105,1.55263157894737,-0.473684210526316,19,19,20,20,25,121,-6,-0.3
1906,"Everton",1,38,65,70,46,24,1.71052631578947,1.84210526315789,1.21052631578947,0.631578947368421,3,3,20,20,9,121,-6,-0.4
1906,"Gainsborough Trinity",2,38,47,45,72,-27,1.23684210526316,1.18421052631579,1.89473684210526,-0.710526315789474,32,12,20,40,31,16,1,NA
1906,"Glossop North End",2,38,45,53,79,-26,1.18421052631579,1.39473684210526,2.07894736842105,-0.684210526315789,34,14,20,40,37,17,-3,NA
1906,"Grimsby Town",2,38,51,57,62,-5,1.34210526315789,1.5,1.63157894736842,-0.131578947368421,30,10,20,40,38,110,-8,-2
1906,"Hull City",2,38,52,65,57,8,1.36842105263158,1.71052631578947,1.5,0.210526315789474,29,9,20,40,26,104,3,-0.8
1906,"Leeds City",2,38,49,55,63,-8,1.28947368421053,1.44736842105263,1.65789473684211,-0.210526315789474,31,11,20,40,32,11,-1,NA
1906,"Leicester City",2,38,68,62,39,23,1.78947368421053,1.63157894736842,1.02631578947368,0.605263157894737,24,4,20,40,22,115,2,-1.2
1906,"Leyton Orient",2,38,41,45,67,-22,1.07894736842105,1.18421052631579,1.76315789473684,-0.578947368421053,37,17,20,40,34,102,3,0.8
1906,"Lincoln City",2,38,40,46,73,-27,1.05263157894737,1.21052631578947,1.92105263157895,-0.710526315789474,39,19,20,40,39,107,0,-4.4
1906,"Liverpool",1,38,46,64,65,-1,1.21052631578947,1.68421052631579,1.71052631578947,-0.0263157894736842,15,15,20,20,7,116,8,1
1906,"Manchester City",1,38,42,53,77,-24,1.10526315789474,1.39473684210526,2.02631578947368,-0.631578947368421,17,17,20,20,4,117,13,1.5
1906,"Manchester United",1,38,59,53,56,-3,1.55263157894737,1.39473684210526,1.47368421052632,-0.0789473684210526,8,8,20,20,1,117,7,-0.3
1906,"Middlesbrough",1,38,51,56,63,-7,1.34210526315789,1.47368421052632,1.65789473684211,-0.184210526315789,10,10,20,20,5,110,5,0.2
1906,"Newcastle United",1,38,73,74,46,28,1.92105263157895,1.94736842105263,1.21052631578947,0.736842105263158,1,1,20,20,6,116,-5,-0.3
1906,"Nottingham Forest",2,38,88,74,36,38,2.31578947368421,1.94736842105263,0.947368421052632,1,21,1,20,40,12,117,9,-1.7
1906,"Notts County",1,38,39,46,50,-4,1.02631578947368,1.21052631578947,1.31578947368421,-0.105263157894737,18,18,20,20,18,120,0,-1
1906,"Port Vale",2,38,43,60,83,-23,1.13157894736842,1.57894736842105,2.18421052631579,-0.605263157894737,36,16,20,40,40,107,-4,-0.6
1906,"Preston North End",1,38,49,44,57,-13,1.28947368421053,1.15789473684211,1.5,-0.342105263157895,13,13,20,20,16,121,-3,-0.2
1906,"Sheffield United",1,38,62,57,55,2,1.63157894736842,1.5,1.44736842105263,0.0526315789473684,7,7,20,20,19,117,-12,-1.3
1906,"Sheffield Wednesday",1,38,47,49,60,-11,1.23684210526316,1.28947368421053,1.57894736842105,-0.289473684210526,14,14,20,20,2,117,12,-1.8
1906,"Stockport County",2,38,47,42,52,-10,1.23684210526316,1.10526315789474,1.36842105263158,-0.263157894736842,33,13,20,40,33,99,0,-1.1
1906,"Stoke City",1,38,34,41,64,-23,0.894736842105263,1.07894736842105,1.68421052631579,-0.605263157894737,20,20,20,20,29,113,-9,-0.7
1906,"Sunderland",1,38,51,65,66,-1,1.34210526315789,1.71052631578947,1.73684210526316,-0.0263157894736842,11,11,20,20,10,119,1,-0.1
1906,"West Bromwich Albion",2,38,68,83,45,38,1.78947368421053,2.18421052631579,1.18421052631579,1,25,5,20,40,28,121,-3,0.9
1906,"Wolverhampton Wanderers",2,38,58,66,53,13,1.52631578947368,1.73684210526316,1.39473684210526,0.342105263157895,26,6,20,40,30,121,-4,-0.8
1907,"Arsenal",1,38,48,51,63,-12,1.26315789473684,1.34210526315789,1.65789473684211,-0.315789473684211,13,13,20,20,6,116,7,-0.2
1907,"Aston Villa",1,38,60,77,59,18,1.57894736842105,2.02631578947368,1.55263157894737,0.473684210526316,3,3,20,20,7,121,-4,-0.1
1907,"Barnsley",2,38,42,54,68,-14,1.10526315789474,1.42105263157895,1.78947368421053,-0.368421052631579,35,15,20,40,38,111,-3,1.1
1907,"Birmingham City",1,38,39,40,60,-20,1.02631578947368,1.05263157894737,1.57894736842105,-0.526315789473684,20,20,20,20,30,117,-10,0.4
1907,"Blackburn Rovers",1,38,48,51,63,-12,1.26315789473684,1.34210526315789,1.65789473684211,-0.315789473684211,14,14,20,20,5,121,9,-0.3
1907,"Blackpool",2,38,42,51,58,-7,1.10526315789474,1.34210526315789,1.52631578947368,-0.184210526315789,36,16,20,40,40,112,-4,-0.3
1907,"Bolton Wanderers",1,38,47,52,58,-6,1.23684210526316,1.36842105263158,1.52631578947368,-0.157894736842105,17,17,20,20,21,121,-4,1.2
1907,"Bradford City",2,38,78,90,42,48,2.05263157894737,2.36842105263158,1.10526315789474,1.26315789473684,21,1,20,40,19,106,2,0
1907,"Bristol City",1,38,48,58,61,-3,1.26315789473684,1.52631578947368,1.60526315789474,-0.0789473684210526,15,15,20,20,9,108,6,-2.9
1907,"Burnley",2,38,66,67,50,17,1.73684210526316,1.76315789473684,1.31578947368421,0.447368421052632,27,7,20,40,34,121,-7,2.4
1907,"Bury",1,38,53,58,61,-3,1.39473684210526,1.52631578947368,1.60526315789474,-0.0789473684210526,8,8,20,20,14,114,-6,-2.5
1907,"Chelsea",1,38,50,53,62,-9,1.31578947368421,1.39473684210526,1.63157894736842,-0.236842105263158,11,11,20,20,10,104,1,0.3
1907,"Chesterfield",2,38,29,46,92,-46,0.763157894736842,1.21052631578947,2.42105263157895,-1.21052631578947,40,20,20,40,39,100,1,-0.9
1907,"Derby County",2,38,67,77,45,32,1.76315789473684,2.02631578947368,1.18421052631579,0.842105263157895,25,5,20,40,25,121,0,-0.9
1907,"Everton",1,38,51,58,64,-6,1.34210526315789,1.52631578947368,1.68421052631579,-0.157894736842105,9,9,20,20,3,121,6,-1.1
1907,"Fulham",2,38,71,82,49,33,1.86842105263158,2.15789473684211,1.28947368421053,0.868421052631579,24,4,20,40,31,102,-7,-0.4
1907,"Gainsborough Trinity",2,38,49,47,71,-24,1.28947368421053,1.23684210526316,1.86842105263158,-0.631578947368421,31,11,20,40,27,16,4,NA
1907,"Glossop North End",2,38,41,54,74,-20,1.07894736842105,1.42105263157895,1.94736842105263,-0.526315789473684,37,17,20,40,28,17,9,NA
1907,"Grimsby Town",2,38,41,43,71,-28,1.07894736842105,1.13157894736842,1.86842105263158,-0.736842105263158,38,18,20,40,32,110,6,-3.7
1907,"Hull City",2,38,67,73,62,11,1.76315789473684,1.92105263157895,1.63157894736842,0.289473684210526,26,6,20,40,24,104,2,-0.1
1907,"Leeds City",2,38,44,53,65,-12,1.15789473684211,1.39473684210526,1.71052631578947,-0.315789473684211,32,12,20,40,33,11,-1,NA
1907,"Leicester City",2,38,73,72,47,25,1.92105263157895,1.89473684210526,1.23684210526316,0.657894736842105,22,2,20,40,20,115,2,-0.9
1907,"Leyton Orient",2,38,43,40,65,-25,1.13157894736842,1.05263157894737,1.71052631578947,-0.657894736842105,34,14,20,40,36,102,-2,-0.1
1907,"Lincoln City",2,38,30,46,83,-37,0.789473684210526,1.21052631578947,2.18421052631579,-0.973684210526316,39,19,20,40,36,107,3,-2.2
1907,"Liverpool",1,38,54,68,61,7,1.42105263157895,1.78947368421053,1.60526315789474,0.184210526315789,7,7,20,20,11,116,-4,0.6
1907,"Manchester City",1,38,59,62,54,8,1.55263157894737,1.63157894736842,1.42105263157895,0.210526315789474,4,4,20,20,18,117,-14,-0.5
1907,"Manchester United",1,38,75,81,48,33,1.97368421052632,2.13157894736842,1.26315789473684,0.868421052631579,1,1,20,20,8,117,-7,-2.1
1907,"Middlesbrough",1,38,58,54,45,9,1.52631578947368,1.42105263157895,1.18421052631579,0.236842105263158,5,5,20,20,12,110,-7,-0.5
1907,"Newcastle United",1,38,57,65,54,11,1.5,1.71052631578947,1.42105263157895,0.289473684210526,6,6,20,20,1,116,5,-0.1
1907,"Nottingham Forest",1,38,50,59,62,-3,1.31578947368421,1.55263157894737,1.63157894736842,-0.0789473684210526,12,12,20,20,15,117,-3,-1.1
1907,"Notts County",1,38,47,39,51,-12,1.23684210526316,1.02631578947368,1.34210526315789,-0.315789473684211,18,18,20,20,16,120,2,-2
1907,"Oldham Athletic",2,38,72,76,42,34,1.89473684210526,2,1.10526315789474,0.894736842105263,23,3,20,40,26,102,-3,0.4
1907,"Preston North End",1,38,48,47,53,-6,1.26315789473684,1.23684210526316,1.39473684210526,-0.157894736842105,16,16,20,20,17,121,-1,-0.2
1907,"Sheffield United",1,38,47,52,58,-6,1.23684210526316,1.36842105263158,1.52631578947368,-0.157894736842105,19,19,20,20,13,117,6,0.7
1907,"Sheffield Wednesday",1,38,61,73,64,9,1.60526315789474,1.92105263157895,1.68421052631579,0.236842105263158,2,2,20,20,4,117,-2,-3
1907,"Stockport County",2,38,44,48,67,-19,1.15789473684211,1.26315789473684,1.76315789473684,-0.5,33,13,20,40,37,99,-4,-1.4
1907,"Stoke City",2,38,53,57,52,5,1.39473684210526,1.5,1.36842105263158,0.131578947368421,29,9,20,40,31,113,-2,-0.1
1907,"Sunderland",1,38,51,78,75,3,1.34210526315789,2.05263157894737,1.97368421052632,0.0789473684210526,10,10,20,20,2,119,8,-0.1
1907,"West Bromwich Albion",2,38,66,61,39,22,1.73684210526316,1.60526315789474,1.02631578947368,0.578947368421053,28,8,20,40,23,121,5,1.5
1907,"Wolverhampton Wanderers",2,38,52,50,45,5,1.36842105263158,1.31578947368421,1.18421052631579,0.131578947368421,30,10,20,40,29,121,1,-1.1
1908,"Arsenal",1,38,52,52,49,3,1.36842105263158,1.36842105263158,1.28947368421053,0.0789473684210526,6,6,20,20,17,116,-11,-0.4
1908,"Aston Villa",1,38,52,58,56,2,1.36842105263158,1.52631578947368,1.47368421052632,0.0526315789473684,7,7,20,20,1,121,6,0.1
1908,"Barnsley",2,38,43,48,57,-9,1.13157894736842,1.26315789473684,1.5,-0.236842105263158,38,18,20,40,28,111,10,0.7
1908,"Birmingham City",2,38,51,58,61,-3,1.34210526315789,1.52631578947368,1.60526315789474,-0.0789473684210526,30,10,20,40,40,117,-10,1.4
1908,"Blackburn Rovers",1,38,55,61,50,11,1.44736842105263,1.60526315789474,1.31578947368421,0.289473684210526,5,5,20,20,5,121,0,-0.8
1908,"Blackpool",2,38,38,46,68,-22,1,1.21052631578947,1.78947368421053,-0.578947368421053,40,20,20,40,32,112,8,1.4
1908,"Bolton Wanderers",2,38,76,59,28,31,2,1.55263157894737,0.736842105263158,0.815789473684211,21,1,20,40,20,121,1,0.7
1908,"Bradford City",1,38,46,47,47,0,1.21052631578947,1.23684210526316,1.23684210526316,0,19,19,20,20,6,106,13,-2.2
1908,"Bradford Park Avenue",2,38,45,51,59,-8,1.18421052631579,1.34210526315789,1.55263157894737,-0.210526315789474,35,15,20,40,29,51,6,-1.6
1908,"Bristol City",1,38,51,45,58,-13,1.34210526315789,1.18421052631579,1.52631578947368,-0.342105263157895,9,9,20,20,14,108,-5,-3.6
1908,"Burnley",2,38,46,51,58,-7,1.21052631578947,1.34210526315789,1.52631578947368,-0.184210526315789,34,14,20,40,33,121,1,1.9
1908,"Bury",1,38,50,63,77,-14,1.31578947368421,1.65789473684211,2.02631578947368,-0.368421052631579,14,14,20,20,13,114,1,-1.3
1908,"Chelsea",1,38,51,56,61,-5,1.34210526315789,1.47368421052632,1.60526315789474,-0.131578947368421,10,10,20,20,19,104,-9,-1
1908,"Chesterfield",2,38,41,37,67,-30,1.07894736842105,0.973684210526316,1.76315789473684,-0.789473684210526,39,19,20,40,69,100,-30,-0.6
1908,"Derby County",2,38,59,55,41,14,1.55263157894737,1.44736842105263,1.07894736842105,0.368421052631579,25,5,20,40,24,121,1,-1.1
1908,"Everton",1,38,64,82,57,25,1.68421052631579,2.15789473684211,1.5,0.657894736842105,3,3,20,20,9,121,-6,-0.1
1908,"Fulham",2,38,50,58,48,10,1.31578947368421,1.52631578947368,1.26315789473684,0.263157894736842,31,11,20,40,30,102,1,-0.1
1908,"Gainsborough Trinity",2,38,53,49,70,-21,1.39473684210526,1.28947368421053,1.84210526315789,-0.552631578947368,27,7,20,40,38,16,-11,NA
1908,"Glossop North End",2,38,53,57,53,4,1.39473684210526,1.5,1.39473684210526,0.105263157894737,28,8,20,40,26,17,2,NA
1908,"Grimsby Town",2,38,49,41,54,-13,1.28947368421053,1.07894736842105,1.42105263157895,-0.342105263157895,32,12,20,40,39,110,-7,-3.5
1908,"Hull City",2,38,63,63,39,24,1.65789473684211,1.65789473684211,1.02631578947368,0.631578947368421,24,4,20,40,22,104,2,-0.9
1908,"Leeds City",2,38,49,43,53,-10,1.28947368421053,1.13157894736842,1.39473684210526,-0.263157894736842,33,13,20,40,37,11,-4,NA
1908,"Leicester City",1,38,33,54,102,-48,0.868421052631579,1.42105263157895,2.68421052631579,-1.26315789473684,20,20,20,20,25,115,-5,-0.4
1908,"Leyton Orient",2,38,45,37,49,-12,1.18421052631579,0.973684210526316,1.28947368421053,-0.315789473684211,36,16,20,40,35,102,1,-0.6
1908,"Liverpool",1,38,51,57,65,-8,1.34210526315789,1.5,1.71052631578947,-0.210526315789474,11,11,20,20,2,116,9,1
1908,"Manchester City",1,38,49,67,69,-2,1.28947368421053,1.76315789473684,1.81578947368421,-0.0526315789473684,18,18,20,20,21,117,-3,1.1
1908,"Manchester United",1,38,52,58,68,-10,1.36842105263158,1.52631578947368,1.78947368421053,-0.263157894736842,8,8,20,20,3,117,5,-2.1
1908,"Middlesbrough",1,38,51,59,53,6,1.34210526315789,1.55263157894737,1.39473684210526,0.157894736842105,12,12,20,20,18,110,-6,-0.6
1908,"Newcastle United",1,38,77,65,41,24,2.02631578947368,1.71052631578947,1.07894736842105,0.631578947368421,1,1,20,20,4,116,-3,-0.4
1908,"Nottingham Forest",1,38,50,66,57,9,1.31578947368421,1.73684210526316,1.5,0.236842105263158,15,15,20,20,15,117,0,-0.4
1908,"Notts County",1,38,50,51,48,3,1.31578947368421,1.34210526315789,1.26315789473684,0.0789473684210526,16,16,20,20,10,120,6,-0.7
1908,"Oldham Athletic",2,38,57,55,43,12,1.5,1.44736842105263,1.13157894736842,0.315789473684211,26,6,20,40,23,102,3,0.5
1908,"Preston North End",1,38,50,48,44,4,1.31578947368421,1.26315789473684,1.15789473684211,0.105263157894737,17,17,20,20,12,121,5,0
1908,"Sheffield United",1,38,51,51,59,-8,1.34210526315789,1.34210526315789,1.55263157894737,-0.210526315789474,13,13,20,20,8,117,5,0.2
1908,"Sheffield Wednesday",1,38,57,67,61,6,1.5,1.76315789473684,1.60526315789474,0.157894736842105,4,4,20,20,11,117,-7,-2.6
1908,"Stockport County",2,38,45,39,71,-32,1.18421052631579,1.02631578947368,1.86842105263158,-0.842105263157895,37,17,20,40,34,99,3,-0.3
1908,"Sunderland",1,38,65,78,63,15,1.71052631578947,2.05263157894737,1.65789473684211,0.394736842105263,2,2,20,20,7,119,-5,0
1908,"Tottenham Hotspur",2,38,71,67,32,35,1.86842105263158,1.76315789473684,0.842105263157895,0.921052631578947,22,2,20,40,16,101,6,1
1908,"West Bromwich Albion",2,38,70,56,27,29,1.84210526315789,1.47368421052632,0.710526315789474,0.763157894736842,23,3,20,40,31,121,-8,1.5
1908,"Wolverhampton Wanderers",2,38,53,56,48,8,1.39473684210526,1.47368421052632,1.26315789473684,0.210526315789474,29,9,20,40,27,121,2,-1.5
1909,"Arsenal",1,38,42,37,67,-30,1.10526315789474,0.973684210526316,1.76315789473684,-0.789473684210526,17,17,20,20,12,116,5,-0.2
1909,"Aston Villa",1,38,76,84,42,42,2,2.21052631578947,1.10526315789474,1.10526315789474,1,1,20,20,2,121,-1,-0.5
1909,"Barnsley",2,38,55,62,59,3,1.44736842105263,1.63157894736842,1.55263157894737,0.0789473684210526,28,8,20,40,39,111,-11,-0.3
1909,"Birmingham City",2,38,31,42,78,-36,0.815789473684211,1.10526315789474,2.05263157894737,-0.947368421052632,40,20,20,40,36,117,4,2.6
1909,"Blackburn Rovers",1,38,63,73,55,18,1.65789473684211,1.92105263157895,1.44736842105263,0.473684210526316,5,5,20,20,13,121,-8,-0.3
1909,"Blackpool",2,38,50,50,52,-2,1.31578947368421,1.31578947368421,1.36842105263158,-0.0526315789473684,32,12,20,40,26,112,6,0.6
1909,"Bolton Wanderers",1,38,33,44,71,-27,0.868421052631579,1.15789473684211,1.86842105263158,-0.710526315789474,20,20,20,20,22,121,-2,1.5
1909,"Bradford City",1,38,59,64,47,17,1.55263157894737,1.68421052631579,1.23684210526316,0.447368421052632,6,6,20,20,3,106,3,-3.3
1909,"Bradford Park Avenue",2,38,55,64,59,5,1.44736842105263,1.68421052631579,1.55263157894737,0.131578947368421,29,9,20,40,32,51,-3,-2.4
1909,"Bristol City",1,38,44,45,60,-15,1.15789473684211,1.18421052631579,1.57894736842105,-0.394736842105263,14,14,20,20,18,108,-4,-3
1909,"Burnley",2,38,48,62,61,1,1.26315789473684,1.63157894736842,1.60526315789474,0.0263157894736842,33,13,20,40,28,121,5,1.6
1909,"Bury",1,38,45,62,66,-4,1.18421052631579,1.63157894736842,1.73684210526316,-0.105263157894737,13,13,20,20,19,114,-6,-1.1
1909,"Chelsea",1,38,40,47,70,-23,1.05263157894737,1.23684210526316,1.84210526315789,-0.605263157894737,19,19,20,20,23,104,-4,-0.2
1909,"Derby County",2,38,75,72,47,25,1.97368421052632,1.89473684210526,1.23684210526316,0.657894736842105,24,4,20,40,25,121,-1,-0.1
1909,"Everton",1,38,56,51,56,-5,1.47368421052632,1.34210526315789,1.47368421052632,-0.131578947368421,9,9,20,20,4,121,5,0.2
1909,"Fulham",2,38,55,51,43,8,1.44736842105263,1.34210526315789,1.13157894736842,0.210526315789474,30,10,20,40,30,102,0,-1.2
1909,"Gainsborough Trinity",2,38,36,33,75,-42,0.947368421052632,0.868421052631579,1.97368421052632,-1.10526315789474,38,18,20,40,38,16,0,NA
1909,"Glossop North End",2,38,61,64,57,7,1.60526315789474,1.68421052631579,1.5,0.184210526315789,26,6,20,40,33,17,-7,NA
1909,"Grimsby Town",2,38,33,50,77,-27,0.868421052631579,1.31578947368421,2.02631578947368,-0.710526315789474,39,19,20,40,29,110,10,-3
1909,"Hull City",2,38,76,80,46,34,2,2.10526315789474,1.21052631578947,0.894736842105263,22,2,20,40,27,104,-5,-1.8
1909,"Leeds City",2,38,37,46,80,-34,0.973684210526316,1.21052631578947,2.10526315789474,-0.894736842105263,37,17,20,40,31,11,6,NA
1909,"Leicester City",2,38,64,79,58,21,1.68421052631579,2.07894736842105,1.52631578947368,0.552631578947368,25,5,20,40,35,115,-10,-0.7
1909,"Leyton Orient",2,38,42,37,60,-23,1.10526315789474,0.973684210526316,1.57894736842105,-0.605263157894737,35,15,20,40,24,102,11,0.1
1909,"Lincoln City",2,38,41,42,69,-27,1.07894736842105,1.10526315789474,1.81578947368421,-0.710526315789474,36,16,20,40,40,107,-4,-3.6
1909,"Liverpool",1,38,69,78,57,21,1.81578947368421,2.05263157894737,1.5,0.552631578947368,2,2,20,20,10,116,-8,-0.9
1909,"Manchester City",2,38,77,81,40,41,2.02631578947368,2.13157894736842,1.05263157894737,1.07894736842105,21,1,20,40,17,117,4,1.1
1909,"Manchester United",1,38,64,69,61,8,1.68421052631579,1.81578947368421,1.60526315789474,0.210526315789474,3,3,20,20,1,117,2,-3.3
1909,"Middlesbrough",1,38,42,56,73,-17,1.10526315789474,1.47368421052632,1.92105263157895,-0.447368421052632,18,18,20,20,16,110,2,-0.4
1909,"Newcastle United",1,38,64,70,56,14,1.68421052631579,1.84210526315789,1.47368421052632,0.368421052631579,4,4,20,20,8,116,-4,-0.5
1909,"Nottingham Forest",1,38,44,54,72,-18,1.15789473684211,1.42105263157895,1.89473684210526,-0.473684210526316,15,15,20,20,20,117,-5,-0.5
1909,"Notts County",1,38,55,67,59,8,1.44736842105263,1.76315789473684,1.55263157894737,0.210526315789474,10,10,20,20,11,120,-1,-0.2
1909,"Oldham Athletic",2,38,76,79,39,40,2,2.07894736842105,1.02631578947368,1.05263157894737,23,3,20,40,7,102,16,-1
1909,"Preston North End",1,38,50,52,58,-6,1.31578947368421,1.36842105263158,1.52631578947368,-0.157894736842105,12,12,20,20,14,121,-2,-0.6
1909,"Sheffield United",1,38,58,62,41,21,1.52631578947368,1.63157894736842,1.07894736842105,0.552631578947368,8,8,20,20,9,117,-1,0.4
1909,"Sheffield Wednesday",1,38,54,60,63,-3,1.42105263157895,1.57894736842105,1.65789473684211,-0.0789473684210526,11,11,20,20,6,117,5,-1.8
1909,"Stockport County",2,38,47,50,47,3,1.23684210526316,1.31578947368421,1.23684210526316,0.0789473684210526,34,14,20,40,37,99,-3,-0.1
1909,"Sunderland",1,38,59,66,51,15,1.55263157894737,1.73684210526316,1.34210526315789,0.394736842105263,7,7,20,20,5,119,2,0.4
1909,"Tottenham Hotspur",1,38,43,53,69,-16,1.13157894736842,1.39473684210526,1.81578947368421,-0.421052631578947,16,16,20,20,15,101,1,0.1
1909,"West Bromwich Albion",2,38,53,58,56,2,1.39473684210526,1.52631578947368,1.47368421052632,0.0526315789473684,31,11,20,40,21,121,10,1.5
1909,"Wolverhampton Wanderers",2,38,57,64,63,1,1.5,1.68421052631579,1.65789473684211,0.0263157894736842,27,7,20,40,29,121,-2,-1.9
1910,"Arsenal",1,38,51,41,49,-8,1.34210526315789,1.07894736842105,1.28947368421053,-0.210526315789474,12,12,20,20,9,116,3,-0.4
1910,"Aston Villa",1,38,73,69,41,28,1.92105263157895,1.81578947368421,1.07894736842105,0.736842105263158,2,2,20,20,5,121,-3,-1.2
1910,"Barnsley",2,38,35,52,62,-10,0.921052631578947,1.36842105263158,1.63157894736842,-0.263157894736842,39,19,20,40,27,111,12,0.3
1910,"Birmingham City",2,38,44,42,64,-22,1.15789473684211,1.10526315789474,1.68421052631579,-0.578947368421053,36,16,20,40,31,117,5,2.8
1910,"Blackburn Rovers",1,38,50,62,54,8,1.31578947368421,1.63157894736842,1.42105263157895,0.210526315789474,13,13,20,20,1,121,12,-0.5
1910,"Blackpool",2,38,58,49,38,11,1.52631578947368,1.28947368421053,1,0.289473684210526,26,6,20,40,34,112,-8,-1.1
1910,"Bolton Wanderers",2,38,72,69,40,29,1.89473684210526,1.81578947368421,1.05263157894737,0.763157894736842,22,2,20,40,3,121,19,1.9
1910,"Bradford City",1,38,65,51,42,9,1.71052631578947,1.34210526315789,1.10526315789474,0.236842105263158,3,3,20,20,10,106,-7,-3.5
1910,"Bradford Park Avenue",2,38,51,53,55,-2,1.34210526315789,1.39473684210526,1.44736842105263,-0.0526315789473684,32,12,20,40,32,51,0,-2.2
1910,"Bristol City",1,38,38,43,66,-23,1,1.13157894736842,1.73684210526316,-0.605263157894737,18,18,20,20,33,108,-15,-3.2
1910,"Burnley",2,38,54,45,45,0,1.42105263157895,1.18421052631579,1.18421052631579,0,28,8,20,40,23,121,5,0.9
1910,"Bury",1,38,38,43,71,-28,1,1.13157894736842,1.86842105263158,-0.736842105263158,19,19,20,20,20,114,-1,1.3
1910,"Chelsea",2,38,69,71,35,36,1.81578947368421,1.86842105263158,0.921052631578947,0.947368421052632,23,3,20,40,21,104,2,-0.4
1910,"Derby County",2,38,59,73,52,21,1.55263157894737,1.92105263157895,1.36842105263158,0.552631578947368,25,5,20,40,22,121,3,0
1910,"Everton",1,38,64,50,36,14,1.68421052631579,1.31578947368421,0.947368421052632,0.368421052631579,4,4,20,20,2,121,2,-1.3
1910,"Fulham",2,38,52,52,48,4,1.36842105263158,1.36842105263158,1.26315789473684,0.105263157894737,30,10,20,40,28,102,2,-0.2
1910,"Gainsborough Trinity",2,38,38,37,55,-18,1,0.973684210526316,1.44736842105263,-0.473684210526316,38,18,20,40,40,16,-2,NA
1910,"Glossop North End",2,38,47,48,62,-14,1.23684210526316,1.26315789473684,1.63157894736842,-0.368421052631579,33,13,20,40,39,17,-6,NA
1910,"Huddersfield Town",2,38,47,57,58,-1,1.23684210526316,1.5,1.52631578947368,-0.0263157894736842,34,14,20,40,36,99,-2,3.3
1910,"Hull City",2,38,58,55,39,16,1.52631578947368,1.44736842105263,1.02631578947368,0.421052631578947,27,7,20,40,25,104,2,-0.4
1910,"Leeds City",2,38,52,58,56,2,1.36842105263158,1.52631578947368,1.47368421052632,0.0526315789473684,31,11,20,40,38,11,-7,NA
1910,"Leicester City",2,38,47,52,62,-10,1.23684210526316,1.36842105263158,1.63157894736842,-0.263157894736842,35,15,20,40,30,115,5,1.2
1910,"Leyton Orient",2,38,64,44,35,9,1.68421052631579,1.15789473684211,0.921052631578947,0.236842105263158,24,4,20,40,24,102,0,-0.9
1910,"Lincoln City",2,38,31,28,72,-44,0.815789473684211,0.736842105263158,1.89473684210526,-1.15789473684211,40,20,20,40,29,107,11,-2.5
1910,"Liverpool",1,38,52,53,53,0,1.36842105263158,1.39473684210526,1.39473684210526,0,10,10,20,20,17,116,-7,0.6
1910,"Manchester City",1,38,40,43,58,-15,1.05263157894737,1.13157894736842,1.52631578947368,-0.394736842105263,17,17,20,20,16,117,1,0.7
1910,"Manchester United",1,38,74,72,40,32,1.94736842105263,1.89473684210526,1.05263157894737,0.842105263157895,1,1,20,20,13,117,-12,-2.3
1910,"Middlesbrough",1,38,43,49,63,-14,1.13157894736842,1.28947368421053,1.65789473684211,-0.368421052631579,16,16,20,20,7,110,9,-2.5
1910,"Newcastle United",1,38,55,61,43,18,1.44736842105263,1.60526315789474,1.13157894736842,0.473684210526316,8,8,20,20,4,116,4,0.1
1910,"Nottingham Forest",1,38,34,55,75,-20,0.894736842105263,1.44736842105263,1.97368421052632,-0.526315789473684,20,20,20,20,35,117,-15,-0.2
1910,"Notts County",1,38,52,37,45,-8,1.36842105263158,0.973684210526316,1.18421052631579,-0.210526315789474,11,11,20,20,14,120,-3,0.2
1910,"Oldham Athletic",1,38,57,44,41,3,1.5,1.15789473684211,1.07894736842105,0.0789473684210526,7,7,20,20,18,102,-11,-3.2
1910,"Preston North End",1,38,47,40,49,-9,1.23684210526316,1.05263157894737,1.28947368421053,-0.236842105263158,14,14,20,20,19,121,-5,-0.7
1910,"Sheffield United",1,38,53,49,43,6,1.39473684210526,1.28947368421053,1.13157894736842,0.157894736842105,9,9,20,20,15,117,-6,-0.6
1910,"Sheffield Wednesday",1,38,59,47,48,-1,1.55263157894737,1.23684210526316,1.26315789473684,-0.0263157894736842,6,6,20,20,6,117,0,-2.8
1910,"Stockport County",2,38,41,47,79,-32,1.07894736842105,1.23684210526316,2.07894736842105,-0.842105263157895,37,17,20,40,37,99,0,-0.3
1910,"Sunderland",1,38,60,67,48,19,1.57894736842105,1.76315789473684,1.26315789473684,0.5,5,5,20,20,11,119,-6,0
1910,"Tottenham Hotspur",1,38,45,52,63,-11,1.18421052631579,1.36842105263158,1.65789473684211,-0.289473684210526,15,15,20,20,12,101,3,0.3
1910,"West Bromwich Albion",2,38,75,67,41,26,1.97368421052632,1.76315789473684,1.07894736842105,0.684210526315789,21,1,20,40,8,121,13,1.9
1910,"Wolverhampton Wanderers",2,38,53,51,52,-1,1.39473684210526,1.34210526315789,1.36842105263158,-0.0263157894736842,29,9,20,40,26,121,3,0.3
1911,"Arsenal",1,38,53,55,59,-4,1.39473684210526,1.44736842105263,1.55263157894737,-0.105263157894737,9,9,20,20,20,116,-11,0.7
1911,"Aston Villa",1,38,58,76,63,13,1.52631578947368,2,1.65789473684211,0.342105263157895,5,5,20,20,3,121,2,-0.3
1911,"Barnsley",2,38,57,45,42,3,1.5,1.18421052631579,1.10526315789474,0.0789473684210526,27,7,20,40,23,111,4,-1.3
1911,"Birmingham City",2,38,48,55,59,-4,1.26315789473684,1.44736842105263,1.55263157894737,-0.105263157894737,31,11,20,40,24,117,7,2
1911,"Blackburn Rovers",1,38,69,60,43,17,1.81578947368421,1.57894736842105,1.13157894736842,0.447368421052632,1,1,20,20,6,121,-5,-1.1
1911,"Blackpool",2,38,47,32,52,-20,1.23684210526316,0.842105263157895,1.36842105263158,-0.526315789473684,34,14,20,40,39,112,-5,0.4
1911,"Bolton Wanderers",1,38,63,54,43,11,1.65789473684211,1.42105263157895,1.13157894736842,0.289473684210526,3,3,20,20,8,121,-5,-0.4
1911,"Bradford City",1,38,53,46,50,-4,1.39473684210526,1.21052631578947,1.31578947368421,-0.105263157894737,10,10,20,20,14,106,-4,-2.9
1911,"Bradford Park Avenue",2,38,48,44,45,-1,1.26315789473684,1.15789473684211,1.18421052631579,-0.0263157894736842,32,12,20,40,33,51,-1,-1.4
1911,"Bristol City",2,38,48,41,60,-19,1.26315789473684,1.07894736842105,1.57894736842105,-0.5,33,13,20,40,38,108,-5,-1.9
1911,"Burnley",2,38,74,77,41,36,1.94736842105263,2.02631578947368,1.07894736842105,0.947368421052632,23,3,20,40,22,121,1,0.3
1911,"Bury",1,38,27,32,59,-27,0.710526315789474,0.842105263157895,1.55263157894737,-0.710526315789474,20,20,20,20,30,114,-10,1.6
1911,"Chelsea",2,38,78,64,34,30,2.05263157894737,1.68421052631579,0.894736842105263,0.789473684210526,21,1,20,40,18,104,3,-0.4
1911,"Derby County",2,38,77,74,28,46,2.02631578947368,1.94736842105263,0.736842105263158,1.21052631578947,22,2,20,40,7,121,15,-0.2
1911,"Everton",1,38,66,46,42,4,1.73684210526316,1.21052631578947,1.10526315789474,0.105263157894737,2,2,20,20,11,121,-9,-1.3
1911,"Fulham",2,38,55,66,58,8,1.44736842105263,1.73684210526316,1.52631578947368,0.210526315789474,28,8,20,40,26,102,2,-1.3
1911,"Gainsborough Trinity",2,38,28,30,64,-34,0.736842105263158,0.789473684210526,1.68421052631579,-0.894736842105263,40,20,20,40,NA,16,NA,NA
1911,"Glossop North End",2,38,36,42,56,-14,0.947368421052632,1.10526315789474,1.47368421052632,-0.368421052631579,39,19,20,40,35,17,4,NA
1911,"Grimsby Town",2,38,54,48,55,-7,1.42105263157895,1.26315789473684,1.44736842105263,-0.184210526315789,29,9,20,40,27,110,2,-1.6
1911,"Huddersfield Town",2,38,45,50,64,-14,1.18421052631579,1.31578947368421,1.68421052631579,-0.368421052631579,36,16,20,40,25,99,11,3.5
1911,"Hull City",2,38,59,54,51,3,1.55263157894737,1.42105263157895,1.34210526315789,0.0789473684210526,25,5,20,40,32,104,-7,-1
1911,"Leeds City",2,38,38,50,78,-28,1,1.31578947368421,2.05263157894737,-0.736842105263158,38,18,20,40,28,11,10,NA
1911,"Leicester City",2,38,52,49,66,-17,1.36842105263158,1.28947368421053,1.73684210526316,-0.447368421052632,30,10,20,40,34,115,-4,1.3
1911,"Leyton Orient",2,38,66,61,44,17,1.73684210526316,1.60526315789474,1.15789473684211,0.447368421052632,24,4,20,40,36,102,-12,-1.8
1911,"Liverpool",1,38,46,49,55,-6,1.21052631578947,1.28947368421053,1.44736842105263,-0.157894736842105,17,17,20,20,10,116,7,0.8
1911,"Manchester City",1,38,48,56,58,-2,1.26315789473684,1.47368421052632,1.52631578947368,-0.0526315789473684,16,16,20,20,5,117,11,-0.5
1911,"Manchester United",1,38,50,45,60,-15,1.31578947368421,1.18421052631579,1.57894736842105,-0.394736842105263,13,13,20,20,4,117,9,0.7
1911,"Middlesbrough",1,38,56,56,45,11,1.47368421052632,1.47368421052632,1.18421052631579,0.289473684210526,7,7,20,20,16,110,-9,-2.1
1911,"Newcastle United",1,38,62,64,50,14,1.63157894736842,1.68421052631579,1.31578947368421,0.368421052631579,4,4,20,20,15,116,-11,-0.6
1911,"Nottingham Forest",2,38,46,46,48,-2,1.21052631578947,1.21052631578947,1.26315789473684,-0.0526315789473684,35,15,20,40,37,117,-2,-0.3
1911,"Notts County",1,38,49,46,63,-17,1.28947368421053,1.21052631578947,1.65789473684211,-0.447368421052632,14,14,20,20,19,120,-5,-0.8
1911,"Oldham Athletic",1,38,46,46,54,-8,1.21052631578947,1.21052631578947,1.42105263157895,-0.210526315789474,18,18,20,20,9,102,9,-1.3
1911,"Preston North End",1,38,46,40,57,-17,1.21052631578947,1.05263157894737,1.5,-0.447368421052632,19,19,20,20,21,121,-2,-1.5
1911,"Sheffield United",1,38,49,63,56,7,1.28947368421053,1.65789473684211,1.47368421052632,0.184210526315789,15,15,20,20,13,117,2,1
1911,"Sheffield Wednesday",1,38,57,69,49,20,1.5,1.81578947368421,1.28947368421053,0.526315789473684,6,6,20,20,2,117,4,-1.7
1911,"Stockport County",2,38,44,47,54,-7,1.15789473684211,1.23684210526316,1.42105263157895,-0.184210526315789,37,17,20,40,40,99,-3,-0.7
1911,"Sunderland",1,38,53,58,51,7,1.39473684210526,1.52631578947368,1.34210526315789,0.184210526315789,11,11,20,20,1,119,10,0.8
1911,"Tottenham Hotspur",1,38,51,53,53,0,1.34210526315789,1.39473684210526,1.39473684210526,0,12,12,20,20,17,101,-5,-0.4
1911,"West Bromwich Albion",1,38,54,43,47,-4,1.42105263157895,1.13157894736842,1.23684210526316,-0.105263157894737,8,8,20,20,12,121,-4,-0.5
1911,"Wolverhampton Wanderers",2,38,58,57,33,24,1.52631578947368,1.5,0.868421052631579,0.631578947368421,26,6,20,40,31,121,-5,0
1912,"Arsenal",1,38,21,26,74,-48,0.552631578947368,0.684210526315789,1.94736842105263,-1.26315789473684,20,20,20,20,23,116,-3,0.9
1912,"Aston Villa",1,38,69,86,52,34,1.81578947368421,2.26315789473684,1.36842105263158,0.894736842105263,3,3,20,20,2,121,1,-0.5
1912,"Barnsley",2,38,64,57,47,10,1.68421052631579,1.5,1.23684210526316,0.263157894736842,23,3,20,40,25,111,-2,-1
1912,"Birmingham City",2,38,64,59,44,15,1.68421052631579,1.55263157894737,1.15789473684211,0.394736842105263,24,4,20,40,35,117,-11,0.9
1912,"Blackburn Rovers",1,38,61,79,43,36,1.60526315789474,2.07894736842105,1.13157894736842,0.947368421052632,6,6,20,20,1,121,5,-1.1
1912,"Blackpool",2,38,35,39,69,-30,0.921052631578947,1.02631578947368,1.81578947368421,-0.789473684210526,39,19,20,40,36,112,3,0.8
1912,"Bolton Wanderers",1,38,58,62,63,-1,1.52631578947368,1.63157894736842,1.65789473684211,-0.0263157894736842,8,8,20,20,5,121,3,0.4
1912,"Bradford City",1,38,47,50,60,-10,1.23684210526316,1.31578947368421,1.57894736842105,-0.263157894736842,14,14,20,20,11,106,3,-3
1912,"Bradford Park Avenue",2,38,50,60,60,0,1.31578947368421,1.57894736842105,1.57894736842105,0,33,13,20,40,22,51,11,-1.6
1912,"Bristol City",2,38,42,46,72,-26,1.10526315789474,1.21052631578947,1.89473684210526,-0.684210526315789,38,18,20,40,28,108,10,-0.8
1912,"Burnley",2,38,71,88,53,35,1.86842105263158,2.31578947368421,1.39473684210526,0.921052631578947,22,2,20,40,15,121,7,1.7
1912,"Bury",2,38,53,53,57,-4,1.39473684210526,1.39473684210526,1.5,-0.105263157894737,30,10,20,40,30,114,0,1.1
1912,"Chelsea",1,38,39,51,73,-22,1.02631578947368,1.34210526315789,1.92105263157895,-0.578947368421053,18,18,20,20,8,104,10,-0.8
1912,"Derby County",1,38,59,69,66,3,1.55263157894737,1.81578947368421,1.73684210526316,0.0789473684210526,7,7,20,20,20,121,-13,-0.5
1912,"Everton",1,38,52,48,54,-6,1.36842105263158,1.26315789473684,1.42105263157895,-0.157894736842105,11,11,20,20,16,121,-5,-0.9
1912,"Fulham",2,38,56,65,55,10,1.47368421052632,1.71052631578947,1.44736842105263,0.263157894736842,26,6,20,40,31,102,-5,-1.3
1912,"Glossop North End",2,38,44,49,68,-19,1.15789473684211,1.28947368421053,1.78947368421053,-0.5,35,15,20,40,37,17,-2,NA
1912,"Grimsby Town",2,38,55,51,50,1,1.44736842105263,1.34210526315789,1.31578947368421,0.0263157894736842,27,7,20,40,33,110,-6,-1.3
1912,"Huddersfield Town",2,38,60,66,40,26,1.57894736842105,1.73684210526316,1.05263157894737,0.684210526315789,25,5,20,40,34,99,-9,2.2
1912,"Hull City",2,38,51,60,55,5,1.34210526315789,1.57894736842105,1.44736842105263,0.131578947368421,32,12,20,40,29,104,3,0.3
1912,"Leeds City",2,38,55,70,64,6,1.44736842105263,1.84210526315789,1.68421052631579,0.157894736842105,28,8,20,40,24,11,4,NA
1912,"Leicester City",2,38,46,49,65,-16,1.21052631578947,1.28947368421053,1.71052631578947,-0.421052631578947,34,14,20,40,38,115,-4,2.7
1912,"Leyton Orient",2,38,44,34,47,-13,1.15789473684211,0.894736842105263,1.23684210526316,-0.342105263157895,36,16,20,40,26,102,10,-0.6
1912,"Lincoln City",2,38,55,50,52,-2,1.44736842105263,1.31578947368421,1.36842105263158,-0.0526315789473684,29,9,20,40,39,107,-10,-1.8
1912,"Liverpool",1,38,53,61,71,-10,1.39473684210526,1.60526315789474,1.86842105263158,-0.263157894736842,10,10,20,20,14,116,-4,0.1
1912,"Manchester City",1,38,62,53,37,16,1.63157894736842,1.39473684210526,0.973684210526316,0.421052631578947,5,5,20,20,12,117,-7,-2
1912,"Manchester United",1,38,65,69,43,26,1.71052631578947,1.81578947368421,1.13157894736842,0.684210526315789,4,4,20,20,10,117,-6,-1.4
1912,"Middlesbrough",1,38,43,55,69,-14,1.13157894736842,1.44736842105263,1.81578947368421,-0.368421052631579,16,16,20,20,3,110,13,-0.7
1912,"Newcastle United",1,38,47,47,47,0,1.23684210526316,1.23684210526316,1.23684210526316,0,15,15,20,20,13,116,2,1.4
1912,"Nottingham Forest",2,38,44,58,59,-1,1.15789473684211,1.52631578947368,1.55263157894737,-0.0263157894736842,37,17,20,40,40,117,-3,0.9
1912,"Notts County",1,38,30,28,56,-28,0.789473684210526,0.736842105263158,1.47368421052632,-0.736842105263158,19,19,20,20,21,120,-2,-1.8
1912,"Oldham Athletic",1,38,56,50,55,-5,1.47368421052632,1.31578947368421,1.44736842105263,-0.131578947368421,9,9,20,20,4,102,5,-2.1
1912,"Preston North End",2,38,72,56,33,23,1.89473684210526,1.47368421052632,0.868421052631579,0.605263157894737,21,1,20,40,19,121,2,-0.6
1912,"Sheffield United",1,38,48,56,70,-14,1.26315789473684,1.47368421052632,1.84210526315789,-0.368421052631579,13,13,20,20,9,117,4,0.3
1912,"Sheffield Wednesday",1,38,70,75,55,20,1.84210526315789,1.97368421052632,1.44736842105263,0.526315789473684,2,2,20,20,17,117,-15,-1.4
1912,"Stockport County",2,38,34,56,78,-22,0.894736842105263,1.47368421052632,2.05263157894737,-0.578947368421053,40,20,20,40,32,99,8,-1.4
1912,"Sunderland",1,38,79,86,43,43,2.07894736842105,2.26315789473684,1.13157894736842,1.13157894736842,1,1,20,20,7,119,-6,-0.1
1912,"Tottenham Hotspur",1,38,42,45,72,-27,1.10526315789474,1.18421052631579,1.89473684210526,-0.710526315789474,17,17,20,20,18,101,-1,0.3
1912,"West Bromwich Albion",1,38,51,57,50,7,1.34210526315789,1.5,1.31578947368421,0.184210526315789,12,12,20,20,6,121,6,-1
1912,"Wolverhampton Wanderers",2,38,52,56,54,2,1.36842105263158,1.47368421052632,1.42105263157895,0.0526315789473684,31,11,20,40,27,121,4,-0.7
1913,"Arsenal",2,38,69,54,38,16,1.81578947368421,1.42105263157895,1,0.421052631578947,23,3,20,40,25,116,-2,0.8
1913,"Aston Villa",1,38,63,65,50,15,1.65789473684211,1.71052631578947,1.31578947368421,0.394736842105263,2,2,20,20,14,121,-12,-0.5
1913,"Barnsley",2,38,64,51,45,6,1.68421052631579,1.34210526315789,1.18421052631579,0.157894736842105,25,5,20,40,23,111,2,-1
1913,"Birmingham City",2,38,46,48,60,-12,1.21052631578947,1.26315789473684,1.57894736842105,-0.315789473684211,35,15,20,40,27,117,8,1.9
1913,"Blackburn Rovers",1,38,71,78,42,36,1.86842105263158,2.05263157894737,1.10526315789474,0.947368421052632,1,1,20,20,3,121,-2,-0.9
1913,"Blackpool",2,38,41,33,44,-11,1.07894736842105,0.868421052631579,1.15789473684211,-0.289473684210526,36,16,20,40,30,112,6,-0.4
1913,"Bolton Wanderers",1,38,58,65,52,13,1.52631578947368,1.71052631578947,1.36842105263158,0.342105263157895,5,5,20,20,16,121,-11,-0.3
1913,"Bradford City",1,38,50,40,40,0,1.31578947368421,1.05263157894737,1.05263157894737,0,11,11,20,20,11,106,0,-4.4
1913,"Bradford Park Avenue",2,38,72,71,47,24,1.89473684210526,1.86842105263158,1.23684210526316,0.631578947368421,22,2,20,40,6,51,16,-2.4
1913,"Bristol City",2,38,57,52,50,2,1.5,1.36842105263158,1.31578947368421,0.0526315789473684,28,8,20,40,32,108,-4,-0.5
1913,"Burnley",1,38,48,61,53,8,1.26315789473684,1.60526315789474,1.39473684210526,0.210526315789474,15,15,20,20,4,121,11,0.4
1913,"Bury",2,38,55,39,40,-1,1.44736842105263,1.02631578947368,1.05263157894737,-0.0263157894736842,30,10,20,40,31,114,-1,2.6
1913,"Chelsea",1,38,55,46,55,-9,1.44736842105263,1.21052631578947,1.44736842105263,-0.236842105263158,8,8,20,20,19,104,-11,-1.7
1913,"Derby County",1,38,35,55,71,-16,0.921052631578947,1.44736842105263,1.86842105263158,-0.421052631578947,20,20,20,20,21,121,-1,1.4
1913,"Everton",1,38,47,46,55,-9,1.23684210526316,1.21052631578947,1.44736842105263,-0.236842105263158,16,16,20,20,1,121,15,1.5
1913,"Fulham",2,38,54,46,43,3,1.42105263157895,1.21052631578947,1.13157894736842,0.0789473684210526,31,11,20,40,33,102,-2,-1
1913,"Glossop North End",2,38,39,51,67,-16,1.02631578947368,1.34210526315789,1.76315789473684,-0.421052631578947,37,17,20,40,40,17,-3,NA
1913,"Grimsby Town",2,38,47,42,58,-16,1.23684210526316,1.10526315789474,1.52631578947368,-0.421052631578947,33,13,20,40,36,110,-3,-0.1
1913,"Huddersfield Town",2,38,47,47,53,-6,1.23684210526316,1.23684210526316,1.39473684210526,-0.157894736842105,34,14,20,40,28,99,6,3.2
1913,"Hull City",2,38,57,53,37,16,1.5,1.39473684210526,0.973684210526316,0.421052631578947,29,9,20,40,26,104,3,-0.7
1913,"Leeds City",2,38,67,76,46,30,1.76315789473684,2,1.21052631578947,0.789473684210526,24,4,20,40,35,11,-11,NA
1913,"Leicester City",2,38,37,45,61,-16,0.973684210526316,1.18421052631579,1.60526315789474,-0.421052631578947,38,18,20,40,39,115,-1,3.5
1913,"Leyton Orient",2,38,59,47,35,12,1.55263157894737,1.23684210526316,0.921052631578947,0.315789473684211,26,6,20,40,29,102,-3,-1.7
1913,"Lincoln City",2,38,36,36,66,-30,0.947368421052632,0.947368421052632,1.73684210526316,-0.789473684210526,39,19,20,40,37,107,2,-1.7
1913,"Liverpool",1,38,49,46,62,-16,1.28947368421053,1.21052631578947,1.63157894736842,-0.421052631578947,14,14,20,20,12,116,2,-0.6
1913,"Manchester City",1,38,50,51,53,-2,1.31578947368421,1.34210526315789,1.39473684210526,-0.0526315789473684,12,12,20,20,7,117,5,-1.1
1913,"Manchester United",1,38,51,52,62,-10,1.34210526315789,1.36842105263158,1.63157894736842,-0.263157894736842,10,10,20,20,18,117,-8,-0.2
1913,"Middlesbrough",1,38,62,77,60,17,1.63157894736842,2.02631578947368,1.57894736842105,0.447368421052632,3,3,20,20,13,110,-10,-1.9
1913,"Newcastle United",1,38,50,39,48,-9,1.31578947368421,1.02631578947368,1.26315789473684,-0.236842105263158,13,13,20,20,15,116,-2,0.4
1913,"Nottingham Forest",2,38,30,37,76,-39,0.789473684210526,0.973684210526316,2,-1.02631578947368,40,20,20,40,38,117,2,0.8
1913,"Notts County",2,38,76,77,36,41,2,2.02631578947368,0.947368421052632,1.07894736842105,21,1,20,40,17,120,4,-1.6
1913,"Oldham Athletic",1,38,60,55,45,10,1.57894736842105,1.44736842105263,1.18421052631579,0.263157894736842,4,4,20,20,2,102,2,-2.5
1913,"Preston North End",1,38,42,52,69,-17,1.10526315789474,1.36842105263158,1.81578947368421,-0.447368421052632,19,19,20,20,22,121,-3,-0.7
1913,"Sheffield United",1,38,53,63,60,3,1.39473684210526,1.65789473684211,1.57894736842105,0.0789473684210526,9,9,20,20,8,117,1,-0.5
1913,"Sheffield Wednesday",1,38,47,53,70,-17,1.23684210526316,1.39473684210526,1.84210526315789,-0.447368421052632,17,17,20,20,9,117,8,-0.4
1913,"Stockport County",2,38,49,55,57,-2,1.28947368421053,1.44736842105263,1.5,-0.0526315789473684,32,12,20,40,34,99,-2,-1.7
1913,"Sunderland",1,38,57,63,52,11,1.5,1.65789473684211,1.36842105263158,0.289473684210526,7,7,20,20,5,119,2,-1
1913,"Tottenham Hotspur",1,38,46,50,62,-12,1.21052631578947,1.31578947368421,1.63157894736842,-0.315789473684211,18,18,20,20,20,101,-2,0
1913,"West Bromwich Albion",1,38,58,46,42,4,1.52631578947368,1.21052631578947,1.10526315789474,0.105263157894737,6,6,20,20,10,121,-4,-2.4
1913,"Wolverhampton Wanderers",2,38,59,51,52,-1,1.55263157894737,1.34210526315789,1.36842105263158,-0.0263157894736842,27,7,20,40,24,121,3,-1.2
1914,"Arsenal",2,38,62,69,41,28,1.63157894736842,1.81578947368421,1.07894736842105,0.736842105263158,25,5,20,40,10,116,15,1.5
1914,"Aston Villa",1,38,50,62,72,-10,1.31578947368421,1.63157894736842,1.89473684210526,-0.263157894736842,14,14,20,20,8,121,6,1.3
1914,"Barnsley",2,38,69,51,51,0,1.81578947368421,1.34210526315789,1.34210526315789,0,23,3,20,40,34,111,-11,-1.2
1914,"Birmingham City",2,38,60,62,39,23,1.57894736842105,1.63157894736842,1.02631578947368,0.605263157894737,27,7,20,40,25,117,2,1.4
1914,"Blackburn Rovers",1,38,61,83,61,22,1.60526315789474,2.18421052631579,1.60526315789474,0.578947368421053,3,3,20,20,19,121,-16,-0.6
1914,"Blackpool",2,38,56,58,57,1,1.47368421052632,1.52631578947368,1.5,0.0263157894736842,30,10,20,40,26,112,4,0.1
1914,"Bolton Wanderers",1,38,41,68,84,-16,1.07894736842105,1.78947368421053,2.21052631578947,-0.421052631578947,16,16,20,20,6,121,10,0
1914,"Bradford City",1,38,53,55,49,6,1.39473684210526,1.44736842105263,1.28947368421053,0.157894736842105,11,11,20,20,14,106,-3,-3.4
1914,"Bradford Park Avenue",1,38,58,69,65,4,1.52631578947368,1.81578947368421,1.71052631578947,0.105263157894737,6,6,20,20,11,51,-5,-1.9
1914,"Bristol City",2,38,52,62,56,6,1.36842105263158,1.63157894736842,1.47368421052632,0.157894736842105,32,12,20,40,33,108,-1,-0.9
1914,"Burnley",1,38,61,61,47,14,1.60526315789474,1.60526315789474,1.23684210526316,0.368421052631579,4,4,20,20,2,121,2,-1.4
1914,"Bury",2,38,53,61,56,5,1.39473684210526,1.60526315789474,1.47368421052632,0.131578947368421,31,11,20,40,27,114,4,1
1914,"Chelsea",1,38,37,51,65,-14,0.973684210526316,1.34210526315789,1.71052631578947,-0.368421052631579,19,19,20,20,3,104,16,-1.2
1914,"Derby County",2,38,76,71,33,38,2,1.86842105263158,0.868421052631579,1,21,1,20,40,18,121,3,1.6
1914,"Everton",1,38,65,76,47,29,1.71052631578947,2,1.23684210526316,0.763157894736842,1,1,20,20,20,121,-19,-1.3
1914,"Fulham",2,38,52,53,47,6,1.36842105263158,1.39473684210526,1.23684210526316,0.157894736842105,33,13,20,40,28,102,5,-1.6
1914,"Glossop North End",2,38,24,31,87,-56,0.631578947368421,0.815789473684211,2.28947368421053,-1.47368421052632,40,20,20,40,NA,17,NA,NA
1914,"Grimsby Town",2,38,42,48,76,-28,1.10526315789474,1.26315789473684,2,-0.736842105263158,36,16,20,40,44,110,-8,1.3
1914,"Huddersfield Town",2,38,59,61,42,19,1.55263157894737,1.60526315789474,1.10526315789474,0.5,28,8,20,40,24,99,4,0.9
1914,"Hull City",2,38,62,65,54,11,1.63157894736842,1.71052631578947,1.42105263157895,0.289473684210526,26,6,20,40,30,104,-4,-1.2
1914,"Leeds City",2,38,46,65,64,1,1.21052631578947,1.71052631578947,1.68421052631579,0.0263157894736842,35,15,20,40,45,11,-10,NA
1914,"Leicester City",2,38,34,47,88,-41,0.894736842105263,1.23684210526316,2.31578947368421,-1.07894736842105,39,19,20,40,35,115,4,3.6
1914,"Leyton Orient",2,38,57,50,48,2,1.5,1.31578947368421,1.26315789473684,0.0526315789473684,29,9,20,40,36,102,-7,-1.5
1914,"Lincoln City",2,38,42,46,65,-19,1.10526315789474,1.21052631578947,1.71052631578947,-0.5,37,17,20,40,43,107,-6,-1.9
1914,"Liverpool",1,38,51,65,75,-10,1.34210526315789,1.71052631578947,1.97368421052632,-0.263157894736842,12,12,20,20,5,116,7,0.6
1914,"Manchester City",1,38,58,49,39,10,1.52631578947368,1.28947368421053,1.02631578947368,0.263157894736842,7,7,20,20,7,117,0,0
1914,"Manchester United",1,38,39,46,62,-16,1.02631578947368,1.21052631578947,1.63157894736842,-0.421052631578947,18,18,20,20,15,117,3,0.3
1914,"Middlesbrough",1,38,51,62,74,-12,1.34210526315789,1.63157894736842,1.94736842105263,-0.315789473684211,13,13,20,20,13,110,0,-1.1
1914,"Newcastle United",1,38,43,46,48,-2,1.13157894736842,1.21052631578947,1.26315789473684,-0.0526315789473684,15,15,20,20,9,116,6,0.7
1914,"Nottingham Forest",2,38,39,43,77,-34,1.02631578947368,1.13157894736842,2.02631578947368,-0.894736842105263,38,18,20,40,39,117,-1,0.5
1914,"Notts County",1,38,40,41,57,-16,1.05263157894737,1.07894736842105,1.5,-0.421052631578947,17,17,20,20,21,120,-4,-0.9
1914,"Oldham Athletic",1,38,62,70,56,14,1.63157894736842,1.84210526315789,1.47368421052632,0.368421052631579,2,2,20,20,16,102,-14,-3.7
1914,"Preston North End",2,38,70,61,42,19,1.84210526315789,1.60526315789474,1.10526315789474,0.5,22,2,20,40,17,121,5,-1.4
1914,"Sheffield United",1,38,58,49,41,8,1.52631578947368,1.28947368421053,1.07894736842105,0.210526315789474,8,8,20,20,12,117,-4,-0.4
1914,"Sheffield Wednesday",1,38,58,61,54,7,1.52631578947368,1.60526315789474,1.42105263157895,0.184210526315789,9,9,20,20,22,117,-13,0.7
1914,"Stockport County",2,38,52,54,60,-6,1.36842105263158,1.42105263157895,1.57894736842105,-0.157894736842105,34,14,20,40,37,99,-3,-1.2
1914,"Sunderland",1,38,59,81,72,9,1.55263157894737,2.13157894736842,1.89473684210526,0.236842105263158,5,5,20,20,4,119,1,0.1
1914,"Tottenham Hotspur",1,38,36,57,90,-33,0.947368421052632,1.5,2.36842105263158,-0.868421052631579,20,20,20,20,23,101,-3,-1.2
1914,"West Bromwich Albion",1,38,55,49,43,6,1.44736842105263,1.28947368421053,1.13157894736842,0.157894736842105,10,10,20,20,1,121,9,-1.8
1914,"Wolverhampton Wanderers",2,38,64,77,52,25,1.68421052631579,2.02631578947368,1.36842105263158,0.657894736842105,24,4,20,40,41,121,-17,-1.6
1919,"Arsenal",1,42,57,56,58,-2,1.35714285714286,1.33333333333333,1.38095238095238,-0.0476190476190476,10,10,22,22,10,116,0,-0.6
1919,"Aston Villa",1,42,60,75,73,2,1.42857142857143,1.78571428571429,1.73809523809524,0.0476190476190476,8,8,22,22,9,121,-1,0.5
1919,"Barnsley",2,42,55,61,55,6,1.30952380952381,1.45238095238095,1.30952380952381,0.142857142857143,34,12,23,45,43,111,-9,-0.4
1919,"Birmingham City",2,42,80,85,34,51,1.9047619047619,2.02380952380952,0.80952380952381,1.21428571428571,25,3,23,45,23,117,2,1.4
1919,"Blackburn Rovers",1,42,50,64,77,-13,1.19047619047619,1.52380952380952,1.83333333333333,-0.30952380952381,19,19,22,22,13,121,6,1.3
1919,"Blackpool",2,42,73,65,47,18,1.73809523809524,1.54761904761905,1.11904761904762,0.428571428571429,26,4,23,45,25,112,1,0.3
1919,"Bolton Wanderers",1,42,66,72,65,7,1.57142857142857,1.71428571428571,1.54761904761905,0.166666666666667,6,6,22,22,3,121,3,-0.8
1919,"Bradford City",1,42,53,54,63,-9,1.26190476190476,1.28571428571429,1.5,-0.214285714285714,14,14,22,22,18,106,-4,-2.7
1919,"Bradford Park Avenue",1,42,57,60,63,-3,1.35714285714286,1.42857142857143,1.5,-0.0714285714285714,11,11,22,22,21,51,-10,-1.6
1919,"Bristol City",2,42,56,46,43,3,1.33333333333333,1.0952380952381,1.02380952380952,0.0714285714285714,33,11,23,45,26,108,7,-0.9
1919,"Burnley",1,42,72,65,59,6,1.71428571428571,1.54761904761905,1.4047619047619,0.142857142857143,2,2,22,22,1,121,1,-1.9
1919,"Bury",2,42,68,60,44,16,1.61904761904762,1.42857142857143,1.04761904761905,0.380952380952381,27,5,23,45,33,114,-6,0.1
1919,"Chelsea",1,42,71,56,51,5,1.69047619047619,1.33333333333333,1.21428571428571,0.119047619047619,3,3,22,22,17,104,-14,-2.1
1919,"Coventry City",2,42,38,35,73,-38,0.904761904761905,0.833333333333333,1.73809523809524,-0.904761904761905,42,20,23,45,40,94,2,-1.2
1919,"Derby County",1,42,51,47,57,-10,1.21428571428571,1.11904761904762,1.35714285714286,-0.238095238095238,18,18,22,22,22,121,-4,1.6
1919,"Everton",1,42,50,69,68,1,1.19047619047619,1.64285714285714,1.61904761904762,0.0238095238095238,20,20,22,22,7,121,13,-0.2
1919,"Fulham",2,42,66,61,50,11,1.57142857142857,1.45238095238095,1.19047619047619,0.261904761904762,28,6,23,45,31,102,-3,-2.7
1919,"Grimsby Town",2,42,35,34,75,-41,0.833333333333333,0.80952380952381,1.78571428571429,-0.976190476190476,44,22,23,45,55,110,-11,2.6
1919,"Huddersfield Town",2,42,92,97,38,59,2.19047619047619,2.30952380952381,0.904761904761905,1.4047619047619,24,2,23,45,14,99,10,1.5
1919,"Hull City",2,42,60,78,72,6,1.42857142857143,1.85714285714286,1.71428571428571,0.142857142857143,30,8,23,45,37,104,-7,-1
1919,"Leeds City",2,8,14,17,10,7,1.75,2.125,1.25,0.875,45,23,23,45,NA,11,NA,NA
1919,"Leicester City",2,42,55,41,61,-20,1.30952380952381,0.976190476190476,1.45238095238095,-0.476190476190476,35,13,23,45,36,115,-1,2.5
1919,"Leyton Orient",2,42,54,51,59,-8,1.28571428571429,1.21428571428571,1.4047619047619,-0.19047619047619,36,14,23,45,29,102,7,-3.4
1919,"Lincoln City",2,42,36,44,101,-57,0.857142857142857,1.04761904761905,2.4047619047619,-1.35714285714286,43,21,23,45,76,107,-33,-0.4
1919,"Liverpool",1,42,67,59,44,15,1.5952380952381,1.4047619047619,1.04761904761905,0.357142857142857,5,5,22,22,5,116,0,-0.7
1919,"Manchester City",1,42,63,71,62,9,1.5,1.69047619047619,1.47619047619048,0.214285714285714,7,7,22,22,2,117,5,0.2
1919,"Manchester United",1,42,53,54,50,4,1.26190476190476,1.28571428571429,1.19047619047619,0.0952380952380952,15,15,22,22,11,117,4,-0.2
1919,"Middlesbrough",1,42,55,61,65,-4,1.30952380952381,1.45238095238095,1.54761904761905,-0.0952380952380952,13,13,22,22,8,110,5,-0.2
1919,"Newcastle United",1,42,60,44,39,5,1.42857142857143,1.04761904761905,0.928571428571429,0.119047619047619,9,9,22,22,4,116,5,-1
1919,"Nottingham Forest",2,42,42,43,73,-30,1,1.02380952380952,1.73809523809524,-0.714285714285714,39,17,23,45,38,117,1,0.6
1919,"Notts County",1,42,48,56,74,-18,1.14285714285714,1.33333333333333,1.76190476190476,-0.428571428571429,21,21,22,22,28,120,-7,-2.3
1919,"Oldham Athletic",1,42,53,49,52,-3,1.26190476190476,1.16666666666667,1.23809523809524,-0.0714285714285714,16,16,22,22,19,102,-3,-0.9
1919,"Port Vale",2,34,42,42,52,-10,1.23529411764706,1.23529411764706,1.52941176470588,-0.294117647058824,40,18,23,45,41,107,-1,-0.6
1919,"Preston North End",1,42,52,57,73,-16,1.23809523809524,1.35714285714286,1.73809523809524,-0.380952380952381,17,17,22,22,15,121,2,-2.2
1919,"Rotherham County",2,42,47,51,83,-32,1.11904761904762,1.21428571428571,1.97619047619048,-0.761904761904762,38,16,23,45,39,6,-1,NA
1919,"Sheffield United",1,42,56,59,69,-10,1.33333333333333,1.4047619047619,1.64285714285714,-0.238095238095238,12,12,22,22,20,117,-8,-0.8
1919,"Sheffield Wednesday",1,42,30,28,64,-36,0.714285714285714,0.666666666666667,1.52380952380952,-0.857142857142857,22,22,22,22,32,117,-10,2.1
1919,"South Shields",2,42,57,58,48,10,1.35714285714286,1.38095238095238,1.14285714285714,0.238095238095238,32,10,23,45,30,11,2,-2.6
1919,"Stockport County",2,42,51,52,61,-9,1.21428571428571,1.23809523809524,1.45238095238095,-0.214285714285714,37,15,23,45,44,99,-7,-1
1919,"Stoke City",2,42,60,60,54,6,1.42857142857143,1.42857142857143,1.28571428571429,0.142857142857143,31,9,23,45,42,113,-11,-0.1
1919,"Sunderland",1,42,70,72,59,13,1.66666666666667,1.71428571428571,1.4047619047619,0.30952380952381,4,4,22,22,12,119,-8,-0.4
1919,"Tottenham Hotspur",2,42,102,102,32,70,2.42857142857143,2.42857142857143,0.761904761904762,1.66666666666667,23,1,23,45,6,101,17,-1.1
1919,"West Bromwich Albion",1,42,88,104,47,57,2.0952380952381,2.47619047619048,1.11904761904762,1.35714285714286,1,1,22,22,16,121,-15,-2.7
1919,"West Ham United",2,42,66,47,40,7,1.57142857142857,1.11904761904762,0.952380952380952,0.166666666666667,29,7,23,45,27,94,2,2.2
1919,"Wolverhampton Wanderers",2,42,40,55,80,-25,0.952380952380952,1.30952380952381,1.9047619047619,-0.595238095238095,41,19,23,45,34,121,7,1
1920,"Arsenal",1,42,59,59,63,-4,1.4047619047619,1.4047619047619,1.5,-0.0952380952380952,10,10,22,22,15,116,-5,0.9
1920,"Aston Villa",1,42,61,63,70,-7,1.45238095238095,1.5,1.66666666666667,-0.166666666666667,9,9,22,22,4,121,5,0.7
1920,"Barnsley",2,42,46,48,50,-2,1.0952380952381,1.14285714285714,1.19047619047619,-0.0476190476190476,43,21,22,44,24,111,19,0.2
1920,"Birmingham City",2,42,82,79,38,41,1.95238095238095,1.88095238095238,0.904761904761905,0.976190476190476,23,1,22,44,16,117,7,0.4
1920,"Blackburn Rovers",1,42,54,57,59,-2,1.28571428571429,1.35714285714286,1.4047619047619,-0.0476190476190476,13,13,22,22,17,121,-4,0.4
1920,"Blackpool",2,42,70,54,42,12,1.66666666666667,1.28571428571429,1,0.285714285714286,25,3,22,44,39,112,-14,0.5
1920,"Bolton Wanderers",1,42,71,77,53,24,1.69047619047619,1.83333333333333,1.26190476190476,0.571428571428571,3,3,22,22,5,121,-2,-1.1
1920,"Bradford City",1,42,51,61,63,-2,1.21428571428571,1.45238095238095,1.5,-0.0476190476190476,18,18,22,22,21,106,-3,-1.4
1920,"Bradford Park Avenue",1,42,32,43,76,-33,0.761904761904762,1.02380952380952,1.80952380952381,-0.785714285714286,21,21,22,22,43,51,-22,-0.7
1920,"Brentford",3,42,39,42,67,-25,0.928571428571429,1,1.5952380952381,-0.595238095238095,65,21,22,66,56,93,9,1.3
1920,"Brighton & Hove Albion",3,42,50,42,61,-19,1.19047619047619,1,1.45238095238095,-0.452380952380952,60,16,22,66,75,93,-15,0.4
1920,"Bristol City",2,42,70,49,29,20,1.66666666666667,1.16666666666667,0.69047619047619,0.476190476190476,26,4,22,44,44,108,-18,-1.2
1920,"Bristol Rovers",3,42,61,68,57,11,1.45238095238095,1.61904761904762,1.35714285714286,0.261904761904762,52,8,22,66,66,92,-14,-1.9
1920,"Burnley",1,42,82,79,36,43,1.95238095238095,1.88095238095238,0.857142857142857,1.02380952380952,1,1,22,22,3,121,-2,-2.9
1920,"Bury",2,42,55,45,49,-4,1.30952380952381,1.07142857142857,1.16666666666667,-0.0952380952380952,33,11,22,44,33,114,0,-0.1
1920,"Cardiff City",2,42,82,59,32,27,1.95238095238095,1.4047619047619,0.761904761904762,0.642857142857143,24,2,22,44,6,93,18,-2
1920,"Chelsea",1,42,52,48,58,-10,1.23809523809524,1.14285714285714,1.38095238095238,-0.238095238095238,17,17,22,22,8,104,9,0.4
1920,"Coventry City",2,42,47,39,70,-31,1.11904761904762,0.928571428571429,1.66666666666667,-0.738095238095238,40,18,22,44,42,94,-2,-3
1920,"Crystal Palace",3,42,83,70,34,36,1.97619047619048,1.66666666666667,0.80952380952381,0.857142857142857,45,1,22,66,37,93,8,-0.6
1920,"Derby County",1,42,31,32,58,-26,0.738095238095238,0.761904761904762,1.38095238095238,-0.619047619047619,22,22,22,22,34,121,-12,1.5
1920,"Everton",1,42,64,66,55,11,1.52380952380952,1.57142857142857,1.30952380952381,0.261904761904762,7,7,22,22,20,121,-13,-1.6
1920,"Exeter City",3,42,45,39,54,-15,1.07142857142857,0.928571428571429,1.28571428571429,-0.357142857142857,63,19,22,66,80,88,-17,-0.4
1920,"Fulham",2,42,58,43,47,-4,1.38095238095238,1.02380952380952,1.11904761904762,-0.0952380952380952,31,9,22,44,28,102,3,-3.1
1920,"Gillingham",3,42,36,34,74,-40,0.857142857142857,0.80952380952381,1.76190476190476,-0.952380952380952,66,22,22,66,72,88,-6,-0.8
1920,"Grimsby Town",3,42,54,49,59,-10,1.28571428571429,1.16666666666667,1.4047619047619,-0.238095238095238,55,11,22,66,50,110,5,4.3
1920,"Huddersfield Town",1,42,54,42,49,-7,1.28571428571429,1,1.16666666666667,-0.166666666666667,14,14,22,22,14,99,0,0.9
1920,"Hull City",2,42,50,43,53,-10,1.19047619047619,1.02380952380952,1.26190476190476,-0.238095238095238,37,15,22,44,27,104,10,-1.7
1920,"Leeds United",2,42,52,40,45,-5,1.23809523809524,0.952380952380952,1.07142857142857,-0.119047619047619,35,13,22,44,30,93,5,1.4
1920,"Leicester City",2,42,52,39,46,-7,1.23809523809524,0.928571428571429,1.0952380952381,-0.166666666666667,36,14,22,44,31,115,5,2.1
1920,"Leyton Orient",2,42,61,43,42,1,1.45238095238095,1.02380952380952,1,0.0238095238095238,29,7,22,44,35,102,-6,-4.9
1920,"Liverpool",1,42,69,63,35,28,1.64285714285714,1.5,0.833333333333333,0.666666666666667,5,5,22,22,1,116,4,-0.5
1920,"Luton Town",3,42,60,61,56,5,1.42857142857143,1.45238095238095,1.33333333333333,0.119047619047619,53,9,22,66,48,91,5,-0.6
1920,"Manchester City",1,42,78,70,50,20,1.85714285714286,1.66666666666667,1.19047619047619,0.476190476190476,2,2,22,22,9,117,-7,-0.6
1920,"Manchester United",1,42,55,64,68,-4,1.30952380952381,1.52380952380952,1.61904761904762,-0.0952380952380952,11,11,22,22,22,117,-11,-1.1
1920,"Merthyr Town",3,42,60,60,49,11,1.42857142857143,1.42857142857143,1.16666666666667,0.261904761904762,54,10,22,66,60,10,-6,NA
1920,"Middlesbrough",1,42,63,53,53,0,1.5,1.26190476190476,1.26190476190476,0,8,8,22,22,10,110,-2,0.2
1920,"Millwall",3,42,65,42,30,12,1.54761904761905,1,0.714285714285714,0.285714285714286,51,7,22,66,77,93,-26,1.5
1920,"Newcastle United",1,42,70,66,45,21,1.66666666666667,1.57142857142857,1.07142857142857,0.5,4,4,22,22,7,116,-3,-1.3
1920,"Newport County",3,42,51,43,64,-21,1.21428571428571,1.02380952380952,1.52380952380952,-0.5,58,14,22,66,81,67,-23,-2.8
1920,"Northampton Town",3,42,53,59,75,-16,1.26190476190476,1.4047619047619,1.78571428571429,-0.380952380952381,57,13,22,66,73,93,-16,0
1920,"Norwich City",3,42,46,44,53,-9,1.0952380952381,1.04761904761905,1.26190476190476,-0.214285714285714,62,18,22,66,74,93,-12,-2.5
1920,"Nottingham Forest",2,42,48,48,55,-7,1.14285714285714,1.14285714285714,1.30952380952381,-0.166666666666667,38,16,22,44,23,117,15,-0.1
1920,"Notts County",2,42,65,55,40,15,1.54761904761905,1.30952380952381,0.952380952380952,0.357142857142857,28,6,22,44,38,120,-10,-1.8
1920,"Oldham Athletic",1,42,42,49,86,-37,1,1.16666666666667,2.04761904761905,-0.880952380952381,19,19,22,22,19,102,0,-1.6
1920,"Plymouth Argyle",3,42,54,35,34,1,1.28571428571429,0.833333333333333,0.80952380952381,0.0238095238095238,56,12,22,66,45,93,11,1.6
1920,"Port Vale",2,42,47,43,49,-6,1.11904761904762,1.02380952380952,1.16666666666667,-0.142857142857143,41,19,22,44,40,107,1,1.5
1920,"Portsmouth",3,42,51,46,48,-2,1.21428571428571,1.0952380952381,1.14285714285714,-0.0476190476190476,59,15,22,66,51,93,8,5.5
1920,"Preston North End",1,42,54,61,65,-4,1.28571428571429,1.45238095238095,1.54761904761905,-0.0952380952380952,15,15,22,22,18,121,-3,-1.6
1920,"Queens Park Rangers",3,42,75,61,32,29,1.78571428571429,1.45238095238095,0.761904761904762,0.69047619047619,46,2,22,66,52,93,-6,-1.4
1920,"Reading",3,42,43,42,59,-17,1.02380952380952,1,1.4047619047619,-0.404761904761905,64,20,22,66,67,93,-3,2.1
1920,"Rotherham County",2,42,48,37,53,-16,1.14285714285714,0.880952380952381,1.26190476190476,-0.380952380952381,39,17,22,44,36,6,3,NA
1920,"Sheffield United",1,42,36,42,68,-26,0.857142857142857,1,1.61904761904762,-0.619047619047619,20,20,22,22,12,117,8,0.4
1920,"Sheffield Wednesday",2,42,56,48,48,0,1.33333333333333,1.14285714285714,1.14285714285714,0,32,10,22,44,32,117,0,2.9
1920,"South Shields",2,42,61,61,46,15,1.45238095238095,1.45238095238095,1.0952380952381,0.357142857142857,30,8,22,44,29,11,1,NA
1920,"Southampton",3,42,73,64,28,36,1.73809523809524,1.52380952380952,0.666666666666667,0.857142857142857,47,3,22,66,46,93,1,1.8
1920,"Southend United",3,42,50,44,61,-17,1.19047619047619,1.04761904761905,1.45238095238095,-0.404761904761905,61,17,22,66,86,93,-25,0.8
1920,"Stockport County",2,42,39,42,75,-33,0.928571428571429,1,1.78571428571429,-0.785714285714286,44,22,22,44,47,99,-3,-1.1
1920,"Stoke City",2,42,47,46,56,-10,1.11904761904762,1.0952380952381,1.33333333333333,-0.238095238095238,42,20,22,44,25,113,17,0.9
1920,"Sunderland",1,42,55,57,60,-3,1.30952380952381,1.35714285714286,1.42857142857143,-0.0714285714285714,12,12,22,22,11,119,1,0.1
1920,"Swansea City",3,42,69,56,45,11,1.64285714285714,1.33333333333333,1.07142857142857,0.261904761904762,49,5,22,66,65,93,-16,0.7
1920,"Swindon Town",3,42,73,73,49,24,1.73809523809524,1.73809523809524,1.16666666666667,0.571428571428571,48,4,22,66,54,93,-6,-1.6
1920,"Tottenham Hotspur",1,42,66,70,48,22,1.57142857142857,1.66666666666667,1.14285714285714,0.523809523809524,6,6,22,22,2,101,4,-1.9
1920,"Watford",3,42,68,59,44,15,1.61904761904762,1.4047619047619,1.04761904761905,0.357142857142857,50,6,22,66,62,93,-12,-2.9
1920,"West Bromwich Albion",1,42,53,54,58,-4,1.26190476190476,1.28571428571429,1.38095238095238,-0.0952380952380952,16,16,22,22,13,121,3,-0.8
1920,"West Ham United",2,42,67,51,30,21,1.5952380952381,1.21428571428571,0.714285714285714,0.5,27,5,22,44,26,94,1,0.9
1920,"Wolverhampton Wanderers",2,42,54,49,66,-17,1.28571428571429,1.16666666666667,1.57142857142857,-0.404761904761905,34,12,22,44,41,121,-7,0.7
1921,"Aberdare Athletic",3,42,61,57,51,6,1.45238095238095,1.35714285714286,1.21428571428571,0.142857142857143,53,9,42,86,84,6,-31,NA
1921,"Accrington Stanley",3,38,60,73,57,16,1.57894736842105,1.92105263157895,1.5,0.421052631578947,55,11,42,86,61,34,-6,-1.8
1921,"Arsenal",1,42,52,47,56,-9,1.23809523809524,1.11904761904762,1.33333333333333,-0.214285714285714,15,15,22,22,10,116,5,1.3
1921,"Ashington",3,38,55,59,66,-7,1.44736842105263,1.55263157894737,1.73684210526316,-0.184210526315789,63,19,42,86,83,8,-20,NA
1921,"Aston Villa",1,42,69,74,55,19,1.64285714285714,1.76190476190476,1.30952380952381,0.452380952380952,4,4,22,22,6,121,-2,-0.3
1921,"Barnsley",2,42,74,67,52,15,1.76190476190476,1.5952380952381,1.23809523809524,0.357142857142857,24,2,22,44,31,111,-7,-1.9
1921,"Barrow",3,38,47,42,54,-12,1.23684210526316,1.10526315789474,1.42105263157895,-0.315789473684211,78,34,42,86,80,44,-2,2.7
1921,"Birmingham City",1,42,52,48,60,-12,1.23809523809524,1.14285714285714,1.42857142857143,-0.285714285714286,16,16,22,22,16,117,0,0.6
1921,"Blackburn Rovers",1,42,51,54,57,-3,1.21428571428571,1.28571428571429,1.35714285714286,-0.0714285714285714,17,17,22,22,13,121,4,0.2
1921,"Blackpool",2,42,50,44,57,-13,1.19047619047619,1.04761904761905,1.35714285714286,-0.30952380952381,39,17,22,44,26,112,13,1.9
1921,"Bolton Wanderers",1,42,67,68,59,9,1.5952380952381,1.61904761904762,1.4047619047619,0.214285714285714,5,5,22,22,14,121,-9,-0.8
1921,"Bradford City",1,42,43,48,72,-24,1.02380952380952,1.14285714285714,1.71428571428571,-0.571428571428571,21,21,22,22,41,106,-20,-0.8
1921,"Bradford Park Avenue",2,42,45,46,62,-16,1.07142857142857,1.0952380952381,1.47619047619048,-0.380952380952381,43,21,22,44,51,51,-8,1.7
1921,"Brentford",3,42,59,52,43,9,1.4047619047619,1.23809523809524,1.02380952380952,0.214285714285714,56,12,42,86,69,93,-13,0.1
1921,"Brighton & Hove Albion",3,42,48,45,51,-6,1.14285714285714,1.07142857142857,1.21428571428571,-0.142857142857143,75,31,42,86,49,93,26,1.2
1921,"Bristol City",2,42,45,37,58,-21,1.07142857142857,0.880952380952381,1.38095238095238,-0.5,44,22,22,44,45,108,-1,0
1921,"Bristol Rovers",3,42,52,52,67,-15,1.23809523809524,1.23809523809524,1.5952380952381,-0.357142857142857,66,22,42,86,65,92,1,-1.2
1921,"Burnley",1,42,71,72,54,18,1.69047619047619,1.71428571428571,1.28571428571429,0.428571428571429,3,3,22,22,15,121,-12,-3.8
1921,"Bury",2,42,55,54,55,-1,1.30952380952381,1.28571428571429,1.30952380952381,-0.0238095238095238,33,11,22,44,27,114,6,0.6
1921,"Cardiff City",1,42,67,61,53,8,1.5952380952381,1.45238095238095,1.26190476190476,0.19047619047619,6,6,22,22,9,93,-3,-5.2
1921,"Charlton Athletic",3,42,50,43,56,-13,1.19047619047619,1.02380952380952,1.33333333333333,-0.30952380952381,71,27,42,86,64,92,7,4.1
1921,"Chelsea",1,42,63,40,43,-3,1.5,0.952380952380952,1.02380952380952,-0.0714285714285714,8,8,22,22,20,104,-12,-0.4
1921,"Chesterfield",3,38,51,48,67,-19,1.34210526315789,1.26315789473684,1.76315789473684,-0.5,69,25,42,86,54,100,15,3
1921,"Coventry City",2,42,46,51,60,-9,1.0952380952381,1.21428571428571,1.42857142857143,-0.214285714285714,42,20,22,44,37,94,5,-2.3
1921,"Crewe Alexandra",3,38,59,60,56,4,1.55263157894737,1.57894736842105,1.47368421052632,0.105263157894737,57,13,42,86,59,96,-2,0.5
1921,"Crystal Palace",2,42,52,45,51,-6,1.23809523809524,1.07142857142857,1.21428571428571,-0.142857142857143,37,15,22,44,39,93,-2,-1.6
1921,"Darlington",3,38,72,81,37,44,1.89473684210526,2.13157894736842,0.973684210526316,1.15789473684211,49,5,42,86,66,81,-17,-1.8
1921,"Derby County",2,42,54,60,64,-4,1.28571428571429,1.42857142857143,1.52380952380952,-0.0952380952380952,34,12,22,44,36,121,-2,1.7
1921,"Durham City",3,38,54,68,67,1,1.42105263157895,1.78947368421053,1.76315789473684,0.0263157894736842,64,20,42,86,85,7,-21,NA
1921,"Everton",1,42,48,57,55,2,1.14285714285714,1.35714285714286,1.30952380952381,0.0476190476190476,20,20,22,22,4,121,16,1.9
1921,"Exeter City",3,42,45,38,59,-21,1.07142857142857,0.904761904761905,1.4047619047619,-0.5,80,36,42,86,77,88,3,2.4
1921,"Fulham",2,42,63,57,38,19,1.5,1.35714285714286,0.904761904761905,0.452380952380952,28,6,22,44,32,102,-4,-1.9
1921,"Gillingham",3,42,50,47,60,-13,1.19047619047619,1.11904761904762,1.42857142857143,-0.30952380952381,72,28,42,86,67,88,5,-1.2
1921,"Grimsby Town",3,38,71,72,47,25,1.86842105263158,1.89473684210526,1.23684210526316,0.657894736842105,50,6,42,86,75,110,-25,2.9
1921,"Halifax Town",3,38,39,56,76,-20,1.02631578947368,1.47368421052632,2,-0.526315789473684,83,39,42,86,62,69,21,0.8
1921,"Hartlepool United",3,38,59,52,39,13,1.55263157894737,1.36842105263158,1.02631578947368,0.342105263157895,58,14,42,86,82,89,-24,-1.2
1921,"Huddersfield Town",1,42,54,53,54,-1,1.28571428571429,1.26190476190476,1.28571428571429,-0.0238095238095238,14,14,22,22,3,99,11,1
1921,"Hull City",2,42,67,51,41,10,1.5952380952381,1.21428571428571,0.976190476190476,0.238095238095238,27,5,22,44,33,104,-6,-3.2
1921,"Leeds United",2,42,61,48,38,10,1.45238095238095,1.14285714285714,0.904761904761905,0.238095238095238,30,8,22,44,28,93,2,0.6
1921,"Leicester City",2,42,59,39,34,5,1.4047619047619,0.928571428571429,0.80952380952381,0.119047619047619,31,9,22,44,24,115,7,1.3
1921,"Leyton Orient",2,42,54,43,50,-7,1.28571428571429,1.02380952380952,1.19047619047619,-0.166666666666667,35,13,22,44,42,102,-7,-4.4
1921,"Lincoln City",3,38,48,48,59,-11,1.26315789473684,1.26315789473684,1.55263157894737,-0.289473684210526,76,32,42,86,71,107,5,3.1
1921,"Liverpool",1,42,79,63,36,27,1.88095238095238,1.5,0.857142857142857,0.642857142857143,1,1,22,22,1,116,0,-0.8
1921,"Luton Town",3,42,74,64,35,29,1.76190476190476,1.52380952380952,0.833333333333333,0.69047619047619,48,4,42,86,50,91,-2,-0.9
1921,"Manchester City",1,42,63,65,70,-5,1.5,1.54761904761905,1.66666666666667,-0.119047619047619,9,9,22,22,7,117,2,-1
1921,"Manchester United",1,42,36,41,73,-32,0.857142857142857,0.976190476190476,1.73809523809524,-0.761904761904762,22,22,22,22,29,117,-7,-1
1921,"Merthyr Town",3,42,57,45,56,-11,1.35714285714286,1.07142857142857,1.33333333333333,-0.261904761904762,60,16,42,86,76,10,-16,NA
1921,"Middlesbrough",1,42,62,79,69,10,1.47619047619048,1.88095238095238,1.64285714285714,0.238095238095238,10,10,22,22,18,110,-8,-0.6
1921,"Millwall",3,42,48,38,42,-4,1.14285714285714,0.904761904761905,1,-0.0952380952380952,77,33,42,86,60,93,17,4.6
1921,"Nelson",3,38,46,48,66,-18,1.21052631578947,1.26315789473684,1.73684210526316,-0.473684210526316,79,35,42,86,47,10,32,NA
1921,"Newcastle United",1,42,64,59,45,14,1.52380952380952,1.4047619047619,1.07142857142857,0.333333333333333,7,7,22,22,5,116,2,-0.4
1921,"Newport County",3,42,45,44,61,-17,1.07142857142857,1.04761904761905,1.45238095238095,-0.404761904761905,81,37,42,86,86,67,-5,-0.4
1921,"Northampton Town",3,42,50,47,71,-24,1.19047619047619,1.11904761904762,1.69047619047619,-0.571428571428571,73,29,42,86,55,93,18,0.4
1921,"Norwich City",3,42,49,50,62,-12,1.16666666666667,1.19047619047619,1.47619047619048,-0.285714285714286,74,30,42,86,72,93,2,1
1921,"Nottingham Forest",2,42,78,51,30,21,1.85714285714286,1.21428571428571,0.714285714285714,0.5,23,1,22,44,19,117,4,-1.1
1921,"Notts County",2,42,51,47,51,-4,1.21428571428571,1.11904761904762,1.21428571428571,-0.0952380952380952,38,16,22,44,23,120,15,0
1921,"Oldham Athletic",1,42,50,38,50,-12,1.19047619047619,0.904761904761905,1.19047619047619,-0.285714285714286,19,19,22,22,21,102,-2,-2.1
1921,"Plymouth Argyle",3,42,86,63,24,39,2.04761904761905,1.5,0.571428571428571,0.928571428571429,45,1,42,86,46,93,-1,1.7
1921,"Port Vale",2,42,50,43,57,-14,1.19047619047619,1.02380952380952,1.35714285714286,-0.333333333333333,40,18,22,44,38,107,2,-0.2
1921,"Portsmouth",3,42,71,62,39,23,1.69047619047619,1.47619047619048,0.928571428571429,0.547619047619048,51,7,42,86,52,93,-1,4.3
1921,"Preston North End",1,42,51,42,65,-23,1.21428571428571,1,1.54761904761905,-0.547619047619048,18,18,22,22,17,121,1,-1.7
1921,"Queens Park Rangers",3,42,67,53,44,9,1.5952380952381,1.26190476190476,1.04761904761905,0.214285714285714,52,8,42,86,63,93,-11,-1.6
1921,"Reading",3,42,52,40,47,-7,1.23809523809524,0.952380952380952,1.11904761904762,-0.166666666666667,67,23,42,86,78,93,-11,1.9
1921,"Rochdale",3,38,37,52,77,-25,0.973684210526316,1.36842105263158,2.02631578947368,-0.657894736842105,85,41,42,86,73,92,12,-0.2
1921,"Rotherham County",2,42,53,32,43,-11,1.26190476190476,0.761904761904762,1.02380952380952,-0.261904761904762,36,14,22,44,43,6,-7,NA
1921,"Sheffield United",1,42,55,59,54,5,1.30952380952381,1.4047619047619,1.28571428571429,0.119047619047619,12,12,22,22,11,117,1,0.7
1921,"Sheffield Wednesday",2,42,59,47,50,-3,1.4047619047619,1.11904761904762,1.19047619047619,-0.0714285714285714,32,10,22,44,30,117,2,2.9
1921,"South Shields",2,42,63,43,38,5,1.5,1.02380952380952,0.904761904761905,0.119047619047619,29,7,22,44,35,11,-6,NA
1921,"Southampton",3,42,84,68,21,47,2,1.61904761904762,0.5,1.11904761904762,46,2,42,86,34,93,12,1
1921,"Southend United",3,42,35,34,74,-40,0.833333333333333,0.80952380952381,1.76190476190476,-0.952380952380952,86,42,42,86,74,93,12,3.6
1921,"Southport",3,38,52,55,44,11,1.36842105263158,1.44736842105263,1.15789473684211,0.289473684210526,68,24,42,86,81,50,-13,0.7
1921,"Stalybridge Celtic",3,38,59,62,63,-1,1.55263157894737,1.63157894736842,1.65789473684211,-0.0263157894736842,59,15,42,86,70,2,-11,NA
1921,"Stockport County",3,38,80,60,21,39,2.10526315789474,1.57894736842105,0.552631578947368,1.02631578947368,47,3,42,86,40,99,7,-2.9
1921,"Stoke City",2,42,70,60,44,16,1.66666666666667,1.42857142857143,1.04761904761905,0.380952380952381,25,3,22,44,22,113,3,0
1921,"Sunderland",1,42,56,60,62,-2,1.33333333333333,1.42857142857143,1.47619047619048,-0.0476190476190476,11,11,22,22,2,119,9,-0.3
1921,"Swansea City",3,42,54,50,47,3,1.28571428571429,1.19047619047619,1.11904761904762,0.0714285714285714,65,21,42,86,48,93,17,2.8
1921,"Swindon Town",3,42,61,72,60,12,1.45238095238095,1.71428571428571,1.42857142857143,0.285714285714286,54,10,42,86,56,93,-2,-2.3
1921,"Tottenham Hotspur",1,42,72,65,39,26,1.71428571428571,1.54761904761905,0.928571428571429,0.619047619047619,2,2,22,22,12,101,-10,-3.1
1921,"Tranmere Rovers",3,38,38,51,61,-10,1,1.34210526315789,1.60526315789474,-0.263157894736842,84,40,42,86,79,89,5,3
1921,"Walsall",3,38,57,66,65,1,1.5,1.73684210526316,1.71052631578947,0.0263157894736842,61,17,42,86,53,100,8,-1
1921,"Watford",3,42,57,54,48,6,1.35714285714286,1.28571428571429,1.14285714285714,0.142857142857143,62,18,42,86,58,93,4,0.2
1921,"West Bromwich Albion",1,42,55,51,63,-12,1.30952380952381,1.21428571428571,1.5,-0.285714285714286,13,13,22,22,8,121,5,0.7
1921,"West Ham United",2,42,68,52,39,13,1.61904761904762,1.23809523809524,0.928571428571429,0.30952380952381,26,4,22,44,25,94,1,0.4
1921,"Wigan Borough",3,38,42,46,72,-26,1.10526315789474,1.21052631578947,1.89473684210526,-0.684210526315789,82,38,42,86,57,11,25,-0.6
1921,"Wolverhampton Wanderers",2,42,50,44,49,-5,1.19047619047619,1.04761904761905,1.16666666666667,-0.119047619047619,41,19,22,44,44,121,-3,1.8
1921,"Wrexham",3,38,51,51,56,-5,1.34210526315789,1.34210526315789,1.47368421052632,-0.131578947368421,70,26,42,86,68,80,2,0.8
1922,"Aberdare Athletic",3,42,38,42,70,-28,0.904761904761905,1,1.66666666666667,-0.666666666666667,84,40,42,86,72,6,12,NA
1922,"Accrington Stanley",3,38,58,59,65,-6,1.52631578947368,1.55263157894737,1.71052631578947,-0.157894736842105,61,17,42,86,64,34,-3,-0.9
1922,"Arsenal",1,42,58,61,62,-1,1.38095238095238,1.45238095238095,1.47619047619048,-0.0238095238095238,10,10,22,22,19,116,-9,0.9
1922,"Ashington",3,38,41,51,77,-26,1.07894736842105,1.34210526315789,2.02631578947368,-0.684210526315789,83,39,42,86,57,8,26,NA
1922,"Aston Villa",1,42,64,64,51,13,1.52380952380952,1.52380952380952,1.21428571428571,0.30952380952381,6,6,22,22,6,121,0,0.4
1922,"Barnsley",2,42,62,62,51,11,1.47619047619048,1.47619047619048,1.21428571428571,0.261904761904762,31,9,22,44,31,111,0,-2.4
1922,"Barrow",3,38,43,50,60,-10,1.13157894736842,1.31578947368421,1.57894736842105,-0.263157894736842,80,36,42,86,87,44,-7,1.8
1922,"Birmingham City",1,42,50,41,57,-16,1.19047619047619,0.976190476190476,1.35714285714286,-0.380952380952381,16,16,22,22,14,117,2,0.3
1922,"Blackburn Rovers",1,42,54,47,62,-15,1.28571428571429,1.11904761904762,1.47619047619048,-0.357142857142857,13,13,22,22,8,121,5,-0.3
1922,"Blackpool",2,42,65,60,43,17,1.54761904761905,1.42857142857143,1.02380952380952,0.404761904761905,26,4,22,44,26,112,0,0.6
1922,"Bolton Wanderers",1,42,54,50,58,-8,1.28571428571429,1.19047619047619,1.38095238095238,-0.19047619047619,14,14,22,22,5,121,9,-0.8
1922,"Bradford City",2,42,49,41,45,-4,1.16666666666667,0.976190476190476,1.07142857142857,-0.0952380952380952,41,19,22,44,39,106,2,0.6
1922,"Bradford Park Avenue",3,38,66,67,38,29,1.73684210526316,1.76315789473684,1,0.763157894736842,51,7,42,86,53,51,-2,2.2
1922,"Brentford",3,42,51,41,51,-10,1.21428571428571,0.976190476190476,1.21428571428571,-0.238095238095238,69,25,42,86,73,93,-4,2.4
1922,"Brighton & Hove Albion",3,42,71,52,34,18,1.69047619047619,1.23809523809524,0.80952380952381,0.428571428571429,49,5,42,86,54,93,-5,-1.6
1922,"Bristol City",3,42,83,66,40,26,1.97619047619048,1.57142857142857,0.952380952380952,0.619047619047619,45,1,42,86,44,108,1,-3.1
1922,"Bristol Rovers",3,42,55,35,36,-1,1.30952380952381,0.833333333333333,0.857142857142857,-0.0238095238095238,65,21,42,86,62,92,3,-0.1
1922,"Burnley",1,42,54,58,59,-1,1.28571428571429,1.38095238095238,1.4047619047619,-0.0238095238095238,15,15,22,22,17,121,-2,-2.7
1922,"Bury",2,42,65,55,46,9,1.54761904761905,1.30952380952381,1.0952380952381,0.214285714285714,27,5,22,44,24,114,3,0.1
1922,"Cardiff City",1,42,61,73,59,14,1.45238095238095,1.73809523809524,1.4047619047619,0.333333333333333,9,9,22,22,2,93,7,-7.4
1922,"Charlton Athletic",3,42,56,55,51,4,1.33333333333333,1.30952380952381,1.21428571428571,0.0952380952380952,64,20,42,86,77,92,-13,2
1922,"Chelsea",1,42,45,45,53,-8,1.07142857142857,1.07142857142857,1.26190476190476,-0.19047619047619,20,20,22,22,21,104,-1,0.2
1922,"Chesterfield",3,38,64,68,52,16,1.68421052631579,1.78947368421053,1.36842105263158,0.421052631578947,54,10,42,86,49,100,5,1.1
1922,"Coventry City",2,42,52,46,63,-17,1.23809523809524,1.0952380952381,1.5,-0.404761904761905,37,15,22,44,41,94,-4,-2.1
1922,"Crewe Alexandra",3,38,60,48,38,10,1.57894736842105,1.26315789473684,1,0.263157894736842,59,15,42,86,86,96,-27,0
1922,"Crystal Palace",2,42,50,54,62,-8,1.19047619047619,1.28571428571429,1.47619047619048,-0.19047619047619,39,17,22,44,37,93,2,-1.7
1922,"Darlington",3,38,55,59,46,13,1.44736842105263,1.55263157894737,1.21052631578947,0.342105263157895,66,22,42,86,55,81,11,-2
1922,"Derby County",2,42,53,46,50,-4,1.26190476190476,1.0952380952381,1.19047619047619,-0.0952380952380952,36,14,22,44,25,121,11,2.7
1922,"Durham City",3,38,37,43,59,-16,0.973684210526316,1.13157894736842,1.55263157894737,-0.421052631578947,85,41,42,86,69,7,16,NA
1922,"Everton",1,42,67,63,59,4,1.5952380952381,1.5,1.4047619047619,0.0952380952380952,4,4,22,22,7,121,-3,-0.7
1922,"Exeter City",3,42,46,47,84,-37,1.0952380952381,1.11904761904762,2,-0.880952380952381,77,33,42,86,71,88,6,3
1922,"Fulham",2,42,60,43,32,11,1.42857142857143,1.02380952380952,0.761904761904762,0.261904761904762,32,10,22,44,42,102,-10,0.7
1922,"Gillingham",3,42,52,51,59,-8,1.23809523809524,1.21428571428571,1.4047619047619,-0.19047619047619,67,23,42,86,75,88,-8,0.7
1922,"Grimsby Town",3,38,47,55,52,3,1.23684210526316,1.44736842105263,1.36842105263158,0.0789473684210526,75,31,42,86,67,110,8,3.9
1922,"Halifax Town",3,38,58,53,46,7,1.52631578947368,1.39473684210526,1.21052631578947,0.184210526315789,62,18,42,86,68,69,-6,-1
1922,"Hartlepool United",3,38,42,48,54,-6,1.10526315789474,1.26315789473684,1.42105263157895,-0.157894736842105,82,38,42,86,88,89,-6,1.1
1922,"Huddersfield Town",1,42,74,60,32,28,1.76190476190476,1.42857142857143,0.761904761904762,0.666666666666667,3,3,22,22,1,99,2,-0.3
1922,"Hull City",2,42,56,43,45,-2,1.33333333333333,1.02380952380952,1.07142857142857,-0.0476190476190476,33,11,22,44,40,104,-7,-1.3
1922,"Leeds United",2,42,65,43,36,7,1.54761904761905,1.02380952380952,0.857142857142857,0.166666666666667,28,6,22,44,23,93,5,1.8
1922,"Leicester City",2,42,72,65,44,21,1.71428571428571,1.54761904761905,1.04761904761905,0.5,24,2,22,44,32,115,-8,0.3
1922,"Leyton Orient",2,42,48,40,50,-10,1.14285714285714,0.952380952380952,1.19047619047619,-0.238095238095238,42,20,22,44,34,102,8,-4.6
1922,"Lincoln City",3,38,49,39,55,-16,1.28947368421053,1.02631578947368,1.44736842105263,-0.421052631578947,71,27,42,86,83,107,-12,3.1
1922,"Liverpool",1,42,86,70,31,39,2.04761904761905,1.66666666666667,0.738095238095238,0.928571428571429,1,1,22,22,11,116,-10,-1.3
1922,"Luton Town",3,42,70,68,49,19,1.66666666666667,1.61904761904762,1.16666666666667,0.452380952380952,50,6,42,86,58,91,-8,-2.3
1922,"Manchester City",1,42,62,50,49,1,1.47619047619048,1.19047619047619,1.16666666666667,0.0238095238095238,7,7,22,22,10,117,-3,-0.8
1922,"Manchester United",2,42,65,51,36,15,1.54761904761905,1.21428571428571,0.857142857142857,0.357142857142857,29,7,22,44,36,117,-7,-0.3
1922,"Merthyr Town",3,42,47,39,48,-9,1.11904761904762,0.928571428571429,1.14285714285714,-0.214285714285714,76,32,42,86,76,10,0,NA
1922,"Middlesbrough",1,42,49,57,63,-6,1.16666666666667,1.35714285714286,1.5,-0.142857142857143,18,18,22,22,22,110,-4,0.1
1922,"Millwall",3,42,60,45,40,5,1.42857142857143,1.07142857142857,0.952380952380952,0.119047619047619,60,16,42,86,50,93,10,3
1922,"Nelson",3,38,75,61,41,20,1.97368421052632,1.60526315789474,1.07894736842105,0.526315789473684,47,3,42,86,43,10,4,NA
1922,"Newcastle United",1,42,66,45,37,8,1.57142857142857,1.07142857142857,0.880952380952381,0.19047619047619,5,5,22,22,9,116,-4,0.1
1922,"Newport County",3,42,35,40,70,-30,0.833333333333333,0.952380952380952,1.66666666666667,-0.714285714285714,86,42,42,86,61,67,25,0.3
1922,"Northampton Town",3,42,62,54,44,10,1.47619047619048,1.28571428571429,1.04761904761905,0.238095238095238,55,11,42,86,59,93,-4,-0.6
1922,"Norwich City",3,42,49,51,71,-20,1.16666666666667,1.21428571428571,1.69047619047619,-0.476190476190476,72,28,42,86,65,93,7,2.3
1922,"Nottingham Forest",1,42,47,41,70,-29,1.11904761904762,0.976190476190476,1.66666666666667,-0.69047619047619,19,19,22,22,20,117,-1,-0.8
1922,"Notts County",2,42,76,46,34,12,1.80952380952381,1.0952380952381,0.80952380952381,0.285714285714286,23,1,22,44,12,120,11,-1.4
1922,"Oldham Athletic",1,42,40,35,65,-30,0.952380952380952,0.833333333333333,1.54761904761905,-0.714285714285714,21,21,22,22,33,102,-12,-1.7
1922,"Plymouth Argyle",3,42,76,61,29,32,1.80952380952381,1.45238095238095,0.69047619047619,0.761904761904762,46,2,42,86,48,93,-2,1.2
1922,"Port Vale",2,42,51,39,51,-12,1.21428571428571,0.928571428571429,1.21428571428571,-0.285714285714286,38,16,22,44,38,107,0,-0.1
1922,"Portsmouth",3,42,65,58,52,6,1.54761904761905,1.38095238095238,1.23809523809524,0.142857142857143,52,8,42,86,47,93,5,4.5
1922,"Preston North End",1,42,50,60,64,-4,1.19047619047619,1.42857142857143,1.52380952380952,-0.0952380952380952,17,17,22,22,18,121,-1,-1.6
1922,"Queens Park Rangers",3,42,58,54,49,5,1.38095238095238,1.28571428571429,1.16666666666667,0.119047619047619,63,19,42,86,84,93,-21,-1.1
1922,"Reading",3,42,44,36,55,-19,1.04761904761905,0.857142857142857,1.30952380952381,-0.452380952380952,78,34,42,86,78,93,0,2.6
1922,"Rochdale",3,38,49,42,53,-11,1.28947368421053,1.10526315789474,1.39473684210526,-0.289473684210526,73,29,42,86,45,92,28,-0.8
1922,"Rotherham County",2,42,48,44,63,-19,1.14285714285714,1.04761904761905,1.5,-0.452380952380952,43,21,22,44,51,6,-8,NA
1922,"Sheffield United",1,42,58,68,64,4,1.38095238095238,1.61904761904762,1.52380952380952,0.0952380952380952,11,11,22,22,4,117,7,0.3
1922,"Sheffield Wednesday",2,42,63,54,47,7,1.5,1.28571428571429,1.11904761904762,0.166666666666667,30,8,22,44,29,117,1,2.7
1922,"South Shields",2,42,55,35,44,-9,1.30952380952381,0.833333333333333,1.04761904761905,-0.214285714285714,35,13,22,44,28,11,7,NA
1922,"Southampton",2,42,56,40,40,0,1.33333333333333,0.952380952380952,0.952380952380952,0,34,12,22,44,27,93,7,0.3
1922,"Southend United",3,42,49,49,54,-5,1.16666666666667,1.16666666666667,1.28571428571429,-0.119047619047619,74,30,42,86,81,93,-7,0.5
1922,"Southport",3,38,43,32,46,-14,1.13157894736842,0.842105263157895,1.21052631578947,-0.368421052631579,81,37,42,86,60,50,21,1.3
1922,"Stalybridge Celtic",3,38,51,42,47,-5,1.34210526315789,1.10526315789474,1.23684210526316,-0.131578947368421,70,26,42,86,NA,2,NA,NA
1922,"Stockport County",2,42,50,43,58,-15,1.19047619047619,1.02380952380952,1.38095238095238,-0.357142857142857,40,18,22,44,35,99,5,-1
1922,"Stoke City",1,42,40,47,67,-20,0.952380952380952,1.11904761904762,1.5952380952381,-0.476190476190476,22,22,22,22,30,113,-8,-0.1
1922,"Sunderland",1,42,76,72,54,18,1.80952380952381,1.71428571428571,1.28571428571429,0.428571428571429,2,2,22,22,3,119,-1,-1
1922,"Swansea City",3,42,75,78,45,33,1.78571428571429,1.85714285714286,1.07142857142857,0.785714285714286,48,4,42,86,52,93,-4,2
1922,"Swindon Town",3,42,62,62,56,6,1.47619047619048,1.47619047619048,1.33333333333333,0.142857142857143,56,12,42,86,56,93,0,-3.1
1922,"Tottenham Hotspur",1,42,58,50,50,0,1.38095238095238,1.19047619047619,1.19047619047619,0,12,12,22,22,15,101,-3,-1.2
1922,"Tranmere Rovers",3,38,44,49,59,-10,1.15789473684211,1.28947368421053,1.55263157894737,-0.263157894736842,79,35,42,86,70,89,9,1.2
1922,"Walsall",3,38,65,51,44,7,1.71052631578947,1.34210526315789,1.15789473684211,0.184210526315789,53,9,42,86,74,100,-21,0
1922,"Watford",3,42,61,57,54,3,1.45238095238095,1.35714285714286,1.28571428571429,0.0714285714285714,58,14,42,86,85,93,-27,-0.6
1922,"West Bromwich Albion",1,42,62,58,49,9,1.47619047619048,1.38095238095238,1.16666666666667,0.214285714285714,8,8,22,22,16,121,-8,0.3
1922,"West Ham United",2,42,71,63,38,25,1.69047619047619,1.5,0.904761904761905,0.595238095238095,25,3,22,44,13,94,12,-1.6
1922,"Wigan Borough",3,38,62,64,39,25,1.63157894736842,1.68421052631579,1.02631578947368,0.657894736842105,57,13,42,86,66,11,-9,NA
1922,"Wolverhampton Wanderers",2,42,36,42,77,-35,0.857142857142857,1,1.83333333333333,-0.833333333333333,44,22,22,44,46,121,-2,2.5
1922,"Wrexham",3,38,52,38,48,-10,1.36842105263158,1,1.26315789473684,-0.263157894736842,68,24,42,86,79,80,-11,2
1923,"Aberdare Athletic",3,42,50,45,58,-13,1.19047619047619,1.07142857142857,1.38095238095238,-0.30952380952381,72,28,44,88,77,6,-5,NA
1923,"Accrington Stanley",3,42,56,48,61,-13,1.33333333333333,1.14285714285714,1.45238095238095,-0.30952380952381,64,20,44,88,70,34,-6,-1.2
1923,"AFC Bournemouth",3,42,44,40,65,-25,1.04761904761905,0.952380952380952,1.54761904761905,-0.595238095238095,82,38,44,88,82,90,0,-0.4
1923,"Arsenal",1,42,45,40,63,-23,1.07142857142857,0.952380952380952,1.5,-0.547619047619048,19,19,22,22,16,116,3,1.8
1923,"Ashington",3,42,62,59,61,-2,1.47619047619048,1.4047619047619,1.45238095238095,-0.0476190476190476,57,13,44,88,65,8,-8,NA
1923,"Aston Villa",1,42,67,52,37,15,1.5952380952381,1.23809523809524,0.880952380952381,0.357142857142857,6,6,22,22,14,121,-8,-0.8
1923,"Barnsley",2,42,59,57,61,-4,1.4047619047619,1.35714285714286,1.45238095238095,-0.0952380952380952,31,9,22,44,36,111,-5,-1.4
1923,"Barrow",3,42,33,35,80,-45,0.785714285714286,0.833333333333333,1.9047619047619,-1.07142857142857,87,43,44,88,67,44,20,2.8
1923,"Birmingham City",1,42,52,41,49,-8,1.23809523809524,0.976190476190476,1.16666666666667,-0.19047619047619,14,14,22,22,8,117,6,-0.6
1923,"Blackburn Rovers",1,42,62,54,50,4,1.47619047619048,1.28571428571429,1.19047619047619,0.0952380952380952,8,8,22,22,18,121,-10,0.2
1923,"Blackpool",2,42,67,72,47,25,1.5952380952381,1.71428571428571,1.11904761904762,0.595238095238095,26,4,22,44,37,112,-11,-0.8
1923,"Bolton Wanderers",1,42,68,68,34,34,1.61904761904762,1.61904761904762,0.80952380952381,0.80952380952381,5,5,22,22,3,121,2,-2.1
1923,"Bradford City",2,42,48,35,48,-13,1.14285714285714,0.833333333333333,1.14285714285714,-0.30952380952381,39,17,22,44,38,106,1,1.1
1923,"Bradford Park Avenue",3,42,73,69,43,26,1.73809523809524,1.64285714285714,1.02380952380952,0.619047619047619,53,9,44,88,54,51,-1,2.6
1923,"Brentford",3,42,50,54,71,-17,1.19047619047619,1.28571428571429,1.69047619047619,-0.404761904761905,73,29,44,88,86,93,-13,4.8
1923,"Brighton & Hove Albion",3,42,72,68,37,31,1.71428571428571,1.61904761904762,0.880952380952381,0.738095238095238,54,10,44,88,59,93,-5,-0.9
1923,"Bristol City",2,42,36,32,65,-33,0.857142857142857,0.761904761904762,1.54761904761905,-0.785714285714286,44,22,22,44,50,108,-6,-3.8
1923,"Bristol Rovers",3,42,58,52,46,6,1.38095238095238,1.23809523809524,1.0952380952381,0.142857142857143,62,18,44,88,81,92,-19,0.5
1923,"Burnley",1,42,48,55,60,-5,1.14285714285714,1.30952380952381,1.42857142857143,-0.119047619047619,17,17,22,22,19,121,-2,-1.5
1923,"Bury",2,42,72,63,35,28,1.71428571428571,1.5,0.833333333333333,0.666666666666667,24,2,22,44,6,114,18,-0.9
1923,"Cardiff City",1,42,79,61,34,27,1.88095238095238,1.45238095238095,0.80952380952381,0.642857142857143,2,2,22,22,11,93,-9,-8.5
1923,"Charlton Athletic",3,42,48,38,45,-7,1.14285714285714,0.904761904761905,1.07142857142857,-0.166666666666667,77,33,44,88,78,92,-1,2.3
1923,"Chelsea",1,42,41,31,53,-22,0.976190476190476,0.738095238095238,1.26190476190476,-0.523809523809524,21,21,22,22,27,104,-6,0.2
1923,"Chesterfield",3,42,76,70,39,31,1.80952380952381,1.66666666666667,0.928571428571429,0.738095238095238,49,5,44,88,60,100,-11,0.3
1923,"Coventry City",2,42,46,52,68,-16,1.0952380952381,1.23809523809524,1.61904761904762,-0.380952380952381,41,19,22,44,44,94,-3,-1
1923,"Crewe Alexandra",3,42,34,32,58,-26,0.80952380952381,0.761904761904762,1.38095238095238,-0.619047619047619,86,42,44,88,73,96,13,1.3
1923,"Crystal Palace",2,42,52,53,65,-12,1.23809523809524,1.26190476190476,1.54761904761905,-0.285714285714286,37,15,22,44,43,93,-6,-2.9
1923,"Darlington",3,42,68,70,53,17,1.61904761904762,1.66666666666667,1.26190476190476,0.404761904761905,55,11,44,88,45,81,10,-2
1923,"Derby County",2,42,72,75,42,33,1.71428571428571,1.78571428571429,1,0.785714285714286,25,3,22,44,25,121,0,2.1
1923,"Doncaster Rovers",3,42,57,59,53,6,1.35714285714286,1.4047619047619,1.26190476190476,0.142857142857143,63,19,44,88,74,88,-11,1.1
1923,"Durham City",3,42,54,59,60,-1,1.28571428571429,1.4047619047619,1.42857142857143,-0.0238095238095238,69,25,44,88,75,7,-6,NA
1923,"Everton",1,42,67,62,53,9,1.5952380952381,1.47619047619048,1.26190476190476,0.214285714285714,7,7,22,22,17,121,-10,-1
1923,"Exeter City",3,42,52,37,52,-15,1.23809523809524,0.880952380952381,1.23809523809524,-0.357142857142857,71,27,44,88,57,88,14,0.9
1923,"Fulham",2,42,44,45,56,-11,1.04761904761905,1.07142857142857,1.33333333333333,-0.261904761904762,42,20,22,44,32,102,10,0.5
1923,"Gillingham",3,42,49,43,58,-15,1.16666666666667,1.02380952380952,1.38095238095238,-0.357142857142857,75,31,44,88,71,88,4,-0.6
1923,"Grimsby Town",3,42,55,49,47,2,1.30952380952381,1.16666666666667,1.11904761904762,0.0476190476190476,67,23,44,88,69,110,-2,4.4
1923,"Halifax Town",3,42,55,42,59,-17,1.30952380952381,1,1.4047619047619,-0.404761904761905,68,24,44,88,64,69,4,0.8
1923,"Hartlepool United",3,42,32,33,70,-37,0.761904761904762,0.785714285714286,1.66666666666667,-0.880952380952381,88,44,44,88,83,89,5,2.1
1923,"Huddersfield Town",1,42,80,60,33,27,1.9047619047619,1.42857142857143,0.785714285714286,0.642857142857143,1,1,22,22,1,99,0,-0.1
1923,"Hull City",2,42,47,46,51,-5,1.11904761904762,1.0952380952381,1.21428571428571,-0.119047619047619,40,18,22,44,31,104,9,0.2
1923,"Leeds United",2,42,75,61,35,26,1.78571428571429,1.45238095238095,0.833333333333333,0.619047619047619,23,1,22,44,20,93,3,1.4
1923,"Leicester City",2,42,59,64,54,10,1.4047619047619,1.52380952380952,1.28571428571429,0.238095238095238,32,10,22,44,23,115,9,1.6
1923,"Leyton Orient",2,42,57,40,36,4,1.35714285714286,0.952380952380952,0.857142857142857,0.0952380952380952,34,12,22,44,33,102,1,-3
1923,"Lincoln City",3,42,42,48,59,-11,1,1.14285714285714,1.4047619047619,-0.261904761904762,83,39,44,88,61,107,22,3.9
1923,"Liverpool",1,42,56,49,48,1,1.33333333333333,1.16666666666667,1.14285714285714,0.0238095238095238,11,11,22,22,4,116,7,-0.7
1923,"Luton Town",3,42,62,50,44,6,1.47619047619048,1.19047619047619,1.04761904761905,0.142857142857143,58,14,44,88,84,91,-26,0.2
1923,"Manchester City",1,42,57,54,71,-17,1.35714285714286,1.28571428571429,1.69047619047619,-0.404761904761905,10,10,22,22,10,117,0,0.5
1923,"Manchester United",2,42,53,52,44,8,1.26190476190476,1.23809523809524,1.04761904761905,0.19047619047619,36,14,22,44,24,117,12,-0.3
1923,"Merthyr Town",3,42,49,45,65,-20,1.16666666666667,1.07142857142857,1.54761904761905,-0.476190476190476,76,32,44,88,87,10,-11,NA
1923,"Middlesbrough",1,42,29,37,60,-23,0.69047619047619,0.880952380952381,1.42857142857143,-0.547619047619048,22,22,22,22,41,110,-19,0.9
1923,"Millwall",3,42,76,64,38,26,1.80952380952381,1.52380952380952,0.904761904761905,0.619047619047619,50,6,44,88,56,93,-6,0.7
1923,"Nelson",2,42,43,40,74,-34,1.02380952380952,0.952380952380952,1.76190476190476,-0.80952380952381,43,21,22,44,48,10,-5,NA
1923,"New Brighton",3,42,46,40,53,-13,1.0952380952381,0.952380952380952,1.26190476190476,-0.30952380952381,80,36,44,88,49,21,31,0.6
1923,"Newcastle United",1,42,61,60,54,6,1.45238095238095,1.42857142857143,1.28571428571429,0.142857142857143,9,9,22,22,7,116,2,-1.2
1923,"Newport County",3,42,60,56,64,-8,1.42857142857143,1.33333333333333,1.52380952380952,-0.19047619047619,61,17,44,88,55,67,6,-2.6
1923,"Northampton Town",3,42,62,64,47,17,1.47619047619048,1.52380952380952,1.11904761904762,0.404761904761905,59,15,44,88,58,93,1,-0.9
1923,"Norwich City",3,42,56,60,59,1,1.33333333333333,1.42857142857143,1.4047619047619,0.0238095238095238,65,21,44,88,68,93,-3,1.8
1923,"Nottingham Forest",1,42,42,42,64,-22,1,1,1.52380952380952,-0.523809523809524,20,20,22,22,22,117,-2,-2
1923,"Notts County",1,42,56,44,49,-5,1.33333333333333,1.04761904761905,1.16666666666667,-0.119047619047619,12,12,22,22,9,120,3,-2.9
1923,"Oldham Athletic",2,42,59,45,52,-7,1.4047619047619,1.07142857142857,1.23809523809524,-0.166666666666667,33,11,22,44,39,102,-6,0.2
1923,"Plymouth Argyle",3,42,78,70,34,36,1.85714285714286,1.66666666666667,0.80952380952381,0.857142857142857,48,4,44,88,47,93,1,1.3
1923,"Port Vale",2,42,51,50,66,-16,1.21428571428571,1.19047619047619,1.57142857142857,-0.380952380952381,38,16,22,44,29,107,9,0.9
1923,"Portsmouth",3,42,83,87,30,57,1.97619047619048,2.07142857142857,0.714285714285714,1.35714285714286,47,3,44,88,28,93,19,3.7
1923,"Preston North End",1,42,46,52,67,-15,1.0952380952381,1.23809523809524,1.5952380952381,-0.357142857142857,18,18,22,22,21,121,-3,-0.6
1923,"Queens Park Rangers",3,42,42,37,77,-40,1,0.880952380952381,1.83333333333333,-0.952380952380952,84,40,44,88,79,93,5,3.5
1923,"Reading",3,42,48,51,57,-6,1.14285714285714,1.21428571428571,1.35714285714286,-0.142857142857143,78,34,44,88,76,93,2,2.5
1923,"Rochdale",3,42,87,60,26,34,2.07142857142857,1.42857142857143,0.619047619047619,0.80952380952381,45,1,44,88,53,92,-8,-4.3
1923,"Rotherham County",3,42,75,70,43,27,1.78571428571429,1.66666666666667,1.02380952380952,0.642857142857143,51,7,44,88,88,6,-37,NA
1923,"Sheffield United",1,42,69,69,49,20,1.64285714285714,1.64285714285714,1.16666666666667,0.476190476190476,4,4,22,22,15,117,-11,-1.8
1923,"Sheffield Wednesday",2,42,60,54,51,3,1.42857142857143,1.28571428571429,1.21428571428571,0.0714285714285714,29,7,22,44,34,117,-5,1.8
1923,"South Shields",2,42,61,49,50,-1,1.45238095238095,1.16666666666667,1.19047619047619,-0.0238095238095238,28,6,22,44,35,11,-7,NA
1923,"Southampton",2,42,65,52,31,21,1.54761904761905,1.23809523809524,0.738095238095238,0.5,27,5,22,44,30,93,-3,-0.9
1923,"Southend United",3,42,46,53,84,-31,1.0952380952381,1.26190476190476,2,-0.738095238095238,81,37,44,88,62,93,19,0.4
1923,"Southport",3,42,62,44,42,2,1.47619047619048,1.04761904761905,1,0.0476190476190476,60,16,44,88,51,50,9,-2.4
1923,"Stockport County",2,42,55,44,52,-8,1.30952380952381,1.04761904761905,1.23809523809524,-0.19047619047619,35,13,22,44,40,99,-5,-1.3
1923,"Stoke City",2,42,60,44,42,2,1.42857142857143,1.04761904761905,1,0.0476190476190476,30,8,22,44,42,113,-12,1.8
1923,"Sunderland",1,42,75,71,54,17,1.78571428571429,1.69047619047619,1.28571428571429,0.404761904761905,3,3,22,22,5,119,-2,-0.5
1923,"Swansea City",3,42,74,60,48,12,1.76190476190476,1.42857142857143,1.14285714285714,0.285714285714286,52,8,44,88,46,93,6,1
1923,"Swindon Town",3,42,64,58,44,14,1.52380952380952,1.38095238095238,1.04761904761905,0.333333333333333,56,12,44,88,52,93,4,-0.5
1923,"Tottenham Hotspur",1,42,50,50,56,-6,1.19047619047619,1.19047619047619,1.33333333333333,-0.142857142857143,15,15,22,22,12,101,3,1.2
1923,"Tranmere Rovers",3,42,54,51,60,-9,1.28571428571429,1.21428571428571,1.42857142857143,-0.214285714285714,70,26,44,88,85,89,-15,1.2
1923,"Walsall",3,42,50,44,59,-15,1.19047619047619,1.04761904761905,1.4047619047619,-0.357142857142857,74,30,44,88,80,100,-6,2.4
1923,"Watford",3,42,42,45,54,-9,1,1.07142857142857,1.28571428571429,-0.214285714285714,85,41,44,88,63,93,22,1.4
1923,"West Bromwich Albion",1,42,50,51,62,-11,1.19047619047619,1.21428571428571,1.47619047619048,-0.261904761904762,16,16,22,22,2,121,14,0.9
1923,"West Ham United",1,42,54,40,43,-3,1.28571428571429,0.952380952380952,1.02380952380952,-0.0714285714285714,13,13,22,22,13,94,0,-1.7
1923,"Wigan Borough",3,42,56,55,53,2,1.33333333333333,1.30952380952381,1.26190476190476,0.0476190476190476,66,22,44,88,66,11,0,NA
1923,"Wolverhampton Wanderers",3,42,87,76,27,49,2.07142857142857,1.80952380952381,0.642857142857143,1.16666666666667,46,2,44,88,26,121,20,3.1
1923,"Wrexham",3,42,48,37,44,-7,1.14285714285714,0.880952380952381,1.04761904761905,-0.166666666666667,79,35,44,88,72,80,7,2.4
1924,"Aberdare Athletic",3,42,51,54,67,-13,1.21428571428571,1.28571428571429,1.5952380952381,-0.30952380952381,77,33,44,88,64,6,13,NA
1924,"Accrington Stanley",3,42,53,60,72,-12,1.26190476190476,1.42857142857143,1.71428571428571,-0.285714285714286,70,26,44,88,73,34,-3,-1.2
1924,"AFC Bournemouth",3,42,47,40,58,-18,1.11904761904762,0.952380952380952,1.38095238095238,-0.428571428571429,82,38,44,88,60,90,22,0.9
1924,"Arsenal",1,42,47,46,58,-12,1.11904761904762,1.0952380952381,1.38095238095238,-0.285714285714286,16,16,22,22,2,116,14,1.5
1924,"Ashington",3,42,58,68,76,-8,1.38095238095238,1.61904761904762,1.80952380952381,-0.19047619047619,65,21,44,88,65,8,0,NA
1924,"Aston Villa",1,42,52,58,71,-13,1.23809523809524,1.38095238095238,1.69047619047619,-0.30952380952381,14,14,22,22,8,121,6,0.1
1924,"Barnsley",2,42,51,46,59,-13,1.21428571428571,1.0952380952381,1.4047619047619,-0.30952380952381,36,14,22,44,40,111,-4,-0.1
1924,"Barrow",3,42,55,51,74,-23,1.30952380952381,1.21428571428571,1.76190476190476,-0.547619047619048,67,23,44,88,88,44,-21,-1.2
1924,"Birmingham City",1,42,63,49,53,-4,1.5,1.16666666666667,1.26190476190476,-0.0952380952380952,8,8,22,22,11,117,-3,-1.1
1924,"Blackburn Rovers",1,42,46,53,66,-13,1.0952380952381,1.26190476190476,1.57142857142857,-0.30952380952381,18,18,22,22,12,121,6,0.3
1924,"Blackpool",2,42,51,65,61,4,1.21428571428571,1.54761904761905,1.45238095238095,0.0952380952380952,37,15,22,44,30,112,7,1.1
1924,"Bolton Wanderers",1,42,77,76,34,42,1.83333333333333,1.80952380952381,0.80952380952381,1,3,3,22,22,7,121,-4,-2.1
1924,"Bradford City",2,42,51,37,50,-13,1.21428571428571,0.880952380952381,1.19047619047619,-0.30952380952381,38,16,22,44,39,106,-1,-0.4
1924,"Bradford Park Avenue",3,42,69,84,42,42,1.64285714285714,2,1,1,54,10,44,88,46,51,8,1.5
1924,"Brentford",3,42,34,38,91,-53,0.80952380952381,0.904761904761905,2.16666666666667,-1.26190476190476,86,42,44,88,74,93,12,6.3
1924,"Brighton & Hove Albion",3,42,65,59,45,14,1.54761904761905,1.4047619047619,1.07142857142857,0.333333333333333,59,15,44,88,53,93,6,-0.4
1924,"Bristol City",3,42,75,60,41,19,1.78571428571429,1.42857142857143,0.976190476190476,0.452380952380952,50,6,44,88,52,108,-2,-2.1
1924,"Bristol Rovers",3,42,49,42,49,-7,1.16666666666667,1,1.16666666666667,-0.166666666666667,81,37,44,88,80,92,1,2
1924,"Burnley",1,42,45,46,75,-29,1.07142857142857,1.0952380952381,1.78571428571429,-0.69047619047619,19,19,22,22,20,121,-1,-1.4
1924,"Bury",1,42,66,54,51,3,1.57142857142857,1.28571428571429,1.21428571428571,0.0714285714285714,6,6,22,22,4,114,2,-2.5
1924,"Cardiff City",1,42,59,56,51,5,1.4047619047619,1.33333333333333,1.21428571428571,0.119047619047619,11,11,22,22,14,93,-3,-6.9
1924,"Charlton Athletic",3,42,51,46,48,-2,1.21428571428571,1.0952380952381,1.14285714285714,-0.0476190476190476,78,34,44,88,83,92,-5,3.3
1924,"Chelsea",2,42,63,51,37,14,1.5,1.21428571428571,0.880952380952381,0.333333333333333,27,5,22,44,25,104,2,1.6
1924,"Chesterfield",3,42,62,60,44,16,1.47619047619048,1.42857142857143,1.04761904761905,0.380952380952381,60,16,44,88,48,100,12,-0.2
1924,"Coventry City",2,42,42,45,84,-39,1,1.07142857142857,2,-0.928571428571429,44,22,22,44,75,94,-31,-0.7
1924,"Crewe Alexandra",3,42,52,53,78,-25,1.23809523809524,1.26190476190476,1.85714285714286,-0.595238095238095,73,29,44,88,61,96,12,0.1
1924,"Crystal Palace",2,42,46,38,54,-16,1.0952380952381,0.904761904761905,1.28571428571429,-0.380952380952381,43,21,22,44,62,93,-19,-1.3
1924,"Darlington",3,42,82,78,33,45,1.95238095238095,1.85714285714286,0.785714285714286,1.07142857142857,45,1,44,88,37,81,8,-0.7
1924,"Derby County",2,42,77,71,36,35,1.83333333333333,1.69047619047619,0.857142857142857,0.833333333333333,25,3,22,44,24,121,1,1.9
1924,"Doncaster Rovers",3,42,52,54,65,-11,1.23809523809524,1.28571428571429,1.54761904761905,-0.261904761904762,74,30,44,88,66,88,8,2.8
1924,"Durham City",3,42,52,50,68,-18,1.23809523809524,1.19047619047619,1.61904761904762,-0.428571428571429,75,31,44,88,63,7,12,NA
1924,"Everton",1,42,47,40,60,-20,1.11904761904762,0.952380952380952,1.42857142857143,-0.476190476190476,17,17,22,22,15,121,2,0.8
1924,"Exeter City",3,42,66,59,48,11,1.57142857142857,1.4047619047619,1.14285714285714,0.261904761904762,57,13,44,88,81,88,-24,-1.1
1924,"Fulham",2,42,55,41,56,-15,1.30952380952381,0.976190476190476,1.33333333333333,-0.357142857142857,32,10,22,44,41,102,-9,0.2
1924,"Gillingham",3,42,53,35,44,-9,1.26190476190476,0.833333333333333,1.04761904761905,-0.214285714285714,71,27,44,88,67,88,4,-1.2
1924,"Grimsby Town",3,42,54,60,60,0,1.28571428571429,1.42857142857143,1.42857142857143,0,69,25,44,88,45,110,24,6.2
1924,"Halifax Town",3,42,59,56,52,4,1.4047619047619,1.33333333333333,1.23809523809524,0.0952380952380952,64,20,44,88,56,69,8,1.7
1924,"Hartlepool United",3,42,47,45,63,-18,1.11904761904762,1.07142857142857,1.5,-0.428571428571429,83,39,44,88,57,89,26,1.7
1924,"Huddersfield Town",1,42,79,69,28,41,1.88095238095238,1.64285714285714,0.666666666666667,0.976190476190476,1,1,22,22,1,99,0,-1.6
1924,"Hull City",2,42,56,50,49,1,1.33333333333333,1.19047619047619,1.16666666666667,0.0238095238095238,31,9,22,44,35,104,-4,-0.4
1924,"Leeds United",1,42,45,46,59,-13,1.07142857142857,1.0952380952381,1.4047619047619,-0.30952380952381,20,20,22,22,19,93,1,0.2
1924,"Leicester City",2,42,83,90,32,58,1.97619047619048,2.14285714285714,0.761904761904762,1.38095238095238,23,1,22,44,17,115,6,0.3
1924,"Leyton Orient",2,42,54,42,42,0,1.28571428571429,1,1,0,33,11,22,44,42,102,-9,-3.7
1924,"Lincoln City",3,42,62,53,58,-5,1.47619047619048,1.26190476190476,1.38095238095238,-0.119047619047619,61,17,44,88,72,107,-11,1.1
1924,"Liverpool",1,42,70,63,55,8,1.66666666666667,1.5,1.30952380952381,0.19047619047619,4,4,22,22,9,116,-5,-0.1
1924,"Luton Town",3,42,47,49,57,-8,1.11904761904762,1.16666666666667,1.35714285714286,-0.19047619047619,84,40,44,88,58,91,26,3
1924,"Manchester City",1,42,60,76,68,8,1.42857142857143,1.80952380952381,1.61904761904762,0.19047619047619,10,10,22,22,21,117,-11,0.7
1924,"Manchester United",2,42,80,57,23,34,1.9047619047619,1.35714285714286,0.547619047619048,0.80952380952381,24,2,22,44,6,117,18,-0.3
1924,"Merthyr Town",3,42,29,35,77,-42,0.69047619047619,0.833333333333333,1.83333333333333,-1,87,43,44,88,78,10,9,NA
1924,"Middlesbrough",2,42,49,36,44,-8,1.16666666666667,0.857142857142857,1.04761904761905,-0.19047619047619,41,19,22,44,28,110,13,2
1924,"Millwall",3,42,67,58,38,20,1.5952380952381,1.38095238095238,0.904761904761905,0.476190476190476,56,12,44,88,51,93,5,-1.1
1924,"Nelson",3,42,76,79,50,29,1.80952380952381,1.88095238095238,1.19047619047619,0.69047619047619,48,4,44,88,68,10,-20,NA
1924,"New Brighton",3,42,76,75,50,25,1.80952380952381,1.78571428571429,1.19047619047619,0.595238095238095,49,5,44,88,69,21,-20,-2.7
1924,"Newcastle United",1,42,64,61,42,19,1.52380952380952,1.45238095238095,1,0.452380952380952,7,7,22,22,10,116,-3,-2.1
1924,"Newport County",3,42,69,62,42,20,1.64285714285714,1.47619047619048,1,0.476190476190476,55,11,44,88,79,67,-24,-3
1924,"Northampton Town",3,42,66,51,44,7,1.57142857142857,1.21428571428571,1.04761904761905,0.166666666666667,58,14,44,88,70,93,-12,-0.1
1924,"Norwich City",3,42,55,53,51,2,1.30952380952381,1.26190476190476,1.21428571428571,0.0476190476190476,68,24,44,88,76,93,-8,3.2
1924,"Nottingham Forest",1,42,30,29,65,-36,0.714285714285714,0.69047619047619,1.54761904761905,-0.857142857142857,22,22,22,22,38,117,-16,-1
1924,"Notts County",1,42,61,42,31,11,1.45238095238095,1,0.738095238095238,0.261904761904762,9,9,22,22,22,120,-13,-3.5
1924,"Oldham Athletic",2,42,50,35,51,-16,1.19047619047619,0.833333333333333,1.21428571428571,-0.380952380952381,39,17,22,44,31,102,8,-0.4
1924,"Plymouth Argyle",3,42,79,77,38,39,1.88095238095238,1.83333333333333,0.904761904761905,0.928571428571429,47,3,44,88,49,93,-2,1.8
1924,"Port Vale",2,42,59,48,56,-8,1.4047619047619,1.14285714285714,1.33333333333333,-0.19047619047619,29,7,22,44,29,107,0,-1.1
1924,"Portsmouth",2,42,63,58,50,8,1.5,1.38095238095238,1.19047619047619,0.19047619047619,28,6,22,44,33,93,-5,1.4
1924,"Preston North End",1,42,36,37,74,-37,0.857142857142857,0.880952380952381,1.76190476190476,-0.880952380952381,21,21,22,22,34,121,-13,0.9
1924,"Queens Park Rangers",3,42,50,42,63,-21,1.19047619047619,1,1.5,-0.5,79,35,44,88,87,93,-8,1
1924,"Reading",3,42,52,37,38,-1,1.23809523809524,0.880952380952381,0.904761904761905,-0.0238095238095238,76,32,44,88,50,93,26,2.7
1924,"Rochdale",3,42,70,75,53,22,1.66666666666667,1.78571428571429,1.26190476190476,0.523809523809524,53,9,44,88,47,92,6,-3.1
1924,"Rotherham County",3,42,28,42,88,-46,0.666666666666667,1,2.0952380952381,-1.0952380952381,88,44,44,88,NA,6,NA,NA
1924,"Sheffield United",1,42,52,55,63,-8,1.23809523809524,1.30952380952381,1.5,-0.19047619047619,15,15,22,22,5,117,10,-1.9
1924,"Sheffield Wednesday",2,42,53,50,56,-6,1.26190476190476,1.19047619047619,1.33333333333333,-0.142857142857143,34,12,22,44,23,117,11,3
1924,"South Shields",2,42,53,42,38,4,1.26190476190476,1,0.904761904761905,0.0952380952380952,35,13,22,44,32,11,3,NA
1924,"Southampton",2,42,57,40,36,4,1.35714285714286,0.952380952380952,0.857142857142857,0.0952380952380952,30,8,22,44,36,93,-6,-1.1
1924,"Southend United",3,42,62,51,61,-10,1.47619047619048,1.21428571428571,1.45238095238095,-0.238095238095238,62,18,44,88,59,93,3,-2.3
1924,"Southport",3,42,73,59,37,22,1.73809523809524,1.4047619047619,0.880952380952381,0.523809523809524,51,7,44,88,84,50,-33,-3.5
1924,"Stockport County",2,42,50,37,57,-20,1.19047619047619,0.880952380952381,1.35714285714286,-0.476190476190476,40,18,22,44,44,99,-4,-1.5
1924,"Stoke City",2,42,47,34,46,-12,1.11904761904762,0.80952380952381,1.0952380952381,-0.285714285714286,42,20,22,44,43,113,-1,3.2
1924,"Sunderland",1,42,67,64,51,13,1.5952380952381,1.52380952380952,1.21428571428571,0.30952380952381,5,5,22,22,3,119,2,0.3
1924,"Swansea City",3,42,80,68,35,33,1.9047619047619,1.61904761904762,0.833333333333333,0.785714285714286,46,2,44,88,27,93,19,0.8
1924,"Swindon Town",3,42,71,66,38,28,1.69047619047619,1.57142857142857,0.904761904761905,0.666666666666667,52,8,44,88,54,93,-2,-2.2
1924,"Tottenham Hotspur",1,42,57,52,43,9,1.35714285714286,1.23809523809524,1.02380952380952,0.214285714285714,12,12,22,22,16,101,-4,-1
1924,"Tranmere Rovers",3,42,46,59,78,-19,1.0952380952381,1.4047619047619,1.85714285714286,-0.452380952380952,85,41,44,88,55,89,30,3.2
1924,"Walsall",3,42,50,44,53,-9,1.19047619047619,1.04761904761905,1.26190476190476,-0.214285714285714,80,36,44,88,86,100,-6,0.2
1924,"Watford",3,42,60,38,47,-9,1.42857142857143,0.904761904761905,1.11904761904762,-0.214285714285714,63,19,44,88,77,93,-14,0.5
1924,"West Bromwich Albion",1,42,79,58,34,24,1.88095238095238,1.38095238095238,0.80952380952381,0.571428571428571,2,2,22,22,13,121,-11,-0.6
1924,"West Ham United",1,42,57,62,60,2,1.35714285714286,1.47619047619048,1.42857142857143,0.0476190476190476,13,13,22,22,18,94,-5,-1.2
1924,"Wigan Borough",3,42,56,62,65,-3,1.33333333333333,1.47619047619048,1.54761904761905,-0.0714285714285714,66,22,44,88,82,11,-16,NA
1924,"Wolverhampton Wanderers",2,42,66,55,51,4,1.57142857142857,1.30952380952381,1.21428571428571,0.0952380952380952,26,4,22,44,26,121,0,1
1924,"Wrexham",3,42,53,53,61,-8,1.26190476190476,1.26190476190476,1.45238095238095,-0.19047619047619,72,28,44,88,85,80,-13,0.7
1925,"Aberdare Athletic",3,42,59,74,66,8,1.4047619047619,1.76190476190476,1.57142857142857,0.19047619047619,64,20,44,88,87,6,-23,NA
1925,"Accrington Stanley",3,42,54,81,105,-24,1.28571428571429,1.92857142857143,2.5,-0.571428571428571,73,29,44,88,86,34,-13,1.4
1925,"AFC Bournemouth",3,42,60,75,91,-16,1.42857142857143,1.78571428571429,2.16666666666667,-0.380952380952381,60,16,44,88,62,90,-2,0
1925,"Arsenal",1,42,74,87,63,24,1.76190476190476,2.07142857142857,1.5,0.571428571428571,2,2,22,22,11,116,-9,-0.5
1925,"Ashington",3,42,59,70,62,8,1.4047619047619,1.66666666666667,1.47619047619048,0.19047619047619,65,21,44,88,76,8,-11,NA
1925,"Aston Villa",1,42,60,86,76,10,1.42857142857143,2.04761904761905,1.80952380952381,0.238095238095238,8,8,22,22,8,121,0,-1.3
1925,"Barnsley",2,42,48,58,84,-26,1.14285714285714,1.38095238095238,2,-0.619047619047619,40,18,22,44,33,111,7,-0.2
1925,"Barrow",3,42,25,50,98,-48,0.595238095238095,1.19047619047619,2.33333333333333,-1.14285714285714,88,44,44,88,88,44,0,1.2
1925,"Birmingham City",1,42,56,66,81,-15,1.33333333333333,1.57142857142857,1.92857142857143,-0.357142857142857,11,11,22,22,15,117,-4,0
1925,"Blackburn Rovers",1,42,56,91,80,11,1.33333333333333,2.16666666666667,1.9047619047619,0.261904761904762,12,12,22,22,17,121,-5,-1
1925,"Blackpool",2,42,62,76,69,7,1.47619047619048,1.80952380952381,1.64285714285714,0.166666666666667,30,8,22,44,31,112,-1,-0.1
1925,"Bolton Wanderers",1,42,61,75,76,-1,1.45238095238095,1.78571428571429,1.80952380952381,-0.0238095238095238,7,7,22,22,4,121,3,-0.7
1925,"Bradford City",2,42,49,47,66,-19,1.16666666666667,1.11904761904762,1.57142857142857,-0.452380952380952,39,17,22,44,44,106,-5,0.5
1925,"Bradford Park Avenue",3,42,86,101,43,58,2.04761904761905,2.4047619047619,1.02380952380952,1.38095238095238,46,2,44,88,49,51,-3,1
1925,"Brentford",3,42,54,69,94,-25,1.28571428571429,1.64285714285714,2.23809523809524,-0.595238095238095,74,30,44,88,70,93,4,6.9
1925,"Brighton & Hove Albion",3,42,66,84,73,11,1.57142857142857,2,1.73809523809524,0.261904761904762,53,9,44,88,51,93,2,-0.5
1925,"Bristol City",3,42,72,72,51,21,1.71428571428571,1.71428571428571,1.21428571428571,0.5,52,8,44,88,46,108,6,-1.5
1925,"Bristol Rovers",3,42,51,66,69,-3,1.21428571428571,1.57142857142857,1.64285714285714,-0.0714285714285714,80,36,44,88,64,92,16,0.3
1925,"Burnley",1,42,49,85,108,-23,1.16666666666667,2.02380952380952,2.57142857142857,-0.547619047619048,20,20,22,22,5,121,15,-2
1925,"Bury",1,42,67,85,77,8,1.5952380952381,2.02380952380952,1.83333333333333,0.19047619047619,4,4,22,22,19,114,-15,-3.3
1925,"Cardiff City",1,42,55,61,76,-15,1.30952380952381,1.45238095238095,1.80952380952381,-0.357142857142857,14,14,22,22,13,93,1,-6.8
1925,"Charlton Athletic",3,42,46,48,68,-20,1.0952380952381,1.14285714285714,1.61904761904762,-0.476190476190476,83,39,44,88,66,92,17,5.9
1925,"Chelsea",2,42,71,76,49,27,1.69047619047619,1.80952380952381,1.16666666666667,0.642857142857143,25,3,22,44,26,104,-1,1.5
1925,"Chesterfield",3,42,80,100,54,46,1.9047619047619,2.38095238095238,1.28571428571429,1.0952380952381,48,4,44,88,56,100,-8,0.3
1925,"Coventry City",3,42,54,73,82,-9,1.28571428571429,1.73809523809524,1.95238095238095,-0.214285714285714,75,31,44,88,71,94,4,2.9
1925,"Crewe Alexandra",3,42,60,63,61,2,1.42857142857143,1.5,1.45238095238095,0.0476190476190476,61,17,44,88,74,96,-13,0.5
1925,"Crystal Palace",3,42,60,75,79,-4,1.42857142857143,1.78571428571429,1.88095238095238,-0.0952380952380952,62,18,44,88,60,93,2,0.9
1925,"Darlington",2,42,52,72,77,-5,1.23809523809524,1.71428571428571,1.83333333333333,-0.119047619047619,37,15,22,44,43,81,-6,-2.4
1925,"Derby County",2,42,82,77,42,35,1.95238095238095,1.83333333333333,1,0.833333333333333,24,2,22,44,12,121,12,2.1
1925,"Doncaster Rovers",3,42,59,80,72,8,1.4047619047619,1.9047619047619,1.71428571428571,0.19047619047619,66,22,44,88,57,88,9,2.8
1925,"Durham City",3,42,60,63,70,-7,1.42857142857143,1.5,1.66666666666667,-0.166666666666667,63,19,44,88,84,7,-21,NA
1925,"Everton",1,42,54,72,70,2,1.28571428571429,1.71428571428571,1.66666666666667,0.0476190476190476,15,15,22,22,20,121,-5,-0.3
1925,"Exeter City",3,42,50,72,70,2,1.19047619047619,1.71428571428571,1.66666666666667,0.0476190476190476,81,37,44,88,67,88,14,-0.6
1925,"Fulham",2,42,45,46,77,-31,1.07142857142857,1.0952380952381,1.83333333333333,-0.738095238095238,41,19,22,44,39,102,2,0.8
1925,"Gillingham",3,42,59,53,49,4,1.4047619047619,1.26190476190476,1.16666666666667,0.0952380952380952,67,23,44,88,82,88,-15,-1.1
1925,"Grimsby Town",3,42,87,91,40,51,2.07142857142857,2.16666666666667,0.952380952380952,1.21428571428571,45,1,44,88,40,110,5,3.3
1925,"Halifax Town",3,42,62,53,50,3,1.47619047619048,1.26190476190476,1.19047619047619,0.0714285714285714,56,12,44,88,52,69,4,-1.8
1925,"Hartlepool United",3,42,62,82,73,9,1.47619047619048,1.95238095238095,1.73809523809524,0.214285714285714,57,13,44,88,77,89,-20,-0.5
1925,"Huddersfield Town",1,42,80,92,60,32,1.9047619047619,2.19047619047619,1.42857142857143,0.761904761904762,1,1,22,22,3,99,-2,-0.3
1925,"Hull City",2,42,57,63,61,2,1.35714285714286,1.5,1.45238095238095,0.0476190476190476,35,13,22,44,29,104,6,-0.9
1925,"Leeds United",1,42,50,64,76,-12,1.19047619047619,1.52380952380952,1.80952380952381,-0.285714285714286,19,19,22,22,21,93,-2,0.6
1925,"Leicester City",1,42,52,70,80,-10,1.23809523809524,1.66666666666667,1.9047619047619,-0.238095238095238,17,17,22,22,7,115,10,-1.1
1925,"Leyton Orient",2,42,45,50,65,-15,1.07142857142857,1.19047619047619,1.54761904761905,-0.357142857142857,42,20,22,44,42,102,0,-2.8
1925,"Lincoln City",3,42,56,66,82,-16,1.33333333333333,1.57142857142857,1.95238095238095,-0.380952380952381,72,28,44,88,65,107,7,2.1
1925,"Liverpool",1,42,58,70,63,7,1.38095238095238,1.66666666666667,1.5,0.166666666666667,9,9,22,22,9,116,0,-1
1925,"Luton Town",3,42,61,80,75,5,1.45238095238095,1.9047619047619,1.78571428571429,0.119047619047619,58,14,44,88,63,91,-5,1
1925,"Manchester City",1,42,47,89,100,-11,1.11904761904762,2.11904761904762,2.38095238095238,-0.261904761904762,21,21,22,22,25,117,-4,1.3
1925,"Manchester United",1,42,63,66,73,-7,1.5,1.57142857142857,1.73809523809524,-0.166666666666667,6,6,22,22,18,117,-12,-1.7
1925,"Merthyr Town",3,42,53,69,75,-6,1.26190476190476,1.64285714285714,1.78571428571429,-0.142857142857143,78,34,44,88,78,10,0,NA
1925,"Middlesbrough",2,42,65,77,68,9,1.54761904761905,1.83333333333333,1.61904761904762,0.214285714285714,28,6,22,44,23,110,5,1.3
1925,"Millwall",3,42,74,73,39,34,1.76190476190476,1.73809523809524,0.928571428571429,0.80952380952381,51,7,44,88,50,93,1,-2
1925,"Nelson",3,42,59,89,71,18,1.4047619047619,2.11904761904762,1.69047619047619,0.428571428571429,68,24,44,88,53,10,15,NA
1925,"New Brighton",3,42,59,69,67,2,1.4047619047619,1.64285714285714,1.5952380952381,0.0476190476190476,69,25,44,88,59,21,10,-1.9
1925,"Newcastle United",1,42,58,84,75,9,1.38095238095238,2,1.78571428571429,0.214285714285714,10,10,22,22,1,116,9,-2
1925,"Newport County",3,42,52,64,74,-10,1.23809523809524,1.52380952380952,1.76190476190476,-0.238095238095238,79,35,44,88,61,67,18,-0.2
1925,"Northampton Town",3,42,58,82,80,2,1.38095238095238,1.95238095238095,1.9047619047619,0.0476190476190476,70,26,44,88,75,93,-5,-0.3
1925,"Norwich City",3,42,54,58,73,-15,1.28571428571429,1.38095238095238,1.73809523809524,-0.357142857142857,76,32,44,88,80,93,-4,4.4
1925,"Nottingham Forest",2,42,50,51,73,-22,1.19047619047619,1.21428571428571,1.73809523809524,-0.523809523809524,38,16,22,44,28,117,10,-0.3
1925,"Notts County",1,42,46,54,74,-20,1.0952380952381,1.28571428571429,1.76190476190476,-0.476190476190476,22,22,22,22,37,120,-15,-4.1
1925,"Oldham Athletic",2,42,62,74,62,12,1.47619047619048,1.76190476190476,1.47619047619048,0.285714285714286,31,9,22,44,30,102,1,-2.6
1925,"Plymouth Argyle",3,42,80,107,67,40,1.9047619047619,2.54761904761905,1.5952380952381,0.952380952380952,49,5,44,88,47,93,2,2.2
1925,"Port Vale",2,42,63,79,69,10,1.5,1.88095238095238,1.64285714285714,0.238095238095238,29,7,22,44,32,107,-3,-1.4
1925,"Portsmouth",2,42,61,79,74,5,1.45238095238095,1.88095238095238,1.76190476190476,0.119047619047619,33,11,22,44,24,93,9,2.4
1925,"Preston North End",2,42,61,71,84,-13,1.45238095238095,1.69047619047619,2,-0.30952380952381,34,12,22,44,27,121,7,2.8
1925,"Queens Park Rangers",3,42,27,37,84,-47,0.642857142857143,0.880952380952381,2,-1.11904761904762,87,43,44,88,68,93,19,3.5
1925,"Reading",3,42,80,77,52,25,1.9047619047619,1.83333333333333,1.23809523809524,0.595238095238095,50,6,44,88,36,93,14,0.3
1925,"Rochdale",3,42,86,104,58,46,2.04761904761905,2.47619047619048,1.38095238095238,1.0952380952381,47,3,44,88,48,92,-1,-3.7
1925,"Rotherham United",3,42,58,69,92,-23,1.38095238095238,1.64285714285714,2.19047619047619,-0.547619047619048,71,27,44,88,85,88,-14,0.7
1925,"Sheffield United",1,42,65,102,82,20,1.54761904761905,2.42857142857143,1.95238095238095,0.476190476190476,5,5,22,22,10,117,-5,-2.1
1925,"Sheffield Wednesday",2,42,87,88,48,40,2.07142857142857,2.0952380952381,1.14285714285714,0.952380952380952,23,1,22,44,16,117,7,0.3
1925,"South Shields",2,42,62,74,65,9,1.47619047619048,1.76190476190476,1.54761904761905,0.214285714285714,32,10,22,44,41,11,-9,NA
1925,"Southampton",2,42,53,63,63,0,1.26190476190476,1.5,1.5,0,36,14,22,44,35,93,1,-0.3
1925,"Southend United",3,42,61,78,73,5,1.45238095238095,1.85714285714286,1.73809523809524,0.119047619047619,59,15,44,88,79,93,-20,-2.4
1925,"Southport",3,42,43,62,92,-30,1.02380952380952,1.47619047619048,2.19047619047619,-0.714285714285714,84,40,44,88,69,50,15,-0.2
1925,"Stockport County",2,42,33,51,97,-46,0.785714285714286,1.21428571428571,2.30952380952381,-1.0952380952381,44,22,22,44,54,99,-10,-1.1
1925,"Stoke City",2,42,44,54,77,-23,1.04761904761905,1.28571428571429,1.83333333333333,-0.547619047619048,43,21,22,44,45,113,-2,4.1
1925,"Sunderland",1,42,69,96,80,16,1.64285714285714,2.28571428571429,1.9047619047619,0.380952380952381,3,3,22,22,2,119,1,0.2
1925,"Swansea City",2,42,68,77,57,20,1.61904761904762,1.83333333333333,1.35714285714286,0.476190476190476,27,5,22,44,34,93,-7,-0.8
1925,"Swindon Town",3,42,66,69,64,5,1.57142857142857,1.64285714285714,1.52380952380952,0.119047619047619,54,10,44,88,55,93,-1,-2.7
1925,"Tottenham Hotspur",1,42,54,66,79,-13,1.28571428571429,1.57142857142857,1.88095238095238,-0.30952380952381,16,16,22,22,14,101,2,-1.3
1925,"Tranmere Rovers",3,42,63,73,83,-10,1.5,1.73809523809524,1.97619047619048,-0.238095238095238,55,11,44,88,58,89,-3,0.5
1925,"Walsall",3,42,36,58,107,-49,0.857142857142857,1.38095238095238,2.54761904761905,-1.16666666666667,86,42,44,88,72,100,14,2
1925,"Watford",3,42,54,73,89,-16,1.28571428571429,1.73809523809524,2.11904761904762,-0.380952380952381,77,33,44,88,81,93,-4,2.3
1925,"West Bromwich Albion",1,42,56,79,78,1,1.33333333333333,1.88095238095238,1.85714285714286,0.0238095238095238,13,13,22,22,22,121,-9,-0.4
1925,"West Ham United",1,42,52,63,76,-13,1.23809523809524,1.5,1.80952380952381,-0.30952380952381,18,18,22,22,6,94,12,-0.7
1925,"Wigan Borough",3,42,50,68,74,-6,1.19047619047619,1.61904761904762,1.76190476190476,-0.142857142857143,82,38,44,88,83,11,-1,NA
1925,"Wolverhampton Wanderers",2,42,70,84,60,24,1.66666666666667,2,1.42857142857143,0.571428571428571,26,4,22,44,38,121,-12,1
1925,"Wrexham",3,42,43,63,92,-29,1.02380952380952,1.5,2.19047619047619,-0.69047619047619,85,41,44,88,73,80,12,1
1926,"Aberdare Athletic",3,42,34,62,101,-39,0.80952380952381,1.47619047619048,2.4047619047619,-0.928571428571429,87,43,44,88,NA,6,NA,NA
1926,"Accrington Stanley",3,42,37,62,98,-36,0.880952380952381,1.47619047619048,2.33333333333333,-0.857142857142857,86,42,44,88,62,34,24,1.8
1926,"AFC Bournemouth",3,42,62,78,66,12,1.47619047619048,1.85714285714286,1.57142857142857,0.285714285714286,62,18,44,88,74,90,-12,1
1926,"Arsenal",1,42,60,77,86,-9,1.42857142857143,1.83333333333333,2.04761904761905,-0.214285714285714,11,11,22,22,15,116,-4,0.8
1926,"Ashington",3,42,48,60,90,-30,1.14285714285714,1.42857142857143,2.14285714285714,-0.714285714285714,76,32,44,88,81,8,-5,NA
1926,"Aston Villa",1,42,61,81,83,-2,1.45238095238095,1.92857142857143,1.97619047619048,-0.0476190476190476,8,8,22,22,7,121,1,-2.3
1926,"Barnsley",2,42,60,88,87,1,1.42857142857143,2.0952380952381,2.07142857142857,0.0238095238095238,33,11,22,44,35,111,-2,-0.3
1926,"Barrow",3,42,29,34,117,-83,0.69047619047619,0.80952380952381,2.78571428571429,-1.97619047619048,88,44,44,88,83,44,5,1.3
1926,"Birmingham City",1,42,55,64,73,-9,1.30952380952381,1.52380952380952,1.73809523809524,-0.214285714285714,15,15,22,22,16,117,-1,0.1
1926,"Blackburn Rovers",1,42,53,77,96,-19,1.26190476190476,1.83333333333333,2.28571428571429,-0.452380952380952,17,17,22,22,10,121,7,-1.6
1926,"Blackpool",2,42,62,95,80,15,1.47619047619048,2.26190476190476,1.9047619047619,0.357142857142857,31,9,22,44,40,112,-9,0.7
1926,"Bolton Wanderers",1,42,67,84,62,22,1.5952380952381,2,1.47619047619048,0.523809523809524,4,4,22,22,8,121,-4,-1.6
1926,"Bradford City",2,42,30,50,88,-38,0.714285714285714,1.19047619047619,2.0952380952381,-0.904761904761905,44,22,22,44,55,106,-11,0.1
1926,"Bradford Park Avenue",3,42,79,101,59,42,1.88095238095238,2.4047619047619,1.4047619047619,1,49,5,44,88,46,51,3,0.8
1926,"Brentford",3,42,53,70,61,9,1.26190476190476,1.66666666666667,1.45238095238095,0.214285714285714,70,26,44,88,67,93,3,6.3
1926,"Brighton & Hove Albion",3,42,74,79,50,29,1.76190476190476,1.88095238095238,1.19047619047619,0.69047619047619,51,7,44,88,54,93,-3,0.2
1926,"Bristol City",3,42,89,104,54,50,2.11904761904762,2.47619047619048,1.28571428571429,1.19047619047619,46,2,44,88,33,108,13,-2.6
1926,"Bristol Rovers",3,42,57,78,80,-2,1.35714285714286,1.85714285714286,1.9047619047619,-0.0476190476190476,64,20,44,88,77,92,-13,-0.7
1926,"Burnley",1,42,66,91,80,11,1.57142857142857,2.16666666666667,1.9047619047619,0.261904761904762,5,5,22,22,11,121,-6,-2.9
1926,"Bury",1,42,48,68,77,-9,1.14285714285714,1.61904761904762,1.83333333333333,-0.214285714285714,19,19,22,22,4,114,15,-0.6
1926,"Cardiff City",1,42,57,55,65,-10,1.35714285714286,1.30952380952381,1.54761904761905,-0.238095238095238,13,13,22,22,5,93,8,-6.3
1926,"Charlton Athletic",3,42,56,60,61,-1,1.33333333333333,1.42857142857143,1.45238095238095,-0.0238095238095238,66,22,44,88,65,92,1,6.4
1926,"Chelsea",2,42,72,62,52,10,1.71428571428571,1.47619047619048,1.23809523809524,0.238095238095238,26,4,22,44,25,104,1,1.4
1926,"Chesterfield",3,42,68,92,68,24,1.61904761904762,2.19047619047619,1.61904761904762,0.571428571428571,56,12,44,88,76,100,-20,1.9
1926,"Coventry City",3,42,52,71,86,-15,1.23809523809524,1.69047619047619,2.04761904761905,-0.357142857142857,71,27,44,88,82,94,-11,4.1
1926,"Crewe Alexandra",3,42,51,71,81,-10,1.21428571428571,1.69047619047619,1.92857142857143,-0.238095238095238,74,30,44,88,78,96,-4,-1.1
1926,"Crystal Palace",3,42,63,84,81,3,1.5,2,1.92857142857143,0.0714285714285714,60,16,44,88,56,93,4,-1.3
1926,"Darlington",2,42,42,79,98,-19,1,1.88095238095238,2.33333333333333,-0.452380952380952,43,21,22,44,53,81,-10,-4.4
1926,"Derby County",1,42,58,86,73,13,1.38095238095238,2.04761904761905,1.73809523809524,0.30952380952381,12,12,22,22,6,121,6,0.8
1926,"Doncaster Rovers",3,42,65,81,65,16,1.54761904761905,1.92857142857143,1.54761904761905,0.380952380952381,57,13,44,88,50,88,7,1.3
1926,"Durham City",3,42,42,58,105,-47,1,1.38095238095238,2.5,-1.11904761904762,84,40,44,88,84,7,0,NA
1926,"Everton",1,42,46,64,90,-26,1.0952380952381,1.52380952380952,2.14285714285714,-0.619047619047619,20,20,22,22,1,121,19,0.4
1926,"Exeter City",3,42,55,76,73,3,1.30952380952381,1.80952380952381,1.73809523809524,0.0714285714285714,67,23,44,88,60,88,7,-1.9
1926,"Fulham",2,42,47,58,92,-34,1.11904761904762,1.38095238095238,2.19047619047619,-0.80952380952381,39,17,22,44,41,102,-2,0.4
1926,"Gillingham",3,42,43,54,72,-18,1.02380952380952,1.28571428571429,1.71428571428571,-0.428571428571429,82,38,44,88,75,88,7,2
1926,"Grimsby Town",2,42,45,74,91,-17,1.07142857142857,1.76190476190476,2.16666666666667,-0.404761904761905,40,18,22,44,34,110,6,3
1926,"Halifax Town",3,42,74,70,53,17,1.76190476190476,1.66666666666667,1.26190476190476,0.404761904761905,52,8,44,88,70,69,-18,-0.6
1926,"Hartlepool United",3,42,48,66,81,-15,1.14285714285714,1.57142857142857,1.92857142857143,-0.357142857142857,77,33,44,88,71,89,6,2.1
1926,"Huddersfield Town",1,42,68,76,60,16,1.61904761904762,1.80952380952381,1.42857142857143,0.380952380952381,3,3,22,22,2,99,1,-1.4
1926,"Hull City",2,42,67,63,52,11,1.5952380952381,1.5,1.23809523809524,0.261904761904762,29,7,22,44,36,104,-7,-3
1926,"Leeds United",1,42,41,69,88,-19,0.976190476190476,1.64285714285714,2.0952380952381,-0.452380952380952,21,21,22,22,24,93,-3,0.3
1926,"Leicester City",1,42,63,85,70,15,1.5,2.02380952380952,1.66666666666667,0.357142857142857,7,7,22,22,3,115,4,-1.6
1926,"Leyton Orient",2,42,43,60,96,-36,1.02380952380952,1.42857142857143,2.28571428571429,-0.857142857142857,42,20,22,44,43,102,-1,-2.7
1926,"Lincoln City",3,42,57,90,78,12,1.35714285714286,2.14285714285714,1.85714285714286,0.285714285714286,65,21,44,88,47,107,18,1.8
1926,"Liverpool",1,42,61,69,61,8,1.45238095238095,1.64285714285714,1.45238095238095,0.19047619047619,9,9,22,22,20,116,-11,-1
1926,"Luton Town",3,42,59,68,66,2,1.4047619047619,1.61904761904762,1.57142857142857,0.0476190476190476,63,19,44,88,69,91,-6,1.8
1926,"Manchester City",2,42,76,108,61,47,1.80952380952381,2.57142857142857,1.45238095238095,1.11904761904762,25,3,22,44,23,117,2,2.4
1926,"Manchester United",1,42,53,52,64,-12,1.26190476190476,1.23809523809524,1.52380952380952,-0.285714285714286,18,18,22,22,12,117,6,-0.3
1926,"Merthyr Town",3,42,48,63,80,-17,1.14285714285714,1.5,1.9047619047619,-0.404761904761905,78,34,44,88,85,10,-7,NA
1926,"Middlesbrough",2,42,89,122,60,62,2.11904761904762,2.9047619047619,1.42857142857143,1.47619047619048,23,1,22,44,22,110,1,1.7
1926,"Millwall",3,42,79,89,51,38,1.88095238095238,2.11904761904762,1.21428571428571,0.904761904761905,50,6,44,88,45,93,5,-0.7
1926,"Nelson",3,42,73,104,75,29,1.73809523809524,2.47619047619048,1.78571428571429,0.69047619047619,53,9,44,88,88,10,-35,NA
1926,"New Brighton",3,42,64,79,67,12,1.52380952380952,1.88095238095238,1.5952380952381,0.285714285714286,59,15,44,88,68,21,-9,-1.5
1926,"Newcastle United",1,42,81,96,58,38,1.92857142857143,2.28571428571429,1.38095238095238,0.904761904761905,1,1,22,22,9,116,-8,-2.5
1926,"Newport County",3,42,63,57,71,-14,1.5,1.35714285714286,1.69047619047619,-0.333333333333333,61,17,44,88,61,67,0,-1.8
1926,"Northampton Town",3,42,50,59,87,-28,1.19047619047619,1.4047619047619,2.07142857142857,-0.666666666666667,75,31,44,88,48,93,27,2
1926,"Norwich City",3,42,47,59,71,-12,1.11904761904762,1.4047619047619,1.69047619047619,-0.285714285714286,80,36,44,88,79,93,1,4.1
1926,"Nottingham Forest",2,42,68,80,55,25,1.61904761904762,1.9047619047619,1.30952380952381,0.595238095238095,28,6,22,44,32,117,-4,-1.2
1926,"Notts County",2,42,50,70,96,-26,1.19047619047619,1.66666666666667,2.28571428571429,-0.619047619047619,37,15,22,44,37,120,0,-1.1
1926,"Oldham Athletic",2,42,63,74,84,-10,1.5,1.76190476190476,2,-0.238095238095238,30,8,22,44,29,102,1,-2.1
1926,"Plymouth Argyle",3,42,85,95,61,34,2.02380952380952,2.26190476190476,1.45238095238095,0.80952380952381,47,3,44,88,51,93,-4,1.9
1926,"Port Vale",2,42,61,88,78,10,1.45238095238095,2.0952380952381,1.85714285714286,0.238095238095238,32,10,22,44,31,107,1,-3.3
1926,"Portsmouth",2,42,77,87,49,38,1.83333333333333,2.07142857142857,1.16666666666667,0.904761904761905,24,2,22,44,13,93,11,1.5
1926,"Preston North End",2,42,69,74,72,2,1.64285714285714,1.76190476190476,1.71428571428571,0.0476190476190476,27,5,22,44,26,121,1,1.4
1926,"Queens Park Rangers",3,42,54,65,71,-6,1.28571428571429,1.54761904761905,1.69047619047619,-0.142857142857143,68,24,44,88,63,93,5,0.8
1926,"Reading",2,42,56,64,72,-8,1.33333333333333,1.52380952380952,1.71428571428571,-0.19047619047619,36,14,22,44,42,93,-6,-1.7
1926,"Rochdale",3,42,84,105,65,40,2,2.5,1.54761904761905,0.952380952380952,48,4,44,88,66,92,-18,-3.2
1926,"Rotherham United",3,42,42,70,92,-22,1,1.66666666666667,2.19047619047619,-0.523809523809524,85,41,44,88,72,88,13,0.8
1926,"Sheffield United",1,42,61,74,86,-12,1.45238095238095,1.76190476190476,2.04761904761905,-0.285714285714286,10,10,22,22,14,117,-4,-1.9
1926,"Sheffield Wednesday",1,42,54,75,92,-17,1.28571428571429,1.78571428571429,2.19047619047619,-0.404761904761905,16,16,22,22,21,117,-5,-0.6
1926,"South Shields",2,42,44,71,96,-25,1.04761904761905,1.69047619047619,2.28571428571429,-0.595238095238095,41,19,22,44,44,11,-3,NA
1926,"Southampton",2,42,57,60,62,-2,1.35714285714286,1.42857142857143,1.47619047619048,-0.0476190476190476,35,13,22,44,38,93,-3,-0.7
1926,"Southend United",3,42,48,64,77,-13,1.14285714285714,1.52380952380952,1.83333333333333,-0.30952380952381,79,35,44,88,57,93,22,1.5
1926,"Southport",3,42,54,80,85,-5,1.28571428571429,1.9047619047619,2.02380952380952,-0.119047619047619,69,25,44,88,59,50,10,-0.9
1926,"Stockport County",3,42,73,93,69,24,1.73809523809524,2.21428571428571,1.64285714285714,0.571428571428571,54,10,44,88,49,99,5,0.8
1926,"Stoke City",3,42,90,92,40,52,2.14285714285714,2.19047619047619,0.952380952380952,1.23809523809524,45,1,44,88,27,113,18,3.4
1926,"Sunderland",1,42,70,98,70,28,1.66666666666667,2.33333333333333,1.66666666666667,0.666666666666667,2,2,22,22,17,119,-15,-0.6
1926,"Swansea City",2,42,59,68,72,-4,1.4047619047619,1.61904761904762,1.71428571428571,-0.0952380952380952,34,12,22,44,28,93,6,-0.4
1926,"Swindon Town",3,42,72,100,85,15,1.71428571428571,2.38095238095238,2.02380952380952,0.357142857142857,55,11,44,88,58,93,-3,-1.5
1926,"Tottenham Hotspur",1,42,57,76,78,-2,1.35714285714286,1.80952380952381,1.85714285714286,-0.0476190476190476,14,14,22,22,18,101,-4,-1.8
1926,"Tranmere Rovers",3,42,65,85,67,18,1.54761904761905,2.02380952380952,1.5952380952381,0.428571428571429,58,14,44,88,52,89,6,-2.4
1926,"Walsall",3,42,52,68,81,-13,1.23809523809524,1.61904761904762,1.92857142857143,-0.30952380952381,72,28,44,88,80,100,-8,-0.7
1926,"Watford",3,42,44,57,87,-30,1.04761904761905,1.35714285714286,2.07142857142857,-0.714285714285714,81,37,44,88,73,93,8,2.7
1926,"West Bromwich Albion",1,42,41,65,86,-21,0.976190476190476,1.54761904761905,2.04761904761905,-0.5,22,22,22,22,30,121,-8,0.7
1926,"West Ham United",1,42,65,86,70,16,1.54761904761905,2.04761904761905,1.66666666666667,0.380952380952381,6,6,22,22,19,94,-13,-2.1
1926,"Wigan Borough",3,42,43,66,83,-17,1.02380952380952,1.57142857142857,1.97619047619048,-0.404761904761905,83,39,44,88,86,11,-3,NA
1926,"Wolverhampton Wanderers",2,42,49,73,75,-2,1.16666666666667,1.73809523809524,1.78571428571429,-0.0476190476190476,38,16,22,44,39,121,-1,3.3
1926,"Wrexham",3,42,52,65,73,-8,1.23809523809524,1.54761904761905,1.73809523809524,-0.19047619047619,73,29,44,88,64,80,9,0.7
1927,"Accrington Stanley",3,42,62,76,67,9,1.47619047619048,1.80952380952381,1.5952380952381,0.214285714285714,62,18,44,88,80,34,-18,-2.3
1927,"AFC Bournemouth",3,42,51,72,79,-7,1.21428571428571,1.71428571428571,1.88095238095238,-0.166666666666667,74,30,44,88,60,90,14,0.6
1927,"Arsenal",1,42,54,82,86,-4,1.28571428571429,1.95238095238095,2.04761904761905,-0.0952380952380952,15,15,22,22,10,116,5,1.4
1927,"Ashington",3,42,44,77,103,-26,1.04761904761905,1.83333333333333,2.45238095238095,-0.619047619047619,81,37,44,88,88,8,-7,NA
1927,"Aston Villa",1,42,60,78,73,5,1.42857142857143,1.85714285714286,1.73809523809524,0.119047619047619,7,7,22,22,1,121,6,-1.6
1927,"Barnsley",2,42,53,65,85,-20,1.26190476190476,1.54761904761905,2.02380952380952,-0.476190476190476,35,13,22,44,35,111,0,-0.8
1927,"Barrow",3,42,41,54,102,-48,0.976190476190476,1.28571428571429,2.42857142857143,-1.14285714285714,83,39,44,88,85,44,-2,0.1
1927,"Birmingham City",1,42,54,70,75,-5,1.28571428571429,1.66666666666667,1.78571428571429,-0.119047619047619,16,16,22,22,13,117,3,-0.6
1927,"Blackburn Rovers",1,42,57,66,78,-12,1.35714285714286,1.57142857142857,1.85714285714286,-0.285714285714286,10,10,22,22,9,121,1,-2.8
1927,"Blackpool",2,42,47,83,101,-18,1.11904761904762,1.97619047619048,2.4047619047619,-0.428571428571429,40,18,22,44,29,112,11,3
1927,"Bolton Wanderers",1,42,59,81,66,15,1.4047619047619,1.92857142857143,1.57142857142857,0.357142857142857,8,8,22,22,16,121,-8,0.1
1927,"Bradford City",3,42,66,85,60,25,1.57142857142857,2.02380952380952,1.42857142857143,0.595238095238095,55,11,44,88,45,106,10,-1.7
1927,"Bradford Park Avenue",3,42,90,101,45,56,2.14285714285714,2.4047619047619,1.07142857142857,1.33333333333333,46,2,44,88,25,51,21,1.7
1927,"Brentford",3,42,56,76,74,2,1.33333333333333,1.80952380952381,1.76190476190476,0.0476190476190476,67,23,44,88,73,93,-6,6.2
1927,"Brighton & Hove Albion",3,42,67,81,69,12,1.5952380952381,1.92857142857143,1.64285714285714,0.285714285714286,54,10,44,88,70,93,-16,0.2
1927,"Bristol City",2,42,54,76,79,-3,1.28571428571429,1.80952380952381,1.88095238095238,-0.0714285714285714,33,11,22,44,41,108,-8,-1.4
1927,"Bristol Rovers",3,42,46,67,93,-26,1.0952380952381,1.5952380952381,2.21428571428571,-0.619047619047619,77,33,44,88,81,92,-4,0.4
1927,"Burnley",1,42,55,82,98,-16,1.30952380952381,1.95238095238095,2.33333333333333,-0.380952380952381,11,11,22,22,18,121,-7,-1.7
1927,"Bury",1,42,64,80,80,0,1.52380952380952,1.9047619047619,1.9047619047619,0,4,4,22,22,21,114,-17,-2.6
1927,"Cardiff City",1,42,61,70,80,-10,1.45238095238095,1.66666666666667,1.9047619047619,-0.238095238095238,5,5,22,22,22,93,-17,-6
1927,"Charlton Athletic",3,42,58,60,70,-10,1.38095238095238,1.42857142857143,1.66666666666667,-0.238095238095238,65,21,44,88,47,92,18,5.9
1927,"Chelsea",2,42,77,75,45,30,1.83333333333333,1.78571428571429,1.07142857142857,0.714285714285714,25,3,22,44,31,104,-6,1.2
1927,"Chesterfield",3,42,49,71,78,-7,1.16666666666667,1.69047619047619,1.85714285714286,-0.166666666666667,76,32,44,88,64,100,12,4.4
1927,"Coventry City",3,42,42,67,96,-29,1,1.5952380952381,2.28571428571429,-0.69047619047619,82,38,44,88,66,94,16,5.6
1927,"Crewe Alexandra",3,42,46,77,86,-9,1.0952380952381,1.83333333333333,2.04761904761905,-0.214285714285714,78,34,44,88,62,96,16,1.9
1927,"Crystal Palace",3,42,66,79,72,7,1.57142857142857,1.88095238095238,1.71428571428571,0.166666666666667,56,12,44,88,48,93,8,-0.1
1927,"Darlington",3,42,68,89,74,15,1.61904761904762,2.11904761904762,1.76190476190476,0.357142857142857,53,9,44,88,82,81,-29,-3
1927,"Derby County",1,42,61,96,83,13,1.45238095238095,2.28571428571429,1.97619047619048,0.30952380952381,6,6,22,22,5,121,1,-0.8
1927,"Doncaster Rovers",3,42,76,80,44,36,1.80952380952381,1.9047619047619,1.04761904761905,0.857142857142857,50,6,44,88,55,88,-5,0.2
1927,"Durham City",3,42,40,53,100,-47,0.952380952380952,1.26190476190476,2.38095238095238,-1.11904761904762,84,40,44,88,NA,7,NA,NA
1927,"Everton",1,42,73,102,66,36,1.73809523809524,2.42857142857143,1.57142857142857,0.857142857142857,1,1,22,22,14,121,-13,-1.4
1927,"Exeter City",3,42,63,70,60,10,1.5,1.66666666666667,1.42857142857143,0.238095238095238,60,16,44,88,86,88,-26,-1.4
1927,"Fulham",2,42,46,68,89,-21,1.0952380952381,1.61904761904762,2.11904761904762,-0.5,41,19,22,44,49,102,-8,1
1927,"Gillingham",3,42,50,62,81,-19,1.19047619047619,1.47619047619048,1.92857142857143,-0.452380952380952,75,31,44,88,84,88,-9,-1.3
1927,"Grimsby Town",2,42,54,69,83,-14,1.28571428571429,1.64285714285714,1.97619047619048,-0.333333333333333,34,12,22,44,23,110,11,1.7
1927,"Halifax Town",3,42,54,73,71,2,1.28571428571429,1.73809523809524,1.69047619047619,0.0476190476190476,70,26,44,88,74,69,-4,-1
1927,"Hartlepool United",3,42,54,69,81,-12,1.28571428571429,1.64285714285714,1.92857142857143,-0.285714285714286,71,27,44,88,87,89,-16,-1.3
1927,"Huddersfield Town",1,42,73,91,68,23,1.73809523809524,2.16666666666667,1.61904761904762,0.547619047619048,2,2,22,22,19,99,-17,-0.9
1927,"Hull City",2,42,51,41,54,-13,1.21428571428571,0.976190476190476,1.28571428571429,-0.30952380952381,36,14,22,44,38,104,-2,-1.5
1927,"Leeds United",2,42,82,98,49,49,1.95238095238095,2.33333333333333,1.16666666666667,1.16666666666667,24,2,22,44,11,93,13,1.5
1927,"Leicester City",1,42,66,96,72,24,1.57142857142857,2.28571428571429,1.71428571428571,0.571428571428571,3,3,22,22,3,115,0,-1.3
1927,"Leyton Orient",2,42,45,55,85,-30,1.07142857142857,1.30952380952381,2.02380952380952,-0.714285714285714,43,21,22,44,44,102,-1,-3.8
1927,"Lincoln City",3,42,79,91,64,27,1.88095238095238,2.16666666666667,1.52380952380952,0.642857142857143,47,3,44,88,56,107,-9,-1.1
1927,"Liverpool",1,42,52,84,87,-3,1.23809523809524,2,2.07142857142857,-0.0714285714285714,20,20,22,22,6,116,14,0.8
1927,"Luton Town",3,42,55,94,87,7,1.30952380952381,2.23809523809524,2.07142857142857,0.166666666666667,69,25,44,88,58,91,11,3.5
1927,"Manchester City",2,42,84,100,59,41,2,2.38095238095238,1.4047619047619,0.976190476190476,23,1,22,44,7,117,16,0.3
1927,"Manchester United",1,42,55,72,80,-8,1.30952380952381,1.71428571428571,1.9047619047619,-0.19047619047619,12,12,22,22,15,117,-3,-1.2
1927,"Merthyr Town",3,42,40,53,91,-38,0.952380952380952,1.26190476190476,2.16666666666667,-0.904761904761905,85,41,44,88,83,10,2,NA
1927,"Middlesbrough",1,42,48,81,88,-7,1.14285714285714,1.92857142857143,2.0952380952381,-0.166666666666667,22,22,22,22,24,110,-2,1.9
1927,"Millwall",3,42,95,127,50,77,2.26190476190476,3.02380952380952,1.19047619047619,1.83333333333333,45,1,44,88,34,93,11,0
1927,"Nelson",3,42,36,76,136,-60,0.857142857142857,1.80952380952381,3.23809523809524,-1.42857142857143,88,44,44,88,67,10,21,NA
1927,"New Brighton",3,42,56,72,62,10,1.33333333333333,1.71428571428571,1.47619047619048,0.238095238095238,68,24,44,88,71,21,-3,-0.3
1927,"Newcastle United",1,42,58,79,81,-2,1.38095238095238,1.88095238095238,1.92857142857143,-0.0476190476190476,9,9,22,22,8,116,1,-3.2
1927,"Newport County",3,42,63,81,84,-3,1.5,1.92857142857143,2,-0.0714285714285714,61,17,44,88,77,67,-16,1.4
1927,"Northampton Town",3,42,78,102,64,38,1.85714285714286,2.42857142857143,1.52380952380952,0.904761904761905,48,4,44,88,51,93,-3,-1.4
1927,"Norwich City",3,42,46,66,70,-4,1.0952380952381,1.57142857142857,1.66666666666667,-0.0952380952380952,79,35,44,88,78,93,1,4.2
1927,"Nottingham Forest",2,42,55,83,84,-1,1.30952380952381,1.97619047619048,2,-0.0238095238095238,32,10,22,44,33,117,-1,-1
1927,"Notts County",2,42,51,68,74,-6,1.21428571428571,1.61904761904762,1.76190476190476,-0.142857142857143,37,15,22,44,26,120,11,-2.9
1927,"Oldham Athletic",2,42,65,75,51,24,1.54761904761905,1.78571428571429,1.21428571428571,0.571428571428571,29,7,22,44,39,102,-10,-2.6
1927,"Plymouth Argyle",3,42,76,85,54,31,1.80952380952381,2.02380952380952,1.28571428571429,0.738095238095238,51,7,44,88,52,93,-1,1.6
1927,"Port Vale",2,42,62,68,57,11,1.47619047619048,1.61904761904762,1.35714285714286,0.261904761904762,31,9,22,44,42,107,-11,-4.5
1927,"Portsmouth",1,42,55,66,90,-24,1.30952380952381,1.57142857142857,2.14285714285714,-0.571428571428571,13,13,22,22,20,93,-7,-0.5
1927,"Preston North End",2,42,75,100,66,34,1.78571428571429,2.38095238095238,1.57142857142857,0.80952380952381,26,4,22,44,36,121,-10,2.2
1927,"Queens Park Rangers",3,42,60,72,71,1,1.42857142857143,1.71428571428571,1.69047619047619,0.0238095238095238,63,19,44,88,54,93,9,1.4
1927,"Reading",2,42,46,53,75,-22,1.0952380952381,1.26190476190476,1.78571428571429,-0.523809523809524,42,20,22,44,37,93,5,-1.2
1927,"Rochdale",3,42,58,74,77,-3,1.38095238095238,1.76190476190476,1.83333333333333,-0.0714285714285714,66,22,44,88,76,92,-10,-1.1
1927,"Rotherham United",3,42,53,65,69,-4,1.26190476190476,1.54761904761905,1.64285714285714,-0.0952380952380952,72,28,44,88,72,88,0,1.6
1927,"Sheffield United",1,42,55,79,86,-7,1.30952380952381,1.88095238095238,2.04761904761905,-0.166666666666667,14,14,22,22,12,117,2,-1.1
1927,"Sheffield Wednesday",1,42,52,81,78,3,1.23809523809524,1.92857142857143,1.85714285714286,0.0714285714285714,21,21,22,22,2,117,19,-1.8
1927,"South Shields",2,42,30,56,111,-55,0.714285714285714,1.33333333333333,2.64285714285714,-1.30952380952381,44,22,22,44,63,11,-19,NA
1927,"Southampton",2,42,49,68,77,-9,1.16666666666667,1.61904761904762,1.83333333333333,-0.214285714285714,38,16,22,44,27,93,11,0.2
1927,"Southend United",3,42,66,80,64,16,1.57142857142857,1.9047619047619,1.52380952380952,0.380952380952381,57,13,44,88,68,93,-11,-1
1927,"Southport",3,42,65,79,70,9,1.54761904761905,1.88095238095238,1.66666666666667,0.214285714285714,59,15,44,88,69,50,-10,-1.9
1927,"Stockport County",3,42,77,89,51,38,1.83333333333333,2.11904761904762,1.21428571428571,0.904761904761905,49,5,44,88,46,99,3,0.5
1927,"Stoke City",2,42,74,78,59,19,1.76190476190476,1.85714285714286,1.4047619047619,0.452380952380952,27,5,22,44,30,113,-3,0.8
1927,"Sunderland",1,42,54,74,76,-2,1.28571428571429,1.76190476190476,1.80952380952381,-0.0476190476190476,17,17,22,22,4,119,13,0.9
1927,"Swansea City",2,42,66,75,63,12,1.57142857142857,1.78571428571429,1.5,0.285714285714286,28,6,22,44,43,93,-15,-1.2
1927,"Swindon Town",3,42,66,90,69,21,1.57142857142857,2.14285714285714,1.64285714285714,0.5,58,14,44,88,65,93,-7,-0.2
1927,"Torquay United",3,42,38,53,103,-50,0.904761904761905,1.26190476190476,2.45238095238095,-1.19047619047619,87,43,44,88,79,78,8,0
1927,"Tottenham Hotspur",1,42,53,74,86,-12,1.26190476190476,1.76190476190476,2.04761904761905,-0.285714285714286,18,18,22,22,32,101,-14,-0.9
1927,"Tranmere Rovers",3,42,75,105,72,33,1.78571428571429,2.5,1.71428571428571,0.785714285714286,52,8,44,88,57,89,-5,0.6
1927,"Walsall",3,42,45,75,101,-26,1.07142857142857,1.78571428571429,2.4047619047619,-0.619047619047619,80,36,44,88,75,100,5,-0.6
1927,"Watford",3,42,52,68,78,-10,1.23809523809524,1.61904761904762,1.85714285714286,-0.238095238095238,73,29,44,88,59,93,14,2.3
1927,"West Bromwich Albion",2,42,63,90,70,20,1.5,2.14285714285714,1.66666666666667,0.476190476190476,30,8,22,44,28,121,2,0.9
1927,"West Ham United",1,42,53,81,88,-7,1.26190476190476,1.92857142857143,2.0952380952381,-0.166666666666667,19,19,22,22,17,94,2,-1.4
1927,"Wigan Borough",3,42,40,56,97,-41,0.952380952380952,1.33333333333333,2.30952380952381,-0.976190476190476,86,42,44,88,53,11,33,NA
1927,"Wolverhampton Wanderers",2,42,49,63,91,-28,1.16666666666667,1.5,2.16666666666667,-0.666666666666667,39,17,22,44,40,121,-1,3.7
1927,"Wrexham",3,42,60,64,67,-3,1.42857142857143,1.52380952380952,1.5952380952381,-0.0714285714285714,64,20,44,88,50,80,14,0.1
1928,"Accrington Stanley",3,42,47,68,82,-14,1.11904761904762,1.61904761904762,1.95238095238095,-0.333333333333333,80,36,44,88,74,34,6,-0.8
1928,"AFC Bournemouth",3,42,66,84,77,7,1.57142857142857,2,1.83333333333333,0.166666666666667,60,16,44,88,64,90,-4,-1.6
1928,"Arsenal",1,42,61,77,72,5,1.45238095238095,1.83333333333333,1.71428571428571,0.119047619047619,10,10,22,22,16,116,-6,0.5
1928,"Ashington",3,42,31,45,115,-70,0.738095238095238,1.07142857142857,2.73809523809524,-1.66666666666667,88,44,44,88,NA,8,NA,NA
1928,"Aston Villa",1,42,73,98,81,17,1.73809523809524,2.33333333333333,1.92857142857143,0.404761904761905,1,1,22,22,3,121,-2,-1
1928,"Barnsley",2,42,54,69,66,3,1.28571428571429,1.64285714285714,1.57142857142857,0.0714285714285714,35,13,22,44,38,111,-3,-1
1928,"Barrow",3,42,38,64,93,-29,0.904761904761905,1.52380952380952,2.21428571428571,-0.69047619047619,85,41,44,88,86,44,-1,1.8
1928,"Birmingham City",1,42,55,68,77,-9,1.30952380952381,1.61904761904762,1.83333333333333,-0.214285714285714,13,13,22,22,11,117,2,-0.8
1928,"Blackburn Rovers",1,42,62,72,63,9,1.47619047619048,1.71428571428571,1.5,0.214285714285714,9,9,22,22,6,121,3,-1.4
1928,"Blackpool",2,42,64,92,76,16,1.52380952380952,2.19047619047619,1.80952380952381,0.380952380952381,29,7,22,44,23,112,6,1.4
1928,"Bolton Wanderers",1,42,54,73,80,-7,1.28571428571429,1.73809523809524,1.9047619047619,-0.166666666666667,16,16,22,22,14,121,2,0.8
1928,"Bradford City",3,42,90,128,43,85,2.14285714285714,3.04761904761905,1.02380952380952,2.02380952380952,45,1,44,88,41,106,4,-0.3
1928,"Bradford Park Avenue",2,42,70,88,70,18,1.66666666666667,2.0952380952381,1.66666666666667,0.428571428571429,25,3,22,44,27,51,-2,-1.5
1928,"Brentford",3,42,52,56,60,-4,1.23809523809524,1.33333333333333,1.42857142857143,-0.0952380952380952,73,29,44,88,48,93,25,5.7
1928,"Brighton & Hove Albion",3,42,54,58,76,-18,1.28571428571429,1.38095238095238,1.80952380952381,-0.428571428571429,70,26,44,88,52,93,18,1.7
1928,"Bristol City",2,42,49,58,72,-14,1.16666666666667,1.38095238095238,1.71428571428571,-0.333333333333333,41,19,22,44,42,108,-1,-1.9
1928,"Bristol Rovers",3,42,46,60,79,-19,1.0952380952381,1.42857142857143,1.88095238095238,-0.452380952380952,81,37,44,88,82,92,-1,-0.5
1928,"Burnley",1,42,53,81,103,-22,1.26190476190476,1.92857142857143,2.45238095238095,-0.523809523809524,18,18,22,22,21,121,-3,-1.8
1928,"Bury",1,42,43,62,99,-37,1.02380952380952,1.47619047619048,2.35714285714286,-0.880952380952381,21,21,22,22,26,114,-5,-1.7
1928,"Cardiff City",1,42,37,43,59,-16,0.880952380952381,1.02380952380952,1.4047619047619,-0.380952380952381,22,22,22,22,29,93,-7,-4.7
1928,"Carlisle United",3,42,65,86,77,9,1.54761904761905,2.04761904761905,1.83333333333333,0.214285714285714,61,17,44,88,69,84,-8,-1.9
1928,"Charlton Athletic",3,42,77,86,60,26,1.83333333333333,2.04761904761905,1.42857142857143,0.619047619047619,47,3,44,88,35,92,12,4.4
1928,"Chelsea",2,42,61,64,65,-1,1.45238095238095,1.52380952380952,1.54761904761905,-0.0238095238095238,31,9,22,44,24,104,7,1.1
1928,"Chesterfield",3,42,59,71,77,-6,1.4047619047619,1.69047619047619,1.83333333333333,-0.142857142857143,64,20,44,88,49,100,15,3.5
1928,"Coventry City",3,42,56,62,57,5,1.33333333333333,1.47619047619048,1.35714285714286,0.119047619047619,66,22,44,88,54,94,12,4
1928,"Crewe Alexandra",3,42,62,80,68,12,1.47619047619048,1.9047619047619,1.61904761904762,0.285714285714286,62,18,44,88,63,96,-1,0.7
1928,"Crystal Palace",3,42,77,81,67,14,1.83333333333333,1.92857142857143,1.5952380952381,0.333333333333333,48,4,44,88,59,93,-11,-0.1
1928,"Darlington",3,42,46,64,88,-24,1.0952380952381,1.52380952380952,2.0952380952381,-0.571428571428571,82,38,44,88,50,81,32,0.1
1928,"Derby County",1,42,64,86,71,15,1.52380952380952,2.04761904761905,1.69047619047619,0.357142857142857,5,5,22,22,2,121,3,-0.1
1928,"Doncaster Rovers",3,42,70,76,66,10,1.66666666666667,1.80952380952381,1.57142857142857,0.238095238095238,55,11,44,88,71,88,-16,0.9
1928,"Everton",1,42,55,63,75,-12,1.30952380952381,1.5,1.78571428571429,-0.285714285714286,14,14,22,22,22,121,-8,1.3
1928,"Exeter City",3,42,38,67,88,-21,0.904761904761905,1.5952380952381,2.0952380952381,-0.5,86,42,44,88,76,88,10,1.2
1928,"Fulham",3,42,73,101,71,30,1.73809523809524,2.4047619047619,1.69047619047619,0.714285714285714,49,5,44,88,55,102,-6,1.6
1928,"Gillingham",3,42,39,43,83,-40,0.928571428571429,1.02380952380952,1.97619047619048,-0.952380952380952,84,40,44,88,83,88,1,-0.2
1928,"Grimsby Town",2,42,77,82,61,21,1.83333333333333,1.95238095238095,1.45238095238095,0.5,23,1,22,44,18,110,5,1.3
1928,"Halifax Town",3,42,52,63,62,1,1.23809523809524,1.5,1.47619047619048,0.0238095238095238,74,30,44,88,87,69,-13,0.3
1928,"Hartlepool United",3,42,36,59,112,-53,0.857142857142857,1.4047619047619,2.66666666666667,-1.26190476190476,87,43,44,88,60,89,27,0
1928,"Huddersfield Town",1,42,53,70,61,9,1.26190476190476,1.66666666666667,1.45238095238095,0.214285714285714,19,19,22,22,9,99,10,0
1928,"Hull City",2,42,53,58,63,-5,1.26190476190476,1.38095238095238,1.5,-0.119047619047619,38,16,22,44,40,104,-2,-1.6
1928,"Leeds United",1,42,57,71,84,-13,1.35714285714286,1.69047619047619,2,-0.30952380952381,11,11,22,22,4,93,7,-0.1
1928,"Leicester City",1,42,72,96,67,29,1.71428571428571,2.28571428571429,1.5952380952381,0.69047619047619,3,3,22,22,10,115,-7,-1.9
1928,"Leyton Orient",2,42,44,45,72,-27,1.04761904761905,1.07142857142857,1.71428571428571,-0.642857142857143,44,22,22,44,70,102,-26,-3.8
1928,"Lincoln City",3,42,69,91,67,24,1.64285714285714,2.16666666666667,1.5952380952381,0.571428571428571,56,12,44,88,56,107,0,-2.7
1928,"Liverpool",1,42,63,90,64,26,1.5,2.14285714285714,1.52380952380952,0.619047619047619,6,6,22,22,12,116,-6,-0.7
1928,"Luton Town",3,42,68,89,73,16,1.61904761904762,2.11904761904762,1.73809523809524,0.380952380952381,58,14,44,88,72,91,-14,3.1
1928,"Manchester City",1,42,63,95,86,9,1.5,2.26190476190476,2.04761904761905,0.214285714285714,7,7,22,22,5,117,2,-2.1
1928,"Manchester United",1,42,55,66,76,-10,1.30952380952381,1.57142857142857,1.80952380952381,-0.238095238095238,15,15,22,22,17,117,-2,-0.2
1928,"Merthyr Town",3,42,41,55,103,-48,0.976190476190476,1.30952380952381,2.45238095238095,-1.14285714285714,83,39,44,88,88,10,-5,NA
1928,"Middlesbrough",2,42,77,92,57,35,1.83333333333333,2.19047619047619,1.35714285714286,0.833333333333333,24,2,22,44,15,110,9,2
1928,"Millwall",2,42,55,71,86,-15,1.30952380952381,1.69047619047619,2.04761904761905,-0.357142857142857,34,12,22,44,36,93,-2,-0.1
1928,"Nelson",3,42,56,77,90,-13,1.33333333333333,1.83333333333333,2.14285714285714,-0.30952380952381,67,23,44,88,79,10,-12,NA
1928,"New Brighton",3,42,54,64,71,-7,1.28571428571429,1.52380952380952,1.69047619047619,-0.166666666666667,71,27,44,88,68,21,3,-0.1
1928,"Newcastle United",1,42,63,70,72,-2,1.5,1.66666666666667,1.71428571428571,-0.0476190476190476,8,8,22,22,19,116,-11,-2.3
1928,"Newport County",3,42,48,69,86,-17,1.14285714285714,1.64285714285714,2.04761904761905,-0.404761904761905,77,33,44,88,80,67,-3,3.3
1928,"Northampton Town",3,42,72,96,57,39,1.71428571428571,2.28571428571429,1.35714285714286,0.928571428571429,51,7,44,88,53,93,-2,-2.4
1928,"Norwich City",3,42,48,69,81,-12,1.14285714285714,1.64285714285714,1.92857142857143,-0.285714285714286,78,34,44,88,57,93,21,3.6
1928,"Nottingham Forest",2,42,57,71,70,1,1.35714285714286,1.69047619047619,1.66666666666667,0.0238095238095238,33,11,22,44,33,117,0,-1
1928,"Notts County",2,42,66,78,65,13,1.57142857142857,1.85714285714286,1.54761904761905,0.30952380952381,26,4,22,44,44,120,-18,-3.6
1928,"Oldham Athletic",2,42,53,54,75,-21,1.26190476190476,1.28571428571429,1.78571428571429,-0.5,39,17,22,44,25,102,14,-1.1
1928,"Plymouth Argyle",3,42,72,83,51,32,1.71428571428571,1.97619047619048,1.21428571428571,0.761904761904762,52,8,44,88,45,93,7,1.5
1928,"Port Vale",2,42,49,71,86,-15,1.16666666666667,1.69047619047619,2.04761904761905,-0.357142857142857,42,20,22,44,46,107,-4,-3.6
1928,"Portsmouth",1,42,51,56,80,-24,1.21428571428571,1.33333333333333,1.9047619047619,-0.571428571428571,20,20,22,22,13,93,7,0.2
1928,"Preston North End",2,42,54,78,79,-1,1.28571428571429,1.85714285714286,1.88095238095238,-0.0238095238095238,36,14,22,44,39,121,-3,2.7
1928,"Queens Park Rangers",3,42,71,82,61,21,1.69047619047619,1.95238095238095,1.45238095238095,0.5,54,10,44,88,51,93,3,-1
1928,"Reading",2,42,54,63,86,-23,1.28571428571429,1.5,2.04761904761905,-0.547619047619048,37,15,22,44,43,93,-6,-2
1928,"Rochdale",3,42,49,79,96,-17,1.16666666666667,1.88095238095238,2.28571428571429,-0.404761904761905,76,32,44,88,61,92,15,0.3
1928,"Rotherham United",3,42,54,60,77,-17,1.28571428571429,1.42857142857143,1.83333333333333,-0.404761904761905,72,28,44,88,84,88,-12,0.7
1928,"Sheffield United",1,42,56,86,85,1,1.33333333333333,2.04761904761905,2.02380952380952,0.0238095238095238,12,12,22,22,20,117,-8,-1.2
1928,"Sheffield Wednesday",1,42,73,86,62,24,1.73809523809524,2.04761904761905,1.47619047619048,0.571428571428571,2,2,22,22,1,117,1,-2.3
1928,"South Shields",3,42,62,83,74,9,1.47619047619048,1.97619047619048,1.76190476190476,0.214285714285714,63,19,44,88,58,11,5,NA
1928,"Southampton",2,42,65,74,60,14,1.54761904761905,1.76190476190476,1.42857142857143,0.333333333333333,27,5,22,44,30,93,-3,-1.2
1928,"Southend United",3,42,56,80,75,5,1.33333333333333,1.9047619047619,1.78571428571429,0.119047619047619,68,24,44,88,65,93,3,0
1928,"Southport",3,42,56,75,85,-10,1.33333333333333,1.78571428571429,2.02380952380952,-0.238095238095238,69,25,44,88,66,50,3,1.8
1928,"Stockport County",3,42,90,111,58,53,2.14285714285714,2.64285714285714,1.38095238095238,1.26190476190476,46,2,44,88,47,99,-1,-1.7
1928,"Stoke City",2,42,63,74,51,23,1.5,1.76190476190476,1.21428571428571,0.547619047619048,30,8,22,44,32,113,-2,2.3
1928,"Sunderland",1,42,67,93,75,18,1.5952380952381,2.21428571428571,1.78571428571429,0.428571428571429,4,4,22,22,8,119,-4,-1
1928,"Swansea City",2,42,49,62,75,-13,1.16666666666667,1.47619047619048,1.78571428571429,-0.30952380952381,43,21,22,44,37,93,6,0.2
1928,"Swindon Town",3,42,58,75,72,3,1.38095238095238,1.78571428571429,1.71428571428571,0.0714285714285714,65,21,44,88,75,93,-10,0.7
1928,"Torquay United",3,42,48,66,84,-18,1.14285714285714,1.57142857142857,2,-0.428571428571429,79,35,44,88,85,78,-6,0
1928,"Tottenham Hotspur",2,42,60,75,81,-6,1.42857142857143,1.78571428571429,1.92857142857143,-0.142857142857143,32,10,22,44,34,101,-2,0.2
1928,"Tranmere Rovers",3,42,69,79,77,2,1.64285714285714,1.88095238095238,1.83333333333333,0.0476190476190476,57,13,44,88,67,89,-10,1.3
1928,"Walsall",3,42,51,73,79,-6,1.21428571428571,1.73809523809524,1.88095238095238,-0.142857142857143,75,31,44,88,77,100,-2,-0.9
1928,"Watford",3,42,67,79,74,5,1.5952380952381,1.88095238095238,1.76190476190476,0.119047619047619,59,15,44,88,73,93,-14,0.3
1928,"West Bromwich Albion",2,42,65,80,79,1,1.54761904761905,1.9047619047619,1.88095238095238,0.0238095238095238,28,6,22,44,28,121,0,-0.4
1928,"West Ham United",1,42,54,86,96,-10,1.28571428571429,2.04761904761905,2.28571428571429,-0.238095238095238,17,17,22,22,7,94,10,-1.7
1928,"Wigan Borough",3,42,72,82,49,33,1.71428571428571,1.95238095238095,1.16666666666667,0.785714285714286,53,9,44,88,81,11,-28,NA
1928,"Wolverhampton Wanderers",2,42,52,77,81,-4,1.23809523809524,1.83333333333333,1.92857142857143,-0.0952380952380952,40,18,22,44,31,121,9,3.8
1928,"Wrexham",3,42,73,91,69,22,1.73809523809524,2.16666666666667,1.64285714285714,0.523809523809524,50,6,44,88,78,80,-28,-1.6
1929,"Accrington Stanley",3,42,51,84,81,3,1.21428571428571,2,1.92857142857143,0.0714285714285714,74,30,44,88,72,34,2,-0.7
1929,"AFC Bournemouth",3,42,58,72,61,11,1.38095238095238,1.71428571428571,1.45238095238095,0.261904761904762,64,20,44,88,68,90,-4,0.7
1929,"Arsenal",1,42,53,78,66,12,1.26190476190476,1.85714285714286,1.57142857142857,0.285714285714286,16,16,22,22,1,116,15,0.3
1929,"Aston Villa",1,42,68,92,83,9,1.61904761904762,2.19047619047619,1.97619047619048,0.214285714285714,3,3,22,22,2,121,1,-0.5
1929,"Barnsley",2,42,50,56,71,-15,1.19047619047619,1.33333333333333,1.69047619047619,-0.357142857142857,38,16,22,44,41,111,-3,0.6
1929,"Barrow",3,42,38,41,98,-57,0.904761904761905,0.976190476190476,2.33333333333333,-1.35714285714286,86,42,44,88,73,44,13,2.3
1929,"Birmingham City",1,42,57,67,62,5,1.35714285714286,1.5952380952381,1.47619047619048,0.119047619047619,11,11,22,22,19,117,-8,-1.3
1929,"Blackburn Rovers",1,42,64,99,93,6,1.52380952380952,2.35714285714286,2.21428571428571,0.142857142857143,6,6,22,22,9,121,-3,-1.1
1929,"Blackpool",2,42,85,98,67,31,2.02380952380952,2.33333333333333,1.5952380952381,0.738095238095238,23,1,22,44,20,112,3,1.8
1929,"Bolton Wanderers",1,42,54,74,74,0,1.28571428571429,1.76190476190476,1.76190476190476,0,14,14,22,22,14,121,0,-0.4
1929,"Bradford City",2,42,48,60,77,-17,1.14285714285714,1.42857142857143,1.83333333333333,-0.404761904761905,41,19,22,44,32,106,9,-1.1
1929,"Bradford Park Avenue",2,42,69,91,70,21,1.64285714285714,2.16666666666667,1.66666666666667,0.5,27,5,22,44,28,51,-1,-1.1
1929,"Brentford",3,42,89,94,44,50,2.11904761904762,2.23809523809524,1.04761904761905,1.19047619047619,48,4,44,88,52,93,-4,2.7
1929,"Brighton & Hove Albion",3,42,71,87,63,24,1.69047619047619,2.07142857142857,1.5,0.571428571428571,52,8,44,88,56,93,-4,-2.3
1929,"Bristol City",2,42,48,61,83,-22,1.14285714285714,1.45238095238095,1.97619047619048,-0.523809523809524,42,20,22,44,38,108,4,-0.9
1929,"Bristol Rovers",3,42,41,67,93,-26,0.976190476190476,1.5952380952381,2.21428571428571,-0.619047619047619,82,38,44,88,71,92,11,1.6
1929,"Burnley",1,42,50,79,97,-18,1.19047619047619,1.88095238095238,2.30952380952381,-0.428571428571429,21,21,22,22,30,121,-9,-0.4
1929,"Bury",2,42,71,78,67,11,1.69047619047619,1.85714285714286,1.5952380952381,0.261904761904762,26,4,22,44,34,114,-8,-1.4
1929,"Cardiff City",2,42,62,61,59,2,1.47619047619048,1.45238095238095,1.4047619047619,0.0476190476190476,29,7,22,44,44,93,-15,-1.7
1929,"Carlisle United",3,42,55,90,101,-11,1.30952380952381,2.14285714285714,2.4047619047619,-0.261904761904762,69,25,44,88,58,84,11,-0.7
1929,"Charlton Athletic",2,42,53,59,63,-4,1.26190476190476,1.4047619047619,1.5,-0.0952380952380952,35,13,22,44,37,92,-2,1.5
1929,"Chelsea",2,42,77,74,46,28,1.83333333333333,1.76190476190476,1.0952380952381,0.666666666666667,24,2,22,44,13,104,11,0.9
1929,"Chesterfield",3,42,72,76,56,20,1.71428571428571,1.80952380952381,1.33333333333333,0.476190476190476,49,5,44,88,45,100,4,2.3
1929,"Coventry City",3,42,66,88,73,15,1.57142857142857,2.0952380952381,1.73809523809524,0.357142857142857,54,10,44,88,70,94,-16,2.4
1929,"Crewe Alexandra",3,42,59,82,71,11,1.4047619047619,1.95238095238095,1.69047619047619,0.261904761904762,63,19,44,88,80,96,-17,0.3
1929,"Crystal Palace",3,42,63,81,74,7,1.5,1.92857142857143,1.76190476190476,0.166666666666667,59,15,44,88,51,93,8,-2
1929,"Darlington",3,42,72,108,73,35,1.71428571428571,2.57142857142857,1.73809523809524,0.833333333333333,50,6,44,88,69,81,-19,-2.7
1929,"Derby County",1,42,71,90,82,8,1.69047619047619,2.14285714285714,1.95238095238095,0.19047619047619,2,2,22,22,7,121,-5,-0.9
1929,"Doncaster Rovers",3,42,54,62,69,-7,1.28571428571429,1.47619047619048,1.64285714285714,-0.166666666666667,71,27,44,88,77,88,-6,2.6
1929,"Everton",1,42,47,80,92,-12,1.11904761904762,1.9047619047619,2.19047619047619,-0.285714285714286,22,22,22,22,23,121,-1,1.2
1929,"Exeter City",3,42,47,67,73,-6,1.11904761904762,1.5952380952381,1.73809523809524,-0.142857142857143,76,32,44,88,67,88,9,0.4
1929,"Fulham",3,42,65,87,83,4,1.54761904761905,2.07142857142857,1.97619047619048,0.0952380952380952,55,11,44,88,62,102,-7,1.9
1929,"Gillingham",3,42,41,51,80,-29,0.976190476190476,1.21428571428571,1.9047619047619,-0.69047619047619,83,39,44,88,74,88,9,-0.4
1929,"Grimsby Town",1,42,52,73,89,-16,1.23809523809524,1.73809523809524,2.11904761904762,-0.380952380952381,18,18,22,22,12,110,6,0.2
1929,"Halifax Town",3,42,38,44,79,-35,0.904761904761905,1.04761904761905,1.88095238095238,-0.833333333333333,87,43,44,88,81,69,6,-0.1
1929,"Hartlepool United",3,42,62,81,74,7,1.47619047619048,1.92857142857143,1.76190476190476,0.166666666666667,60,16,44,88,84,89,-24,-1.4
1929,"Huddersfield Town",1,42,60,63,69,-6,1.42857142857143,1.5,1.64285714285714,-0.142857142857143,9,9,22,22,5,99,4,-1
1929,"Hull City",2,42,49,51,78,-27,1.16666666666667,1.21428571428571,1.85714285714286,-0.642857142857143,40,18,22,44,54,104,-14,-2.7
1929,"Leeds United",1,42,66,79,63,16,1.57142857142857,1.88095238095238,1.5,0.380952380952381,4,4,22,22,21,93,-17,-1.8
1929,"Leicester City",1,42,60,86,90,-4,1.42857142857143,2.04761904761905,2.14285714285714,-0.0952380952380952,10,10,22,22,15,115,-5,-2.1
1929,"Leyton Orient",3,42,55,55,62,-7,1.30952380952381,1.30952380952381,1.47619047619048,-0.166666666666667,70,26,44,88,78,102,-8,-1.2
1929,"Lincoln City",3,42,65,83,61,22,1.54761904761905,1.97619047619048,1.45238095238095,0.523809523809524,56,12,44,88,47,107,9,-1.2
1929,"Liverpool",1,42,57,63,79,-16,1.35714285714286,1.5,1.88095238095238,-0.380952380952381,12,12,22,22,10,116,2,1.1
1929,"Luton Town",3,42,54,64,78,-14,1.28571428571429,1.52380952380952,1.85714285714286,-0.333333333333333,72,28,44,88,59,91,13,3.8
1929,"Manchester City",1,42,66,91,81,10,1.57142857142857,2.16666666666667,1.92857142857143,0.238095238095238,5,5,22,22,8,117,-3,-1.8
1929,"Manchester United",1,42,53,67,88,-21,1.26190476190476,1.5952380952381,2.0952380952381,-0.5,17,17,22,22,22,117,-5,1.3
1929,"Merthyr Town",3,42,27,60,135,-75,0.642857142857143,1.42857142857143,3.21428571428571,-1.78571428571429,88,44,44,88,NA,10,NA,NA
1929,"Middlesbrough",1,42,54,82,84,-2,1.28571428571429,1.95238095238095,2,-0.0476190476190476,15,15,22,22,6,110,9,0.3
1929,"Millwall",2,42,51,57,73,-16,1.21428571428571,1.35714285714286,1.73809523809524,-0.380952380952381,36,14,22,44,36,93,0,-0.3
1929,"Nelson",3,42,46,51,80,-29,1.0952380952381,1.21428571428571,1.9047619047619,-0.69047619047619,79,35,44,88,88,10,-9,NA
1929,"New Brighton",3,42,56,69,79,-10,1.33333333333333,1.64285714285714,1.88095238095238,-0.238095238095238,68,24,44,88,83,21,-15,-1.2
1929,"Newcastle United",1,42,52,71,92,-21,1.23809523809524,1.69047619047619,2.19047619047619,-0.5,19,19,22,22,17,116,2,-0.9
1929,"Newport County",3,42,46,74,85,-11,1.0952380952381,1.76190476190476,2.02380952380952,-0.261904761904762,80,36,44,88,86,67,-6,1.2
1929,"Northampton Town",3,42,71,82,58,24,1.69047619047619,1.95238095238095,1.38095238095238,0.571428571428571,53,9,44,88,57,93,-4,-1.7
1929,"Norwich City",3,42,64,88,77,11,1.52380952380952,2.0952380952381,1.83333333333333,0.261904761904762,57,13,44,88,87,93,-30,-2.8
1929,"Nottingham Forest",2,42,54,55,69,-14,1.28571428571429,1.30952380952381,1.64285714285714,-0.333333333333333,33,11,22,44,39,117,-6,-0.2
1929,"Notts County",2,42,42,54,70,-16,1,1.28571428571429,1.66666666666667,-0.380952380952381,44,22,22,44,46,120,-2,-2.7
1929,"Oldham Athletic",2,42,74,90,51,39,1.76190476190476,2.14285714285714,1.21428571428571,0.928571428571429,25,3,22,44,35,102,-10,-5.8
1929,"Plymouth Argyle",3,42,98,98,38,60,2.33333333333333,2.33333333333333,0.904761904761905,1.42857142857143,45,1,44,88,40,93,5,0.4
1929,"Port Vale",3,42,97,103,37,66,2.30952380952381,2.45238095238095,0.880952380952381,1.57142857142857,46,2,44,88,26,107,20,-1.5
1929,"Portsmouth",1,42,55,66,62,4,1.30952380952381,1.57142857142857,1.47619047619048,0.0952380952380952,13,13,22,22,4,93,9,-0.1
1929,"Preston North End",2,42,50,65,80,-15,1.19047619047619,1.54761904761905,1.9047619047619,-0.357142857142857,39,17,22,44,31,121,8,3.2
1929,"Queens Park Rangers",3,42,72,80,68,12,1.71428571428571,1.9047619047619,1.61904761904762,0.285714285714286,51,7,44,88,60,93,-9,0.2
1929,"Reading",2,42,47,54,67,-13,1.11904761904762,1.28571428571429,1.5952380952381,-0.30952380952381,43,21,22,44,43,93,0,-1.9
1929,"Rochdale",3,42,61,89,91,-2,1.45238095238095,2.11904761904762,2.16666666666667,-0.0476190476190476,61,17,44,88,85,92,-24,0.7
1929,"Rotherham United",3,42,41,67,113,-46,0.976190476190476,1.5952380952381,2.69047619047619,-1.0952380952381,84,40,44,88,75,88,9,3.7
1929,"Sheffield United",1,42,51,91,96,-5,1.21428571428571,2.16666666666667,2.28571428571429,-0.119047619047619,20,20,22,22,16,117,4,1.4
1929,"Sheffield Wednesday",1,42,86,105,57,48,2.04761904761905,2.5,1.35714285714286,1.14285714285714,1,1,22,22,3,117,-2,-4.1
1929,"South Shields",3,42,64,77,74,3,1.52380952380952,1.83333333333333,1.76190476190476,0.0714285714285714,58,14,44,88,NA,11,NA,NA
1929,"Southampton",2,42,62,77,76,1,1.47619047619048,1.83333333333333,1.80952380952381,0.0238095238095238,30,8,22,44,29,93,1,-0.7
1929,"Southend United",3,42,58,69,59,10,1.38095238095238,1.64285714285714,1.4047619047619,0.238095238095238,65,21,44,88,53,93,12,0.6
1929,"Southport",3,42,58,81,74,7,1.38095238095238,1.92857142857143,1.76190476190476,0.166666666666667,66,22,44,88,49,50,17,-2.1
1929,"Stockport County",3,42,91,106,44,62,2.16666666666667,2.52380952380952,1.04761904761905,1.47619047619048,47,3,44,88,55,99,-8,-0.3
1929,"Stoke City",2,42,56,74,72,2,1.33333333333333,1.76190476190476,1.71428571428571,0.0476190476190476,32,10,22,44,33,113,-1,2.9
1929,"Sunderland",1,42,61,76,80,-4,1.45238095238095,1.80952380952381,1.9047619047619,-0.0952380952380952,8,8,22,22,11,119,-3,-0.1
1929,"Swansea City",2,42,51,57,61,-4,1.21428571428571,1.35714285714286,1.45238095238095,-0.0952380952380952,37,15,22,44,42,93,-5,-0.6
1929,"Swindon Town",3,42,51,73,83,-10,1.21428571428571,1.73809523809524,1.97619047619048,-0.238095238095238,75,31,44,88,64,93,11,2.2
1929,"Torquay United",3,42,41,64,94,-30,0.976190476190476,1.52380952380952,2.23809523809524,-0.714285714285714,85,41,44,88,65,78,20,2
1929,"Tottenham Hotspur",2,42,54,59,61,-2,1.28571428571429,1.4047619047619,1.45238095238095,-0.0476190476190476,34,12,22,44,25,101,9,0.5
1929,"Tranmere Rovers",3,42,57,83,86,-3,1.35714285714286,1.97619047619048,2.04761904761905,-0.0714285714285714,67,23,44,88,48,89,19,0.3
1929,"Walsall",3,42,47,71,78,-7,1.11904761904762,1.69047619047619,1.85714285714286,-0.166666666666667,77,33,44,88,76,100,1,2.2
1929,"Watford",3,42,53,60,73,-13,1.26190476190476,1.42857142857143,1.73809523809524,-0.30952380952381,73,29,44,88,79,93,-6,0.4
1929,"West Bromwich Albion",2,42,68,105,73,32,1.61904761904762,2.5,1.73809523809524,0.761904761904762,28,6,22,44,24,121,4,0.1
1929,"West Ham United",1,42,62,86,79,7,1.47619047619048,2.04761904761905,1.88095238095238,0.166666666666667,7,7,22,22,18,94,-11,-2.6
1929,"Wigan Borough",3,42,46,60,88,-28,1.0952380952381,1.42857142857143,2.0952380952381,-0.666666666666667,81,37,44,88,61,11,20,NA
1929,"Wolverhampton Wanderers",2,42,57,77,79,-2,1.35714285714286,1.83333333333333,1.88095238095238,-0.0476190476190476,31,9,22,44,27,121,4,2.9
1929,"Wrexham",3,42,47,67,88,-21,1.11904761904762,1.5952380952381,2.0952380952381,-0.5,78,34,44,88,50,80,28,2.2
1929,"York City",3,42,61,77,64,13,1.45238095238095,1.83333333333333,1.52380952380952,0.30952380952381,62,18,44,88,66,72,-4,-1.6
1930,"Accrington Stanley",3,42,54,84,108,-24,1.28571428571429,2,2.57142857142857,-0.571428571428571,72,28,44,88,73,34,-1,1.9
1930,"AFC Bournemouth",3,42,58,72,73,-1,1.38095238095238,1.71428571428571,1.73809523809524,-0.0238095238095238,68,24,44,88,74,90,-6,2
1930,"Arsenal",1,42,94,127,59,68,2.23809523809524,3.02380952380952,1.4047619047619,1.61904761904762,1,1,22,22,2,116,-1,0
1930,"Aston Villa",1,42,84,128,78,50,2,3.04761904761905,1.85714285714286,1.19047619047619,2,2,22,22,7,121,-5,-0.4
1930,"Barnsley",2,42,48,59,79,-20,1.14285714285714,1.4047619047619,1.88095238095238,-0.476190476190476,41,19,22,44,43,111,-2,0.8
1930,"Barrow",3,42,52,68,89,-21,1.23809523809524,1.61904761904762,2.11904761904762,-0.5,73,29,44,88,51,44,22,1.5
1930,"Birmingham City",1,42,49,55,70,-15,1.16666666666667,1.30952380952381,1.66666666666667,-0.357142857142857,19,19,22,22,10,117,9,-0.4
1930,"Blackburn Rovers",1,42,59,83,84,-1,1.4047619047619,1.97619047619048,2,-0.0238095238095238,9,9,22,22,15,121,-6,-1.2
1930,"Blackpool",1,42,43,71,125,-54,1.02380952380952,1.69047619047619,2.97619047619048,-1.28571428571429,20,20,22,22,20,112,0,1.1
1930,"Bolton Wanderers",1,42,54,68,81,-13,1.28571428571429,1.61904761904762,1.92857142857143,-0.30952380952381,14,14,22,22,13,121,1,-0.1
1930,"Bradford City",2,42,61,61,63,-2,1.45238095238095,1.45238095238095,1.5,-0.0476190476190476,32,10,22,44,29,106,3,-3.5
1930,"Bradford Park Avenue",2,42,64,97,66,31,1.52380952380952,2.30952380952381,1.57142857142857,0.738095238095238,28,6,22,44,26,51,2,-0.4
1930,"Brentford",3,42,72,90,64,26,1.71428571428571,2.14285714285714,1.52380952380952,0.619047619047619,52,8,44,88,55,93,-3,1.4
1930,"Brighton & Hove Albion",3,42,66,68,53,15,1.57142857142857,1.61904761904762,1.26190476190476,0.357142857142857,56,12,44,88,63,93,-7,-3
1930,"Bristol City",2,42,53,54,82,-28,1.26190476190476,1.28571428571429,1.95238095238095,-0.666666666666667,38,16,22,44,44,108,-6,-2.1
1930,"Bristol Rovers",3,42,56,75,92,-17,1.33333333333333,1.78571428571429,2.19047619047619,-0.404761904761905,71,27,44,88,78,92,-7,-1
1930,"Burnley",2,42,62,81,77,4,1.47619047619048,1.92857142857143,1.83333333333333,0.0952380952380952,30,8,22,44,41,121,-11,2.8
1930,"Bury",2,42,60,75,82,-7,1.42857142857143,1.78571428571429,1.95238095238095,-0.166666666666667,34,12,22,44,27,114,7,-0.8
1930,"Cardiff City",2,42,33,47,87,-40,0.785714285714286,1.11904761904762,2.07142857142857,-0.952380952380952,44,22,22,44,58,93,-14,1.7
1930,"Carlisle United",3,42,65,98,81,17,1.54761904761905,2.33333333333333,1.92857142857143,0.404761904761905,58,14,44,88,82,84,-24,-0.2
1930,"Charlton Athletic",2,42,54,59,86,-27,1.28571428571429,1.4047619047619,2.04761904761905,-0.642857142857143,37,15,22,44,30,92,7,2.5
1930,"Chelsea",1,42,55,64,67,-3,1.30952380952381,1.52380952380952,1.5952380952381,-0.0714285714285714,13,13,22,22,12,104,1,-0.4
1930,"Chesterfield",3,42,84,102,57,45,2,2.42857142857143,1.35714285714286,1.07142857142857,45,1,44,88,39,100,6,1.1
1930,"Coventry City",3,42,57,75,65,10,1.35714285714286,1.78571428571429,1.54761904761905,0.238095238095238,70,26,44,88,65,94,5,3.5
1930,"Crewe Alexandra",3,42,48,66,93,-27,1.14285714285714,1.57142857142857,2.21428571428571,-0.642857142857143,80,36,44,88,52,96,28,1.9
1930,"Crystal Palace",3,42,73,107,71,36,1.73809523809524,2.54761904761905,1.69047619047619,0.857142857142857,51,7,44,88,53,93,-2,-2.2
1930,"Darlington",3,42,58,71,59,12,1.38095238095238,1.69047619047619,1.4047619047619,0.285714285714286,69,25,44,88,67,81,2,-0.5
1930,"Derby County",1,42,64,94,79,15,1.52380952380952,2.23809523809524,1.88095238095238,0.357142857142857,7,7,22,22,17,121,-10,0.3
1930,"Doncaster Rovers",3,42,50,65,65,0,1.19047619047619,1.54761904761905,1.54761904761905,0,77,33,44,88,72,88,5,3.4
1930,"Everton",2,42,89,121,66,55,2.11904761904762,2.88095238095238,1.57142857142857,1.30952380952381,23,1,22,44,1,121,22,1
1930,"Exeter City",3,42,59,84,90,-6,1.4047619047619,2,2.14285714285714,-0.142857142857143,67,23,44,88,56,88,11,0.3
1930,"Fulham",3,42,61,77,75,2,1.45238095238095,1.83333333333333,1.78571428571429,0.0476190476190476,62,18,44,88,47,102,15,2.6
1930,"Gateshead",3,42,61,71,73,-2,1.45238095238095,1.69047619047619,1.73809523809524,-0.0476190476190476,63,19,44,88,46,23,17,1.1
1930,"Gillingham",3,42,52,61,76,-15,1.23809523809524,1.45238095238095,1.80952380952381,-0.357142857142857,74,30,44,88,84,88,-10,-0.9
1930,"Grimsby Town",1,42,56,82,87,-5,1.33333333333333,1.95238095238095,2.07142857142857,-0.119047619047619,12,12,22,22,21,110,-9,-1
1930,"Halifax Town",3,42,48,55,89,-34,1.14285714285714,1.30952380952381,2.11904761904762,-0.80952380952381,81,37,44,88,75,69,6,-0.6
1930,"Hartlepool United",3,42,42,67,86,-19,1,1.5952380952381,2.04761904761905,-0.452380952380952,84,40,44,88,70,89,14,0.6
1930,"Huddersfield Town",1,42,66,81,65,16,1.57142857142857,1.92857142857143,1.54761904761905,0.380952380952381,5,5,22,22,4,99,1,-1.5
1930,"Hull City",3,42,70,99,55,44,1.66666666666667,2.35714285714286,1.30952380952381,1.04761904761905,54,10,44,88,59,104,-5,-0.1
1930,"Leeds United",1,42,43,68,81,-13,1.02380952380952,1.61904761904762,1.92857142857143,-0.30952380952381,21,21,22,22,24,93,-3,-1.8
1930,"Leicester City",1,42,54,80,95,-15,1.28571428571429,1.9047619047619,2.26190476190476,-0.357142857142857,15,15,22,22,18,115,-3,-1.5
1930,"Leyton Orient",3,42,49,63,91,-28,1.16666666666667,1.5,2.16666666666667,-0.666666666666667,78,34,44,88,79,102,-1,-0.1
1930,"Lincoln City",3,42,82,102,59,43,1.95238095238095,2.42857142857143,1.4047619047619,1.02380952380952,47,3,44,88,45,107,2,0.1
1930,"Liverpool",1,42,57,86,85,1,1.35714285714286,2.04761904761905,2.02380952380952,0.0238095238095238,10,10,22,22,9,116,1,0
1930,"Luton Town",3,42,65,76,51,25,1.54761904761905,1.80952380952381,1.21428571428571,0.595238095238095,59,15,44,88,57,91,2,2.2
1930,"Manchester City",1,42,64,75,70,5,1.52380952380952,1.78571428571429,1.66666666666667,0.119047619047619,8,8,22,22,19,117,-11,-0.6
1930,"Manchester United",1,42,29,53,115,-62,0.69047619047619,1.26190476190476,2.73809523809524,-1.47619047619048,22,22,22,22,32,117,-10,1.9
1930,"Middlesbrough",1,42,65,98,90,8,1.54761904761905,2.33333333333333,2.14285714285714,0.19047619047619,6,6,22,22,16,110,-10,-1.2
1930,"Millwall",2,42,55,71,80,-9,1.30952380952381,1.69047619047619,1.9047619047619,-0.214285714285714,36,14,22,44,31,93,5,-0.8
1930,"Nelson",3,42,25,43,113,-70,0.595238095238095,1.02380952380952,2.69047619047619,-1.66666666666667,88,44,44,88,NA,10,NA,NA
1930,"New Brighton",3,42,46,49,76,-27,1.0952380952381,1.16666666666667,1.80952380952381,-0.642857142857143,83,39,44,88,85,21,-2,-0.5
1930,"Newcastle United",1,42,51,78,87,-9,1.21428571428571,1.85714285714286,2.07142857142857,-0.214285714285714,17,17,22,22,11,116,6,-0.7
1930,"Newport County",3,42,39,69,111,-42,0.928571428571429,1.64285714285714,2.64285714285714,-1,86,42,44,88,85,67,1,1.1
1930,"Northampton Town",3,42,66,77,59,18,1.57142857142857,1.83333333333333,1.4047619047619,0.428571428571429,57,13,44,88,69,93,-12,-1.3
1930,"Norwich City",3,42,38,47,76,-29,0.904761904761905,1.11904761904762,1.80952380952381,-0.69047619047619,87,43,44,88,64,93,23,0.5
1930,"Nottingham Forest",2,42,51,80,85,-5,1.21428571428571,1.9047619047619,2.02380952380952,-0.119047619047619,39,17,22,44,34,117,5,-0.1
1930,"Notts County",3,42,83,97,46,51,1.97619047619048,2.30952380952381,1.0952380952381,1.21428571428571,46,2,44,88,38,120,8,-1
1930,"Oldham Athletic",2,42,58,61,72,-11,1.38095238095238,1.45238095238095,1.71428571428571,-0.261904761904762,35,13,22,44,40,102,-5,-3.4
1930,"Plymouth Argyle",2,42,50,76,84,-8,1.19047619047619,1.80952380952381,2,-0.19047619047619,40,18,22,44,28,93,12,-0.1
1930,"Port Vale",2,42,68,67,61,6,1.61904761904762,1.5952380952381,1.45238095238095,0.142857142857143,26,4,22,44,42,107,-16,-3.6
1930,"Portsmouth",1,42,67,84,67,17,1.5952380952381,2,1.5952380952381,0.404761904761905,4,4,22,22,8,93,-4,-0.4
1930,"Preston North End",2,42,62,83,64,19,1.47619047619048,1.97619047619048,1.52380952380952,0.452380952380952,31,9,22,44,35,121,-4,2.6
1930,"Queens Park Rangers",3,42,63,82,75,7,1.5,1.95238095238095,1.78571428571429,0.166666666666667,60,16,44,88,68,93,-8,1.5
1930,"Reading",2,42,42,72,96,-24,1,1.71428571428571,2.28571428571429,-0.571428571428571,43,21,22,44,48,93,-5,-2.2
1930,"Rochdale",3,42,42,62,107,-45,1,1.47619047619048,2.54761904761905,-1.07142857142857,85,41,44,88,87,92,-2,1.9
1930,"Rotherham United",3,42,51,81,83,-2,1.21428571428571,1.92857142857143,1.97619047619048,-0.0476190476190476,75,31,44,88,80,88,-5,2.8
1930,"Sheffield United",1,42,52,78,84,-6,1.23809523809524,1.85714285714286,2,-0.142857142857143,16,16,22,22,5,117,11,0.5
1930,"Sheffield Wednesday",1,42,74,102,75,27,1.76190476190476,2.42857142857143,1.78571428571429,0.642857142857143,3,3,22,22,3,117,0,-2.3
1930,"Southampton",2,42,63,74,62,12,1.5,1.76190476190476,1.47619047619048,0.285714285714286,29,7,22,44,36,93,-7,0.4
1930,"Southend United",3,42,71,76,60,16,1.69047619047619,1.80952380952381,1.42857142857143,0.380952380952381,53,9,44,88,50,93,3,-1
1930,"Southport",3,42,75,88,56,32,1.78571428571429,2.0952380952381,1.33333333333333,0.761904761904762,49,5,44,88,61,50,-12,-2.2
1930,"Stockport County",3,42,69,77,61,16,1.64285714285714,1.83333333333333,1.45238095238095,0.380952380952381,55,11,44,88,76,99,-21,-2.2
1930,"Stoke City",2,42,61,64,71,-7,1.45238095238095,1.52380952380952,1.69047619047619,-0.166666666666667,33,11,22,44,25,113,8,1.7
1930,"Sunderland",1,42,57,89,85,4,1.35714285714286,2.11904761904762,2.02380952380952,0.0952380952380952,11,11,22,22,14,119,-3,-0.8
1930,"Swansea City",2,42,46,51,74,-23,1.0952380952381,1.21428571428571,1.76190476190476,-0.547619047619048,42,20,22,44,37,93,5,-1.2
1930,"Swindon Town",3,42,60,89,94,-5,1.42857142857143,2.11904761904762,2.23809523809524,-0.119047619047619,64,20,44,88,77,93,-13,-1.9
1930,"Thames",3,42,47,54,93,-39,1.11904761904762,1.28571428571429,2.21428571428571,-0.928571428571429,82,38,44,88,86,2,-4,NA
1930,"Torquay United",3,42,60,80,84,-4,1.42857142857143,1.9047619047619,2,-0.0952380952380952,65,21,44,88,81,78,-16,-1.9
1930,"Tottenham Hotspur",2,42,73,88,55,33,1.73809523809524,2.0952380952381,1.30952380952381,0.785714285714286,25,3,22,44,33,101,-8,-0.6
1930,"Tranmere Rovers",3,42,78,111,74,37,1.85714285714286,2.64285714285714,1.76190476190476,0.880952380952381,48,4,44,88,54,89,-6,-2.7
1930,"Walsall",3,42,51,78,95,-17,1.21428571428571,1.85714285714286,2.26190476190476,-0.404761904761905,76,32,44,88,71,100,5,2.6
1930,"Watford",3,42,49,72,75,-3,1.16666666666667,1.71428571428571,1.78571428571429,-0.0714285714285714,79,35,44,88,60,93,19,0.3
1930,"West Bromwich Albion",2,42,76,83,49,34,1.80952380952381,1.97619047619048,1.16666666666667,0.80952380952381,24,2,22,44,6,121,18,-0.4
1930,"West Ham United",1,42,50,79,94,-15,1.19047619047619,1.88095238095238,2.23809523809524,-0.357142857142857,18,18,22,22,22,94,-4,-1.1
1930,"Wigan Borough",3,42,62,76,86,-10,1.47619047619048,1.80952380952381,2.04761904761905,-0.238095238095238,61,17,44,88,88,11,-27,NA
1930,"Wolverhampton Wanderers",2,42,68,84,67,17,1.61904761904762,2,1.5952380952381,0.404761904761905,27,5,22,44,23,121,4,2
1930,"Wrexham",3,42,75,94,62,32,1.78571428571429,2.23809523809524,1.47619047619048,0.761904761904762,50,6,44,88,62,80,-12,-0.1
1930,"York City",3,42,60,85,82,3,1.42857142857143,2.02380952380952,1.95238095238095,0.0714285714285714,66,22,44,88,66,72,0,-0.6
1931,"Accrington Stanley",3,40,51,75,80,-5,1.275,1.875,2,-0.125,73,29,44,88,70,34,3,-0.6
1931,"AFC Bournemouth",3,42,51,70,78,-8,1.21428571428571,1.66666666666667,1.85714285714286,-0.19047619047619,74,30,44,88,78,90,-4,2.5
1931,"Arsenal",1,42,76,90,48,42,1.80952380952381,2.14285714285714,1.14285714285714,1,2,2,22,22,1,116,1,-0.3
1931,"Aston Villa",1,42,65,104,72,32,1.54761904761905,2.47619047619048,1.71428571428571,0.761904761904762,7,7,22,22,2,121,5,-0.1
1931,"Barnsley",2,42,45,55,91,-36,1.07142857142857,1.30952380952381,2.16666666666667,-0.857142857142857,43,21,22,44,55,111,-12,1
1931,"Barrow",3,40,73,86,59,27,1.825,2.15,1.475,0.675,51,7,44,88,62,44,-11,-1.7
1931,"Birmingham City",1,42,62,78,67,11,1.47619047619048,1.85714285714286,1.5952380952381,0.261904761904762,10,10,22,22,13,117,-3,-0.8
1931,"Blackburn Rovers",1,42,54,89,95,-6,1.28571428571429,2.11904761904762,2.26190476190476,-0.142857142857143,15,15,22,22,16,121,-1,-2
1931,"Blackpool",1,42,45,65,102,-37,1.07142857142857,1.54761904761905,2.42857142857143,-0.880952380952381,20,20,22,22,20,112,0,0.3
1931,"Bolton Wanderers",1,42,55,72,80,-8,1.30952380952381,1.71428571428571,1.9047619047619,-0.19047619047619,13,13,22,22,22,121,-9,0
1931,"Bradford City",2,42,61,80,61,19,1.45238095238095,1.9047619047619,1.45238095238095,0.452380952380952,29,7,22,44,35,106,-6,-5.8
1931,"Bradford Park Avenue",2,42,70,72,63,9,1.66666666666667,1.71428571428571,1.5,0.214285714285714,26,4,22,44,29,51,-3,-1.2
1931,"Brentford",3,42,67,68,52,16,1.5952380952381,1.61904761904762,1.23809523809524,0.380952380952381,55,11,44,88,45,93,10,1.3
1931,"Brighton & Hove Albion",3,42,63,73,58,15,1.5,1.73809523809524,1.38095238095238,0.357142857142857,63,19,44,88,65,93,-2,0.9
1931,"Bristol City",2,42,29,39,78,-39,0.69047619047619,0.928571428571429,1.85714285714286,-0.928571428571429,44,22,22,44,76,108,-32,-3.3
1931,"Bristol Rovers",3,42,47,65,92,-27,1.11904761904762,1.54761904761905,2.19047619047619,-0.642857142857143,78,34,44,88,66,92,12,2.6
1931,"Burnley",2,42,48,59,87,-28,1.14285714285714,1.4047619047619,2.07142857142857,-0.666666666666667,41,19,22,44,42,121,-1,2.7
1931,"Bury",2,42,70,70,58,12,1.66666666666667,1.66666666666667,1.38095238095238,0.285714285714286,27,5,22,44,26,114,1,-0.4
1931,"Cardiff City",3,42,65,87,73,14,1.54761904761905,2.07142857142857,1.73809523809524,0.333333333333333,58,14,44,88,83,93,-25,3.2
1931,"Carlisle United",3,41,44,66,82,-16,1.07317073170732,1.60975609756098,2,-0.390243902439024,82,38,44,88,80,84,2,1.1
1931,"Charlton Athletic",2,42,60,61,66,-5,1.42857142857143,1.45238095238095,1.57142857142857,-0.119047619047619,30,8,22,44,44,92,-14,2.1
1931,"Chelsea",1,42,56,69,73,-4,1.33333333333333,1.64285714285714,1.73809523809524,-0.0952380952380952,12,12,22,22,18,104,-6,-0.3
1931,"Chester",3,41,74,82,60,22,1.80487804878049,2,1.46341463414634,0.536585365853659,49,5,44,88,51,67,-2,-3.1
1931,"Chesterfield",2,42,50,64,86,-22,1.19047619047619,1.52380952380952,2.04761904761905,-0.523809523809524,39,17,22,44,43,100,-4,1
1931,"Coventry City",3,42,62,108,97,11,1.47619047619048,2.57142857142857,2.30952380952381,0.261904761904762,65,21,44,88,58,94,7,2.8
1931,"Crewe Alexandra",3,41,72,99,69,30,1.75609756097561,2.41463414634146,1.68292682926829,0.731707317073171,52,8,44,88,59,96,-7,-1.3
1931,"Crystal Palace",3,42,71,74,63,11,1.69047619047619,1.76190476190476,1.5,0.261904761904762,53,9,44,88,56,93,-3,-3.5
1931,"Darlington",3,41,58,71,69,2,1.41463414634146,1.73170731707317,1.68292682926829,0.0487804878048781,67,23,44,88,86,81,-19,1.4
1931,"Derby County",1,42,52,71,75,-4,1.23809523809524,1.69047619047619,1.78571428571429,-0.0952380952380952,17,17,22,22,9,121,8,1.5
1931,"Doncaster Rovers",3,40,52,59,80,-21,1.3,1.475,2,-0.525,72,28,44,88,57,88,15,2.2
1931,"Everton",1,42,82,116,64,52,1.95238095238095,2.76190476190476,1.52380952380952,1.23809523809524,1,1,22,22,11,121,-10,-1.5
1931,"Exeter City",3,42,67,77,62,15,1.5952380952381,1.83333333333333,1.47619047619048,0.357142857142857,56,12,44,88,47,88,9,-1.1
1931,"Fulham",3,42,81,111,62,49,1.92857142857143,2.64285714285714,1.47619047619048,1.16666666666667,47,3,44,88,25,102,22,2.4
1931,"Gateshead",3,41,82,95,50,45,2,2.31707317073171,1.21951219512195,1.09756097560976,46,2,44,88,54,23,-8,-1.5
1931,"Gillingham",3,42,38,40,82,-42,0.904761904761905,0.952380952380952,1.95238095238095,-1,84,40,44,88,60,88,24,2.1
1931,"Grimsby Town",1,42,45,67,98,-31,1.07142857142857,1.5952380952381,2.33333333333333,-0.738095238095238,21,21,22,22,36,110,-15,-1.1
1931,"Halifax Town",3,41,50,62,87,-25,1.21951219512195,1.51219512195122,2.1219512195122,-0.609756097560976,75,31,44,88,72,69,3,-0.3
1931,"Hartlepool United",3,41,54,79,101,-22,1.31707317073171,1.92682926829268,2.46341463414634,-0.536585365853659,70,26,44,88,71,89,-1,-0.4
1931,"Huddersfield Town",1,42,67,80,63,17,1.5952380952381,1.9047619047619,1.5,0.404761904761905,4,4,22,22,6,99,-2,-1.5
1931,"Hull City",3,41,65,83,56,27,1.58536585365854,2.02439024390244,1.36585365853659,0.658536585365854,59,15,44,88,46,104,13,1.4
1931,"Leeds United",2,42,76,78,54,24,1.80952380952381,1.85714285714286,1.28571428571429,0.571428571428571,24,2,22,44,10,93,14,-1.5
1931,"Leicester City",1,42,52,74,94,-20,1.23809523809524,1.76190476190476,2.23809523809524,-0.476190476190476,18,18,22,22,21,115,-3,-2.5
1931,"Leyton Orient",3,42,47,77,90,-13,1.11904761904762,1.83333333333333,2.14285714285714,-0.30952380952381,79,35,44,88,88,102,-9,-0.2
1931,"Lincoln City",3,42,89,112,47,65,2.11904761904762,2.66666666666667,1.11904761904762,1.54761904761905,45,1,44,88,40,107,5,0.1
1931,"Liverpool",1,42,63,81,93,-12,1.5,1.92857142857143,2.21428571428571,-0.285714285714286,9,9,22,22,14,116,-5,-0.3
1931,"Luton Town",3,42,67,95,70,25,1.5952380952381,2.26190476190476,1.66666666666667,0.595238095238095,57,13,44,88,73,91,-16,2.3
1931,"Manchester City",1,42,51,83,73,10,1.21428571428571,1.97619047619048,1.73809523809524,0.238095238095238,19,19,22,22,15,117,4,1.2
1931,"Manchester United",2,42,59,71,72,-1,1.4047619047619,1.69047619047619,1.71428571428571,-0.0238095238095238,32,10,22,44,32,117,0,2.9
1931,"Mansfield Town",3,42,43,75,108,-33,1.02380952380952,1.78571428571429,2.57142857142857,-0.785714285714286,83,39,44,88,77,77,6,1.7
1931,"Middlesbrough",1,42,53,64,89,-25,1.26190476190476,1.52380952380952,2.11904761904762,-0.595238095238095,16,16,22,22,17,110,-1,-0.4
1931,"Millwall",2,42,60,61,61,0,1.42857142857143,1.45238095238095,1.45238095238095,0,31,9,22,44,30,93,1,-2.7
1931,"New Brighton",3,40,32,38,76,-38,0.8,0.95,1.9,-0.95,85,41,44,88,84,21,1,0.9
1931,"Newcastle United",1,42,60,80,87,-7,1.42857142857143,1.9047619047619,2.07142857142857,-0.166666666666667,11,11,22,22,4,116,7,0.7
1931,"Northampton Town",3,42,55,69,69,0,1.30952380952381,1.64285714285714,1.64285714285714,0,69,25,44,88,61,93,8,-1.3
1931,"Norwich City",3,42,63,76,67,9,1.5,1.80952380952381,1.5952380952381,0.214285714285714,64,20,44,88,49,93,15,0.2
1931,"Nottingham Forest",2,42,58,77,72,5,1.38095238095238,1.83333333333333,1.71428571428571,0.119047619047619,34,12,22,44,27,117,7,-0.6
1931,"Notts County",2,42,51,75,75,0,1.21428571428571,1.78571428571429,1.78571428571429,0,38,16,22,44,37,120,1,-2.1
1931,"Oldham Athletic",2,42,49,62,84,-22,1.16666666666667,1.47619047619048,2,-0.523809523809524,40,18,22,44,38,102,2,-1.6
1931,"Plymouth Argyle",2,42,69,100,66,34,1.64285714285714,2.38095238095238,1.57142857142857,0.80952380952381,28,6,22,44,34,93,-6,-1.3
1931,"Port Vale",2,42,46,58,89,-31,1.0952380952381,1.38095238095238,2.11904761904762,-0.738095238095238,42,20,22,44,39,107,3,-3
1931,"Portsmouth",1,42,64,62,62,0,1.52380952380952,1.47619047619048,1.47619047619048,0,8,8,22,22,7,93,1,0.7
1931,"Preston North End",2,42,58,75,77,-2,1.38095238095238,1.78571428571429,1.83333333333333,-0.0476190476190476,35,13,22,44,33,121,2,1.4
1931,"Queens Park Rangers",3,42,57,79,73,6,1.35714285714286,1.88095238095238,1.73809523809524,0.142857142857143,68,24,44,88,74,93,-6,3.2
1931,"Reading",3,42,78,97,67,30,1.85714285714286,2.30952380952381,1.5952380952381,0.714285714285714,48,4,44,88,52,93,-4,0
1931,"Rochdale",3,40,15,48,135,-87,0.375,1.2,3.375,-2.175,87,43,44,88,81,92,6,3
1931,"Rotherham United",3,40,46,63,72,-9,1.15,1.575,1.8,-0.225,80,36,44,88,79,88,1,3.4
1931,"Sheffield United",1,42,66,80,75,5,1.57142857142857,1.9047619047619,1.78571428571429,0.119047619047619,5,5,22,22,8,117,-3,-1.7
1931,"Sheffield Wednesday",1,42,72,96,82,14,1.71428571428571,2.28571428571429,1.95238095238095,0.333333333333333,3,3,22,22,3,117,0,-2.7
1931,"Southampton",2,42,58,66,77,-11,1.38095238095238,1.57142857142857,1.83333333333333,-0.261904761904762,36,14,22,44,31,93,5,1.1
1931,"Southend United",3,42,74,77,53,24,1.76190476190476,1.83333333333333,1.26190476190476,0.571428571428571,50,6,44,88,69,93,-19,-3.5
1931,"Southport",3,40,64,58,53,5,1.6,1.45,1.325,0.125,61,17,44,88,68,50,-7,-2.5
1931,"Stockport County",3,40,50,55,53,2,1.25,1.375,1.325,0.05,76,32,44,88,50,99,26,1.2
1931,"Stoke City",2,42,71,69,48,21,1.69047619047619,1.64285714285714,1.14285714285714,0.5,25,3,22,44,23,113,2,1.5
1931,"Sunderland",1,42,55,67,73,-6,1.30952380952381,1.5952380952381,1.73809523809524,-0.142857142857143,14,14,22,22,12,119,2,0.3
1931,"Swansea City",2,42,55,73,75,-2,1.30952380952381,1.73809523809524,1.78571428571429,-0.0476190476190476,37,15,22,44,28,93,9,-1
1931,"Swindon Town",3,42,48,70,84,-14,1.14285714285714,1.66666666666667,2,-0.333333333333333,77,33,44,88,87,93,-10,2.6
1931,"Thames",3,42,30,53,109,-56,0.714285714285714,1.26190476190476,2.5952380952381,-1.33333333333333,86,42,44,88,NA,2,NA,NA
1931,"Torquay United",3,42,45,72,106,-34,1.07142857142857,1.71428571428571,2.52380952380952,-0.80952380952381,81,37,44,88,63,78,18,2.1
1931,"Tottenham Hotspur",2,42,59,87,78,9,1.4047619047619,2.07142857142857,1.85714285714286,0.214285714285714,33,11,22,44,24,101,9,0.6
1931,"Tranmere Rovers",3,40,68,107,58,49,1.7,2.675,1.45,1.225,54,10,44,88,67,89,-13,-1.5
1931,"Walsall",3,41,54,60,85,-25,1.31707317073171,1.46341463414634,2.07317073170732,-0.609756097560976,71,27,44,88,53,100,18,-0.2
1931,"Watford",3,42,65,81,79,2,1.54761904761905,1.92857142857143,1.88095238095238,0.0476190476190476,60,16,44,88,64,93,-4,-2.3
1931,"West Bromwich Albion",1,42,66,77,55,22,1.57142857142857,1.83333333333333,1.30952380952381,0.523809523809524,6,6,22,22,5,121,1,-1.8
1931,"West Ham United",1,42,43,62,107,-45,1.02380952380952,1.47619047619048,2.54761904761905,-1.07142857142857,22,22,22,22,41,94,-19,-0.6
1931,"Wigan Borough",3,12,10,12,33,-21,0.833333333333333,1,2.75,-1.75,88,44,44,88,NA,11,NA,NA
1931,"Wolverhampton Wanderers",2,42,80,115,49,66,1.9047619047619,2.73809523809524,1.16666666666667,1.57142857142857,23,1,22,44,19,121,4,1.7
1931,"Wrexham",3,41,64,69,69,0,1.5609756097561,1.68292682926829,1.68292682926829,0,62,18,44,88,48,80,14,-0.1
1931,"York City",3,40,61,76,81,-5,1.525,1.9,2.025,-0.125,66,22,44,88,82,72,-16,-0.4
1932,"Accrington Stanley",3,42,55,78,76,2,1.30952380952381,1.85714285714286,1.80952380952381,0.0476190476190476,70,26,44,88,76,34,-6,-0.1
1932,"AFC Bournemouth",3,42,48,60,81,-21,1.14285714285714,1.42857142857143,1.92857142857143,-0.5,78,34,44,88,86,90,-8,1.2
1932,"Aldershot",3,42,49,61,72,-11,1.16666666666667,1.45238095238095,1.71428571428571,-0.261904761904762,75,31,44,88,72,57,3,-0.2
1932,"Arsenal",1,42,83,118,61,57,1.97619047619048,2.80952380952381,1.45238095238095,1.35714285714286,1,1,22,22,1,116,0,-0.4
1932,"Aston Villa",1,42,77,92,67,25,1.83333333333333,2.19047619047619,1.5952380952381,0.595238095238095,2,2,22,22,14,121,-12,-1
1932,"Barnsley",3,42,65,92,80,12,1.54761904761905,2.19047619047619,1.9047619047619,0.285714285714286,55,11,44,88,45,111,10,2
1932,"Barrow",3,42,61,60,60,0,1.45238095238095,1.42857142857143,1.42857142857143,0,62,18,44,88,59,44,3,-1.3
1932,"Birmingham City",1,42,53,57,57,0,1.26190476190476,1.35714285714286,1.35714285714286,0,13,13,22,22,20,117,-7,-0.9
1932,"Blackburn Rovers",1,42,52,76,102,-26,1.23809523809524,1.80952380952381,2.42857142857143,-0.619047619047619,16,16,22,22,6,121,10,-2
1932,"Blackpool",1,42,47,69,85,-16,1.11904761904762,1.64285714285714,2.02380952380952,-0.380952380952381,20,20,22,22,34,112,-14,1.2
1932,"Bolton Wanderers",1,42,45,78,92,-14,1.07142857142857,1.85714285714286,2.19047619047619,-0.333333333333333,22,22,22,22,26,121,-4,0.4
1932,"Bradford City",2,42,55,65,61,4,1.30952380952381,1.54761904761905,1.45238095238095,0.0952380952380952,35,13,22,44,28,106,7,-4.9
1932,"Bradford Park Avenue",2,42,59,77,71,6,1.4047619047619,1.83333333333333,1.69047619047619,0.142857142857143,29,7,22,44,27,51,2,-1.4
1932,"Brentford",3,42,88,90,49,41,2.0952380952381,2.14285714285714,1.16666666666667,0.976190476190476,45,1,44,88,25,93,20,1.4
1932,"Brighton & Hove Albion",3,42,59,66,65,1,1.4047619047619,1.57142857142857,1.54761904761905,0.0238095238095238,65,21,44,88,63,93,2,0.3
1932,"Bristol City",3,42,49,83,90,-7,1.16666666666667,1.97619047619048,2.14285714285714,-0.166666666666667,76,32,44,88,82,108,-6,0.4
1932,"Bristol Rovers",3,42,59,61,56,5,1.4047619047619,1.45238095238095,1.33333333333333,0.119047619047619,66,22,44,88,57,92,9,0.6
1932,"Burnley",2,42,47,67,79,-12,1.11904761904762,1.5952380952381,1.88095238095238,-0.285714285714286,42,20,22,44,32,121,10,3.2
1932,"Bury",2,42,69,84,59,25,1.64285714285714,2,1.4047619047619,0.595238095238095,26,4,22,44,33,114,-7,-1.2
1932,"Cardiff City",3,42,43,69,99,-30,1.02380952380952,1.64285714285714,2.35714285714286,-0.714285714285714,83,39,44,88,87,93,-4,5.1
1932,"Carlisle United",3,42,46,51,75,-24,1.0952380952381,1.21428571428571,1.78571428571429,-0.571428571428571,80,36,44,88,69,84,11,2.1
1932,"Charlton Athletic",2,42,43,60,91,-31,1.02380952380952,1.42857142857143,2.16666666666667,-0.738095238095238,44,22,22,44,54,92,-10,2.8
1932,"Chelsea",1,42,49,63,73,-10,1.16666666666667,1.5,1.73809523809524,-0.238095238095238,18,18,22,22,19,104,-1,0.4
1932,"Chester",3,42,74,94,66,28,1.76190476190476,2.23809523809524,1.57142857142857,0.666666666666667,51,7,44,88,65,67,-14,-1.7
1932,"Chesterfield",2,42,46,61,84,-23,1.0952380952381,1.45238095238095,2,-0.547619047619048,43,21,22,44,46,100,-3,0.9
1932,"Coventry City",3,42,63,106,77,29,1.5,2.52380952380952,1.83333333333333,0.69047619047619,58,14,44,88,51,94,7,2.1
1932,"Crewe Alexandra",3,42,63,80,84,-4,1.5,1.9047619047619,2,-0.0952380952380952,59,15,44,88,73,96,-14,0.2
1932,"Crystal Palace",3,42,65,78,64,14,1.54761904761905,1.85714285714286,1.52380952380952,0.333333333333333,56,12,44,88,66,93,-10,-0.7
1932,"Darlington",3,42,38,66,109,-43,0.904761904761905,1.57142857142857,2.5952380952381,-1.02380952380952,86,42,44,88,75,81,11,0.4
1932,"Derby County",1,42,59,76,69,7,1.4047619047619,1.80952380952381,1.64285714285714,0.166666666666667,9,9,22,22,4,121,5,-0.2
1932,"Doncaster Rovers",3,42,65,77,79,-2,1.54761904761905,1.83333333333333,1.88095238095238,-0.0476190476190476,57,13,44,88,52,88,5,1
1932,"Everton",1,42,57,81,74,7,1.35714285714286,1.92857142857143,1.76190476190476,0.166666666666667,11,11,22,22,17,121,-6,-0.8
1932,"Exeter City",3,42,82,88,48,40,1.95238095238095,2.0952380952381,1.14285714285714,0.952380952380952,47,3,44,88,62,88,-15,-2.6
1932,"Fulham",2,42,70,78,65,13,1.66666666666667,1.85714285714286,1.54761904761905,0.30952380952381,25,3,22,44,37,102,-12,0.5
1932,"Gateshead",3,42,66,78,67,11,1.57142857142857,1.85714285714286,1.5952380952381,0.261904761904762,54,10,44,88,79,23,-25,0.8
1932,"Gillingham",3,42,62,72,61,11,1.47619047619048,1.71428571428571,1.45238095238095,0.261904761904762,60,16,44,88,81,88,-21,0.6
1932,"Grimsby Town",2,42,55,79,84,-5,1.30952380952381,1.88095238095238,2,-0.119047619047619,36,14,22,44,23,110,13,0.3
1932,"Halifax Town",3,42,53,71,90,-19,1.26190476190476,1.69047619047619,2.14285714285714,-0.452380952380952,72,28,44,88,60,69,12,-1.3
1932,"Hartlepool United",3,42,55,87,116,-29,1.30952380952381,2.07142857142857,2.76190476190476,-0.69047619047619,71,27,44,88,67,89,4,-0.7
1932,"Huddersfield Town",1,42,65,66,53,13,1.54761904761905,1.57142857142857,1.26190476190476,0.30952380952381,6,6,22,22,2,99,4,-0.9
1932,"Hull City",3,42,85,100,45,55,2.02380952380952,2.38095238095238,1.07142857142857,1.30952380952381,46,2,44,88,38,104,8,1.7
1932,"Leeds United",1,42,59,59,62,-3,1.4047619047619,1.4047619047619,1.47619047619048,-0.0714285714285714,10,10,22,22,9,93,1,-1.7
1932,"Leicester City",1,42,46,75,89,-14,1.0952380952381,1.78571428571429,2.11904761904762,-0.333333333333333,21,21,22,22,16,115,5,-1.8
1932,"Leyton Orient",3,42,37,59,93,-34,0.880952380952381,1.4047619047619,2.21428571428571,-0.80952380952381,88,44,44,88,64,102,24,0.8
1932,"Lincoln City",2,42,49,72,87,-15,1.16666666666667,1.71428571428571,2.07142857142857,-0.357142857142857,40,18,22,44,44,107,-4,-0.8
1932,"Liverpool",1,42,53,79,84,-5,1.26190476190476,1.88095238095238,2,-0.119047619047619,14,14,22,22,18,116,-4,0.5
1932,"Luton Town",3,42,52,78,78,0,1.23809523809524,1.85714285714286,1.85714285714286,0,73,29,44,88,56,91,17,3.3
1932,"Manchester City",1,42,53,68,71,-3,1.26190476190476,1.61904761904762,1.69047619047619,-0.0714285714285714,15,15,22,22,5,117,10,-0.6
1932,"Manchester United",2,42,58,71,68,3,1.38095238095238,1.69047619047619,1.61904761904762,0.0714285714285714,32,10,22,44,39,117,-7,2.6
1932,"Mansfield Town",3,42,49,84,100,-16,1.16666666666667,2,2.38095238095238,-0.380952380952381,77,33,44,88,80,77,-3,2.1
1932,"Middlesbrough",1,42,51,63,73,-10,1.21428571428571,1.5,1.73809523809524,-0.238095238095238,17,17,22,22,13,110,4,1
1932,"Millwall",2,42,59,59,57,2,1.4047619047619,1.4047619047619,1.35714285714286,0.0476190476190476,30,8,22,44,43,93,-13,-5.3
1932,"New Brighton",3,42,43,63,88,-25,1.02380952380952,1.5,2.0952380952381,-0.595238095238095,84,40,44,88,74,21,10,1
1932,"Newcastle United",1,42,71,71,63,8,1.69047619047619,1.69047619047619,1.5,0.19047619047619,4,4,22,22,21,116,-17,0
1932,"Newport County",3,42,40,61,105,-44,0.952380952380952,1.45238095238095,2.5,-1.04761904761905,85,41,44,88,83,67,2,0.4
1932,"Northampton Town",3,42,62,76,66,10,1.47619047619048,1.80952380952381,1.57142857142857,0.238095238095238,61,17,44,88,68,93,-7,1.1
1932,"Norwich City",3,42,79,88,55,33,1.88095238095238,2.0952380952381,1.30952380952381,0.785714285714286,49,5,44,88,47,93,2,-1.8
1932,"Nottingham Forest",2,42,66,67,59,8,1.57142857142857,1.5952380952381,1.4047619047619,0.19047619047619,27,5,22,44,40,117,-13,-2.5
1932,"Notts County",2,42,55,67,78,-11,1.30952380952381,1.5952380952381,1.85714285714286,-0.261904761904762,37,15,22,44,41,120,-4,-0.8
1932,"Oldham Athletic",2,42,53,67,80,-13,1.26190476190476,1.5952380952381,1.9047619047619,-0.30952380952381,38,16,22,44,31,102,7,-2.6
1932,"Plymouth Argyle",2,42,57,63,67,-4,1.35714285714286,1.5,1.5952380952381,-0.0952380952380952,34,12,22,44,35,93,-1,-1
1932,"Port Vale",2,42,52,66,79,-13,1.23809523809524,1.57142857142857,1.88095238095238,-0.30952380952381,39,17,22,44,29,107,10,-3
1932,"Portsmouth",1,42,61,74,76,-2,1.45238095238095,1.76190476190476,1.80952380952381,-0.0476190476190476,7,7,22,22,10,93,-3,0.6
1932,"Preston North End",2,42,58,74,70,4,1.38095238095238,1.76190476190476,1.66666666666667,0.0952380952380952,33,11,22,44,24,121,9,0.5
1932,"Queens Park Rangers",3,42,50,72,87,-15,1.19047619047619,1.71428571428571,2.07142857142857,-0.357142857142857,74,30,44,88,49,93,25,3.2
1932,"Reading",3,42,70,103,71,32,1.66666666666667,2.45238095238095,1.69047619047619,0.761904761904762,52,8,44,88,53,93,-1,-1.3
1932,"Rochdale",3,42,46,58,80,-22,1.0952380952381,1.38095238095238,1.9047619047619,-0.523809523809524,81,37,44,88,88,92,-7,3.2
1932,"Rotherham United",3,42,48,60,84,-24,1.14285714285714,1.42857142857143,2,-0.571428571428571,79,35,44,88,85,88,-6,2.5
1932,"Sheffield United",1,42,60,74,80,-6,1.42857142857143,1.76190476190476,1.9047619047619,-0.142857142857143,8,8,22,22,22,117,-14,-1.6
1932,"Sheffield Wednesday",1,42,72,80,68,12,1.71428571428571,1.9047619047619,1.61904761904762,0.285714285714286,3,3,22,22,11,117,-8,-2.3
1932,"Southampton",2,42,59,66,66,0,1.4047619047619,1.57142857142857,1.57142857142857,0,31,9,22,44,36,93,-5,0.6
1932,"Southend United",3,42,56,65,82,-17,1.33333333333333,1.54761904761905,1.95238095238095,-0.404761904761905,69,25,44,88,77,93,-8,1.8
1932,"Southport",3,42,58,70,67,3,1.38095238095238,1.66666666666667,1.5952380952381,0.0714285714285714,68,24,44,88,84,50,-16,-0.8
1932,"Stockport County",3,42,75,99,58,41,1.78571428571429,2.35714285714286,1.38095238095238,0.976190476190476,50,6,44,88,48,99,2,-0.8
1932,"Stoke City",2,42,81,78,39,39,1.92857142857143,1.85714285714286,0.928571428571429,0.928571428571429,23,1,22,44,12,113,11,0.6
1932,"Sunderland",1,42,55,63,80,-17,1.30952380952381,1.5,1.9047619047619,-0.404761904761905,12,12,22,22,8,119,4,1
1932,"Swansea City",2,42,61,50,54,-4,1.45238095238095,1.19047619047619,1.28571428571429,-0.0952380952380952,28,6,22,44,42,93,-14,-0.2
1932,"Swindon Town",3,42,38,60,105,-45,0.904761904761905,1.42857142857143,2.5,-1.07142857142857,87,43,44,88,61,93,26,1.7
1932,"Torquay United",3,42,60,72,67,5,1.42857142857143,1.71428571428571,1.5952380952381,0.119047619047619,63,19,44,88,78,78,-15,0.8
1932,"Tottenham Hotspur",2,42,75,96,51,45,1.78571428571429,2.28571428571429,1.21428571428571,1.07142857142857,24,2,22,44,3,101,21,0.1
1932,"Tranmere Rovers",3,42,59,70,66,4,1.4047619047619,1.66666666666667,1.57142857142857,0.0952380952380952,67,23,44,88,58,89,9,1.4
1932,"Walsall",3,42,67,75,58,17,1.5952380952381,1.78571428571429,1.38095238095238,0.404761904761905,53,9,44,88,50,100,3,-3.3
1932,"Watford",3,42,60,66,63,3,1.42857142857143,1.57142857142857,1.5,0.0714285714285714,64,20,44,88,71,93,-7,0.3
1932,"West Bromwich Albion",1,42,69,83,70,13,1.64285714285714,1.97619047619048,1.66666666666667,0.30952380952381,5,5,22,22,7,121,-2,-0.8
1932,"West Ham United",2,42,48,75,93,-18,1.14285714285714,1.78571428571429,2.21428571428571,-0.428571428571429,41,19,22,44,30,94,11,0
1932,"Wolverhampton Wanderers",1,42,48,80,96,-16,1.14285714285714,1.9047619047619,2.28571428571429,-0.380952380952381,19,19,22,22,15,121,4,1.6
1932,"Wrexham",3,42,81,106,51,55,1.92857142857143,2.52380952380952,1.21428571428571,1.30952380952381,48,4,44,88,55,80,-7,-3.9
1932,"York City",3,42,45,72,92,-20,1.07142857142857,1.71428571428571,2.19047619047619,-0.476190476190476,82,38,44,88,70,72,12,-0.6
1933,"Accrington Stanley",3,42,46,65,101,-36,1.0952380952381,1.54761904761905,2.4047619047619,-0.857142857142857,76,32,44,88,82,34,-6,-1.3
1933,"AFC Bournemouth",3,42,36,60,102,-42,0.857142857142857,1.42857142857143,2.42857142857143,-1,86,42,44,88,73,90,13,2.8
1933,"Aldershot",3,42,51,52,71,-19,1.21428571428571,1.23809523809524,1.69047619047619,-0.452380952380952,72,28,44,88,77,57,-5,-0.3
1933,"Arsenal",1,42,84,75,47,28,2,1.78571428571429,1.11904761904762,0.666666666666667,1,1,22,22,1,116,0,-0.4
1933,"Aston Villa",1,42,54,78,75,3,1.28571428571429,1.85714285714286,1.78571428571429,0.0714285714285714,14,14,22,22,13,121,1,-0.5
1933,"Barnsley",3,42,89,118,61,57,2.11904761904762,2.80952380952381,1.45238095238095,1.35714285714286,45,1,44,88,37,111,8,0.8
1933,"Barrow",3,42,66,116,94,22,1.57142857142857,2.76190476190476,2.23809523809524,0.523809523809524,59,15,44,88,79,44,-20,-1.9
1933,"Birmingham City",1,42,48,54,56,-2,1.14285714285714,1.28571428571429,1.33333333333333,-0.0476190476190476,20,20,22,22,19,117,1,-0.5
1933,"Blackburn Rovers",1,42,61,74,81,-7,1.45238095238095,1.76190476190476,1.92857142857143,-0.166666666666667,6,6,22,22,15,121,-9,-2.2
1933,"Blackpool",2,42,58,62,64,-2,1.38095238095238,1.47619047619048,1.52380952380952,-0.0476190476190476,34,12,22,44,26,112,8,3.1
1933,"Bolton Wanderers",2,42,72,79,55,24,1.71428571428571,1.88095238095238,1.30952380952381,0.571428571428571,26,4,22,44,24,121,2,1.9
1933,"Bradford City",2,42,66,73,67,6,1.57142857142857,1.73809523809524,1.5952380952381,0.142857142857143,28,6,22,44,42,106,-14,-3.1
1933,"Bradford Park Avenue",2,42,72,86,67,19,1.71428571428571,2.04761904761905,1.5952380952381,0.452380952380952,27,5,22,44,39,51,-12,-2.8
1933,"Brentford",2,42,73,85,60,25,1.73809523809524,2.02380952380952,1.42857142857143,0.595238095238095,25,3,22,44,23,93,2,-0.5
1933,"Brighton & Hove Albion",3,42,58,68,60,8,1.38095238095238,1.61904761904762,1.42857142857143,0.19047619047619,63,19,44,88,63,93,0,-1
1933,"Bristol City",3,42,43,58,85,-27,1.02380952380952,1.38095238095238,2.02380952380952,-0.642857142857143,82,38,44,88,71,108,11,2.1
1933,"Bristol Rovers",3,42,71,77,47,30,1.69047619047619,1.83333333333333,1.11904761904762,0.714285714285714,57,13,44,88,61,92,-4,0.1
1933,"Burnley",2,42,60,60,72,-12,1.42857142857143,1.42857142857143,1.71428571428571,-0.285714285714286,32,10,22,44,33,121,-1,2.2
1933,"Bury",2,42,60,70,73,-3,1.42857142857143,1.66666666666667,1.73809523809524,-0.0714285714285714,33,11,22,44,31,114,2,-0.8
1933,"Cardiff City",3,42,33,57,105,-48,0.785714285714286,1.35714285714286,2.5,-1.14285714285714,87,43,44,88,80,93,7,6
1933,"Carlisle United",3,42,53,66,81,-15,1.26190476190476,1.57142857142857,1.92857142857143,-0.357142857142857,69,25,44,88,88,84,-19,2
1933,"Charlton Athletic",3,42,74,83,56,27,1.76190476190476,1.97619047619048,1.33333333333333,0.642857142857143,54,10,44,88,45,92,9,3.9
1933,"Chelsea",1,42,50,67,69,-2,1.19047619047619,1.5952380952381,1.64285714285714,-0.0476190476190476,19,19,22,22,11,104,8,-0.1
1933,"Chester",3,42,57,89,86,3,1.35714285714286,2.11904761904762,2.04761904761905,0.0714285714285714,65,21,44,88,48,67,17,-0.3
1933,"Chesterfield",3,42,88,86,43,43,2.0952380952381,2.04761904761905,1.02380952380952,1.02380952380952,46,2,44,88,62,100,-16,0.3
1933,"Coventry City",3,42,75,100,54,46,1.78571428571429,2.38095238095238,1.28571428571429,1.0952380952381,51,7,44,88,51,94,0,2.2
1933,"Crewe Alexandra",3,42,51,81,97,-16,1.21428571428571,1.92857142857143,2.30952380952381,-0.380952380952381,73,29,44,88,72,96,1,0.9
1933,"Crystal Palace",3,42,57,71,67,4,1.35714285714286,1.69047619047619,1.5952380952381,0.0952380952380952,66,22,44,88,56,93,10,-2.6
1933,"Darlington",3,42,48,70,101,-31,1.14285714285714,1.66666666666667,2.4047619047619,-0.738095238095238,75,31,44,88,52,81,23,-0.6
1933,"Derby County",1,42,62,68,54,14,1.47619047619048,1.61904761904762,1.28571428571429,0.333333333333333,4,4,22,22,6,121,-2,-0.7
1933,"Doncaster Rovers",3,42,75,83,61,22,1.78571428571429,1.97619047619048,1.45238095238095,0.523809523809524,52,8,44,88,46,88,6,1.9
1933,"Everton",1,42,52,62,63,-1,1.23809523809524,1.47619047619048,1.5,-0.0238095238095238,17,17,22,22,9,121,8,-0.4
1933,"Exeter City",3,42,59,68,57,11,1.4047619047619,1.61904761904762,1.35714285714286,0.261904761904762,62,18,44,88,68,88,-6,-0.7
1933,"Fulham",2,42,52,48,67,-19,1.23809523809524,1.14285714285714,1.5952380952381,-0.452380952380952,37,15,22,44,30,102,7,2
1933,"Gateshead",3,42,45,76,110,-34,1.07142857142857,1.80952380952381,2.61904761904762,-0.80952380952381,79,35,44,88,81,23,-2,1.7
1933,"Gillingham",3,42,44,75,96,-21,1.04761904761905,1.78571428571429,2.28571428571429,-0.5,81,37,44,88,83,88,-2,1.8
1933,"Grimsby Town",2,42,86,103,59,44,2.04761904761905,2.45238095238095,1.4047619047619,1.04761904761905,23,1,22,44,7,110,16,-2.1
1933,"Halifax Town",3,42,64,80,91,-11,1.52380952380952,1.9047619047619,2.16666666666667,-0.261904761904762,60,16,44,88,47,69,13,-2.8
1933,"Hartlepool United",3,42,55,89,93,-4,1.30952380952381,2.11904761904762,2.21428571428571,-0.0952380952380952,67,23,44,88,66,89,1,-0.9
1933,"Huddersfield Town",1,42,79,90,61,29,1.88095238095238,2.14285714285714,1.45238095238095,0.69047619047619,2,2,22,22,17,99,-15,-1.4
1933,"Hull City",2,42,51,52,68,-16,1.21428571428571,1.23809523809524,1.61904761904762,-0.380952380952381,38,16,22,44,35,104,3,0.6
1933,"Leeds United",1,42,59,75,66,9,1.4047619047619,1.78571428571429,1.57142857142857,0.214285714285714,9,9,22,22,18,93,-9,-1.7
1933,"Leicester City",1,42,53,59,74,-15,1.26190476190476,1.4047619047619,1.76190476190476,-0.357142857142857,16,16,22,22,20,115,-4,-2
1933,"Leyton Orient",3,42,58,75,69,6,1.38095238095238,1.78571428571429,1.64285714285714,0.142857142857143,64,20,44,88,70,102,-6,-1.6
1933,"Lincoln City",2,42,35,44,75,-31,0.833333333333333,1.04761904761905,1.78571428571429,-0.738095238095238,44,22,22,44,50,107,-6,-0.6
1933,"Liverpool",1,42,52,79,87,-8,1.23809523809524,1.88095238095238,2.07142857142857,-0.19047619047619,18,18,22,22,5,116,13,0.9
1933,"Luton Town",3,42,73,83,61,22,1.73809523809524,1.97619047619048,1.45238095238095,0.523809523809524,56,12,44,88,54,91,2,1.4
1933,"Manchester City",1,42,62,65,72,-7,1.47619047619048,1.54761904761905,1.71428571428571,-0.166666666666667,5,5,22,22,3,117,2,-1.9
1933,"Manchester United",2,42,48,59,85,-26,1.14285714285714,1.4047619047619,2.02380952380952,-0.619047619047619,39,17,22,44,27,117,12,3.7
1933,"Mansfield Town",3,42,45,81,88,-7,1.07142857142857,1.92857142857143,2.0952380952381,-0.166666666666667,80,36,44,88,57,77,23,3.3
1933,"Middlesbrough",1,42,55,68,80,-12,1.30952380952381,1.61904761904762,1.9047619047619,-0.285714285714286,13,13,22,22,21,110,-8,0.7
1933,"Millwall",2,42,44,39,68,-29,1.04761904761905,0.928571428571429,1.61904761904762,-0.69047619047619,43,21,22,44,67,93,-24,-1
1933,"New Brighton",3,42,50,62,87,-25,1.19047619047619,1.47619047619048,2.07142857142857,-0.595238095238095,74,30,44,88,76,21,-2,-1.6
1933,"Newcastle United",1,42,44,68,77,-9,1.04761904761905,1.61904761904762,1.83333333333333,-0.214285714285714,21,21,22,22,28,116,-7,1.7
1933,"Newport County",3,42,41,49,70,-21,0.976190476190476,1.16666666666667,1.66666666666667,-0.5,83,39,44,88,87,67,-4,1.8
1933,"Northampton Town",3,42,54,71,78,-7,1.28571428571429,1.69047619047619,1.85714285714286,-0.166666666666667,68,24,44,88,59,93,9,-1.9
1933,"Norwich City",3,42,86,88,49,39,2.04761904761905,2.0952380952381,1.16666666666667,0.928571428571429,47,3,44,88,36,93,11,-0.1
1933,"Nottingham Forest",2,42,48,73,74,-1,1.14285714285714,1.73809523809524,1.76190476190476,-0.0238095238095238,40,18,22,44,32,117,8,-0.6
1933,"Notts County",2,42,47,53,62,-9,1.11904761904762,1.26190476190476,1.47619047619048,-0.214285714285714,41,19,22,44,44,120,-3,0.2
1933,"Oldham Athletic",2,42,61,72,60,12,1.45238095238095,1.71428571428571,1.42857142857143,0.285714285714286,31,9,22,44,43,102,-12,-4.3
1933,"Plymouth Argyle",2,42,58,69,70,-1,1.38095238095238,1.64285714285714,1.66666666666667,-0.0238095238095238,35,13,22,44,29,93,6,-1.7
1933,"Port Vale",2,42,64,60,55,5,1.52380952380952,1.42857142857143,1.30952380952381,0.119047619047619,29,7,22,44,40,107,-11,-3.8
1933,"Portsmouth",1,42,57,52,55,-3,1.35714285714286,1.23809523809524,1.30952380952381,-0.0714285714285714,10,10,22,22,14,93,-4,0.2
1933,"Preston North End",2,42,75,71,52,19,1.78571428571429,1.69047619047619,1.23809523809524,0.452380952380952,24,2,22,44,12,121,12,0.1
1933,"Queens Park Rangers",3,42,78,70,51,19,1.85714285714286,1.66666666666667,1.21428571428571,0.452380952380952,49,5,44,88,69,93,-20,1.1
1933,"Reading",3,42,75,82,50,32,1.78571428571429,1.95238095238095,1.19047619047619,0.761904761904762,53,9,44,88,49,93,4,-0.1
1933,"Rochdale",3,42,33,53,103,-50,0.785714285714286,1.26190476190476,2.45238095238095,-1.19047619047619,88,44,44,88,84,92,4,2.2
1933,"Rotherham United",3,42,38,53,91,-38,0.904761904761905,1.26190476190476,2.16666666666667,-0.904761904761905,85,41,44,88,60,88,25,4
1933,"Sheffield United",1,42,43,58,101,-43,1.02380952380952,1.38095238095238,2.4047619047619,-1.02380952380952,22,22,22,22,34,117,-12,-0.9
1933,"Sheffield Wednesday",1,42,57,62,67,-5,1.35714285714286,1.47619047619048,1.5952380952381,-0.119047619047619,11,11,22,22,4,117,7,-1.1
1933,"Southampton",2,42,53,54,58,-4,1.26190476190476,1.28571428571429,1.38095238095238,-0.0952380952380952,36,14,22,44,41,93,-5,0.2
1933,"Southend United",3,42,46,51,74,-23,1.0952380952381,1.21428571428571,1.76190476190476,-0.547619047619048,77,33,44,88,85,93,-8,1.7
1933,"Southport",3,42,41,63,90,-27,0.976190476190476,1.5,2.14285714285714,-0.642857142857143,84,40,44,88,86,50,-2,-0.1
1933,"Stockport County",3,42,83,115,52,63,1.97619047619048,2.73809523809524,1.23809523809524,1.5,48,4,44,88,55,99,-7,-1.5
1933,"Stoke City",1,42,56,58,71,-13,1.33333333333333,1.38095238095238,1.69047619047619,-0.30952380952381,12,12,22,22,10,113,2,0
1933,"Sunderland",1,42,60,81,56,25,1.42857142857143,1.92857142857143,1.33333333333333,0.595238095238095,8,8,22,22,2,119,6,-0.6
1933,"Swansea City",2,42,45,51,60,-9,1.07142857142857,1.21428571428571,1.42857142857143,-0.214285714285714,42,20,22,44,38,93,4,0.2
1933,"Swindon Town",3,42,62,64,68,-4,1.47619047619048,1.52380952380952,1.61904761904762,-0.0952380952380952,61,17,44,88,74,93,-13,-0.9
1933,"Torquay United",3,42,46,53,93,-40,1.0952380952381,1.26190476190476,2.21428571428571,-0.952380952380952,78,34,44,88,64,78,14,-0.5
1933,"Tottenham Hotspur",1,42,70,79,56,23,1.66666666666667,1.88095238095238,1.33333333333333,0.547619047619048,3,3,22,22,22,101,-19,0.2
1933,"Tranmere Rovers",3,42,67,84,63,21,1.5952380952381,2,1.5,0.5,58,14,44,88,53,89,5,0.7
1933,"Walsall",3,42,76,97,60,37,1.80952380952381,2.30952380952381,1.42857142857143,0.880952380952381,50,6,44,88,78,100,-28,-2.7
1933,"Watford",3,42,52,71,63,8,1.23809523809524,1.69047619047619,1.5,0.19047619047619,71,27,44,88,58,93,13,-2
1933,"West Bromwich Albion",1,42,61,78,70,8,1.45238095238095,1.85714285714286,1.66666666666667,0.19047619047619,7,7,22,22,8,121,-1,-1.1
1933,"West Ham United",2,42,62,78,70,8,1.47619047619048,1.85714285714286,1.66666666666667,0.19047619047619,30,8,22,44,25,94,5,-0.5
1933,"Wolverhampton Wanderers",1,42,54,74,86,-12,1.28571428571429,1.76190476190476,2.04761904761905,-0.285714285714286,15,15,22,22,16,121,-1,0.2
1933,"Wrexham",3,42,74,102,73,29,1.76190476190476,2.42857142857143,1.73809523809524,0.69047619047619,55,11,44,88,65,80,-10,-1.7
1933,"York City",3,42,53,71,74,-3,1.26190476190476,1.69047619047619,1.76190476190476,-0.0714285714285714,70,26,44,88,75,72,-5,-1.4
1934,"Accrington Stanley",3,42,46,63,89,-26,1.0952380952381,1.5,2.11904761904762,-0.619047619047619,82,38,44,88,59,34,23,-0.8
1934,"AFC Bournemouth",3,42,52,54,71,-17,1.23809523809524,1.28571428571429,1.69047619047619,-0.404761904761905,73,29,44,88,60,90,13,0.2
1934,"Aldershot",3,42,49,50,75,-25,1.16666666666667,1.19047619047619,1.78571428571429,-0.595238095238095,77,33,44,88,68,57,9,1
1934,"Arsenal",1,42,81,115,46,69,1.92857142857143,2.73809523809524,1.0952380952381,1.64285714285714,1,1,22,22,7,116,-6,-0.2
1934,"Aston Villa",1,42,55,74,88,-14,1.30952380952381,1.76190476190476,2.0952380952381,-0.333333333333333,13,13,22,22,21,121,-8,0.7
1934,"Barnsley",2,42,51,60,83,-23,1.21428571428571,1.42857142857143,1.97619047619048,-0.547619047619048,37,15,22,44,42,111,-5,-0.6
1934,"Barrow",3,42,48,58,87,-29,1.14285714285714,1.38095238095238,2.07142857142857,-0.69047619047619,79,35,44,88,76,44,3,1.4
1934,"Birmingham City",1,42,49,63,81,-18,1.16666666666667,1.5,1.92857142857143,-0.428571428571429,19,19,22,22,11,117,8,-0.5
1934,"Blackburn Rovers",1,42,53,66,78,-12,1.26190476190476,1.57142857142857,1.85714285714286,-0.285714285714286,15,15,22,22,22,121,-7,-1.8
1934,"Blackpool",2,42,74,79,57,22,1.76190476190476,1.88095238095238,1.35714285714286,0.523809523809524,26,4,22,44,31,112,-5,1.9
1934,"Bolton Wanderers",2,42,82,96,48,48,1.95238095238095,2.28571428571429,1.14285714285714,1.14285714285714,24,2,22,44,14,121,10,1.9
1934,"Bradford City",2,42,44,50,68,-18,1.04761904761905,1.19047619047619,1.61904761904762,-0.428571428571429,42,20,22,44,34,106,8,-3
1934,"Bradford Park Avenue",2,42,49,55,63,-8,1.16666666666667,1.30952380952381,1.5,-0.19047619047619,39,17,22,44,36,51,3,-2.2
1934,"Brentford",2,42,87,93,48,45,2.07142857142857,2.21428571428571,1.14285714285714,1.07142857142857,23,1,22,44,5,93,18,-1.1
1934,"Brighton & Hove Albion",3,42,60,69,62,7,1.42857142857143,1.64285714285714,1.47619047619048,0.166666666666667,63,19,44,88,58,93,5,1.3
1934,"Bristol City",3,42,54,52,68,-16,1.28571428571429,1.23809523809524,1.61904761904762,-0.380952380952381,71,27,44,88,67,108,4,-0.3
1934,"Bristol Rovers",3,42,61,73,77,-4,1.45238095238095,1.73809523809524,1.83333333333333,-0.0952380952380952,61,17,44,88,77,92,-16,0.4
1934,"Burnley",2,42,57,63,73,-10,1.35714285714286,1.5,1.73809523809524,-0.238095238095238,33,11,22,44,40,121,-7,2.1
1934,"Bury",2,42,61,62,73,-11,1.45238095238095,1.47619047619048,1.73809523809524,-0.261904761904762,31,9,22,44,37,114,-6,-0.7
1934,"Cardiff City",3,42,48,62,82,-20,1.14285714285714,1.47619047619048,1.95238095238095,-0.476190476190476,80,36,44,88,82,93,-2,5.5
1934,"Carlisle United",3,42,31,51,102,-51,0.738095238095238,1.21428571428571,2.42857142857143,-1.21428571428571,88,44,44,88,69,84,19,2.8
1934,"Charlton Athletic",3,42,88,103,52,51,2.0952380952381,2.45238095238095,1.23809523809524,1.21428571428571,45,1,44,88,24,92,21,3.5
1934,"Chelsea",1,42,57,73,82,-9,1.35714285714286,1.73809523809524,1.95238095238095,-0.214285714285714,11,11,22,22,10,104,1,-0.7
1934,"Chester",3,42,74,91,58,33,1.76190476190476,2.16666666666667,1.38095238095238,0.785714285714286,48,4,44,88,49,67,-1,-3.2
1934,"Chesterfield",3,42,61,71,52,19,1.45238095238095,1.69047619047619,1.23809523809524,0.452380952380952,62,18,44,88,45,100,17,-0.6
1934,"Coventry City",3,42,72,86,50,36,1.71428571428571,2.04761904761905,1.19047619047619,0.857142857142857,51,7,44,88,46,94,5,1
1934,"Crewe Alexandra",3,42,53,66,86,-20,1.26190476190476,1.57142857142857,2.04761904761905,-0.476190476190476,72,28,44,88,56,96,16,0.2
1934,"Crystal Palace",3,42,67,86,64,22,1.5952380952381,2.04761904761905,1.52380952380952,0.523809523809524,56,12,44,88,53,93,3,-2.5
1934,"Darlington",3,42,72,80,59,21,1.71428571428571,1.9047619047619,1.4047619047619,0.5,52,8,44,88,61,81,-9,-3.9
1934,"Derby County",1,42,63,81,66,15,1.5,1.92857142857143,1.57142857142857,0.357142857142857,6,6,22,22,3,121,3,-0.9
1934,"Doncaster Rovers",3,42,83,87,44,43,1.97619047619048,2.07142857142857,1.04761904761905,1.02380952380952,46,2,44,88,38,88,8,0.7
1934,"Everton",1,42,60,89,88,1,1.42857142857143,2.11904761904762,2.0952380952381,0.0238095238095238,9,9,22,22,18,121,-9,-2
1934,"Exeter City",3,42,57,70,75,-5,1.35714285714286,1.66666666666667,1.78571428571429,-0.119047619047619,68,24,44,88,87,88,-19,-1.8
1934,"Fulham",2,42,63,76,56,20,1.5,1.80952380952381,1.33333333333333,0.476190476190476,30,8,22,44,33,102,-3,0.8
1934,"Gateshead",3,42,47,58,96,-38,1.11904761904762,1.38095238095238,2.28571428571429,-0.904761904761905,81,37,44,88,72,23,9,2.6
1934,"Gillingham",3,42,46,55,75,-20,1.0952380952381,1.30952380952381,1.78571428571429,-0.476190476190476,83,39,44,88,78,88,5,-0.4
1934,"Grimsby Town",1,42,62,78,60,18,1.47619047619048,1.85714285714286,1.42857142857143,0.428571428571429,7,7,22,22,12,110,-5,-3.9
1934,"Halifax Town",3,42,80,76,67,9,1.9047619047619,1.80952380952381,1.5952380952381,0.214285714285714,47,3,44,88,74,69,-27,-3.6
1934,"Hartlepool United",3,42,58,80,78,2,1.38095238095238,1.9047619047619,1.85714285714286,0.0476190476190476,66,22,44,88,62,89,4,0.8
1934,"Huddersfield Town",1,42,52,76,71,5,1.23809523809524,1.80952380952381,1.69047619047619,0.119047619047619,17,17,22,22,4,99,13,-0.4
1934,"Hull City",2,42,56,63,74,-11,1.33333333333333,1.5,1.76190476190476,-0.261904761904762,35,13,22,44,44,104,-9,-0.5
1934,"Leeds United",1,42,51,75,92,-17,1.21428571428571,1.78571428571429,2.19047619047619,-0.404761904761905,18,18,22,22,13,93,5,-1
1934,"Leicester City",1,42,45,61,86,-25,1.07142857142857,1.45238095238095,2.04761904761905,-0.595238095238095,20,20,22,22,28,115,-8,-0.7
1934,"Leyton Orient",3,42,55,65,65,0,1.30952380952381,1.54761904761905,1.54761904761905,0,70,26,44,88,70,102,0,-0.6
1934,"Lincoln City",3,42,73,87,58,29,1.73809523809524,2.07142857142857,1.38095238095238,0.69047619047619,50,6,44,88,51,107,-1,0.5
1934,"Liverpool",1,42,64,85,88,-3,1.52380952380952,2.02380952380952,2.0952380952381,-0.0714285714285714,5,5,22,22,19,116,-14,-0.8
1934,"Luton Town",3,42,69,92,60,32,1.64285714285714,2.19047619047619,1.42857142857143,0.761904761904762,54,10,44,88,48,91,6,2.4
1934,"Manchester City",1,42,68,82,67,15,1.61904761904762,1.95238095238095,1.5952380952381,0.357142857142857,3,3,22,22,8,117,-5,-1.3
1934,"Manchester United",2,42,73,76,55,21,1.73809523809524,1.80952380952381,1.30952380952381,0.5,27,5,22,44,23,117,4,2.6
1934,"Mansfield Town",3,42,66,75,62,13,1.57142857142857,1.78571428571429,1.47619047619048,0.30952380952381,57,13,44,88,79,77,-22,0.1
1934,"Middlesbrough",1,42,44,70,90,-20,1.04761904761905,1.66666666666667,2.14285714285714,-0.476190476190476,21,21,22,22,15,110,6,0.4
1934,"Millwall",3,42,58,57,62,-5,1.38095238095238,1.35714285714286,1.47619047619048,-0.119047619047619,67,23,44,88,71,93,-4,1.5
1934,"New Brighton",3,42,50,59,76,-17,1.19047619047619,1.4047619047619,1.80952380952381,-0.404761904761905,76,32,44,88,88,21,-12,NA
1934,"Newcastle United",2,42,70,89,68,21,1.66666666666667,2.11904761904762,1.61904761904762,0.5,28,6,22,44,30,116,-2,2
1934,"Newport County",3,42,35,54,112,-58,0.833333333333333,1.28571428571429,2.66666666666667,-1.38095238095238,87,43,44,88,85,67,2,3.3
1934,"Northampton Town",3,42,65,65,67,-2,1.54761904761905,1.54761904761905,1.5952380952381,-0.0476190476190476,59,15,44,88,73,93,-14,0
1934,"Norwich City",2,42,53,71,61,10,1.26190476190476,1.69047619047619,1.45238095238095,0.238095238095238,36,14,22,44,32,93,4,-1.3
1934,"Nottingham Forest",2,42,59,76,70,6,1.4047619047619,1.80952380952381,1.66666666666667,0.142857142857143,32,10,22,44,41,117,-9,0.6
1934,"Notts County",2,42,34,46,97,-51,0.80952380952381,1.0952380952381,2.30952380952381,-1.21428571428571,44,22,22,44,63,120,-19,0.7
1934,"Oldham Athletic",2,42,36,56,95,-39,0.857142857142857,1.33333333333333,2.26190476190476,-0.928571428571429,43,21,22,44,57,102,-14,-1
1934,"Plymouth Argyle",2,42,65,75,64,11,1.54761904761905,1.78571428571429,1.52380952380952,0.261904761904762,29,7,22,44,27,93,2,-1.8
1934,"Port Vale",2,42,45,55,74,-19,1.07142857142857,1.30952380952381,1.76190476190476,-0.452380952380952,40,18,22,44,43,107,-3,-3.7
1934,"Portsmouth",1,42,55,71,72,-1,1.30952380952381,1.69047619047619,1.71428571428571,-0.0238095238095238,14,14,22,22,9,93,5,1
1934,"Preston North End",1,42,57,62,67,-5,1.35714285714286,1.47619047619048,1.5952380952381,-0.119047619047619,12,12,22,22,6,121,6,0.3
1934,"Queens Park Rangers",3,42,57,63,72,-9,1.35714285714286,1.5,1.71428571428571,-0.214285714285714,69,25,44,88,52,93,17,2.5
1934,"Reading",3,42,74,89,65,24,1.76190476190476,2.11904761904762,1.54761904761905,0.571428571428571,49,5,44,88,47,93,2,0.1
1934,"Rochdale",3,42,44,53,71,-18,1.04761904761905,1.26190476190476,1.69047619047619,-0.428571428571429,84,40,44,88,84,92,0,-0.4
1934,"Rotherham United",3,42,64,86,73,13,1.52380952380952,2.04761904761905,1.73809523809524,0.30952380952381,60,16,44,88,64,88,-4,2.9
1934,"Sheffield United",2,42,57,79,70,9,1.35714285714286,1.88095238095238,1.66666666666667,0.214285714285714,34,12,22,44,26,117,8,0.2
1934,"Sheffield Wednesday",1,42,67,70,64,6,1.5952380952381,1.66666666666667,1.52380952380952,0.142857142857143,4,4,22,22,20,117,-16,-1.9
1934,"Southampton",2,42,45,46,75,-29,1.07142857142857,1.0952380952381,1.78571428571429,-0.69047619047619,41,19,22,44,39,93,2,0.6
1934,"Southend United",3,42,42,65,78,-13,1,1.54761904761905,1.85714285714286,-0.30952380952381,85,41,44,88,83,93,2,2.2
1934,"Southport",3,42,42,55,85,-30,1,1.30952380952381,2.02380952380952,-0.714285714285714,86,42,44,88,86,50,0,0.8
1934,"Stockport County",3,42,69,90,72,18,1.64285714285714,2.14285714285714,1.71428571428571,0.428571428571429,55,11,44,88,55,99,0,0.4
1934,"Stoke City",1,42,60,71,70,1,1.42857142857143,1.69047619047619,1.66666666666667,0.0238095238095238,10,10,22,22,2,113,8,-1
1934,"Sunderland",1,42,73,90,51,39,1.73809523809524,2.14285714285714,1.21428571428571,0.928571428571429,2,2,22,22,1,119,1,-0.9
1934,"Swansea City",2,42,50,56,67,-11,1.19047619047619,1.33333333333333,1.5952380952381,-0.261904761904762,38,16,22,44,35,93,3,-0.4
1934,"Swindon Town",3,42,51,67,78,-11,1.21428571428571,1.5952380952381,1.85714285714286,-0.261904761904762,74,30,44,88,81,93,-7,-0.5
1934,"Torquay United",3,42,60,81,75,6,1.42857142857143,1.92857142857143,1.78571428571429,0.142857142857143,64,20,44,88,65,78,-1,-0.5
1934,"Tottenham Hotspur",1,42,40,54,93,-39,0.952380952380952,1.28571428571429,2.21428571428571,-0.928571428571429,22,22,22,22,29,101,-7,2
1934,"Tranmere Rovers",3,42,71,74,55,19,1.69047619047619,1.76190476190476,1.30952380952381,0.452380952380952,53,9,44,88,50,89,3,-0.9
1934,"Walsall",3,42,49,81,72,9,1.16666666666667,1.92857142857143,1.71428571428571,0.214285714285714,78,34,44,88,66,100,12,-1.1
1934,"Watford",3,42,66,76,49,27,1.57142857142857,1.80952380952381,1.16666666666667,0.642857142857143,58,14,44,88,54,93,4,-2.7
1934,"West Bromwich Albion",1,42,61,83,83,0,1.45238095238095,1.97619047619048,1.97619047619048,0,8,8,22,22,17,121,-9,-0.6
1934,"West Ham United",2,42,82,80,63,17,1.95238095238095,1.9047619047619,1.5,0.404761904761905,25,3,22,44,25,94,0,-1.1
1934,"Wolverhampton Wanderers",1,42,53,88,94,-6,1.26190476190476,2.0952380952381,2.23809523809524,-0.142857142857143,16,16,22,22,16,121,0,-0.3
1934,"Wrexham",3,42,59,76,69,7,1.4047619047619,1.80952380952381,1.64285714285714,0.166666666666667,65,21,44,88,75,80,-10,-1.7
1934,"York City",3,42,51,76,82,-6,1.21428571428571,1.80952380952381,1.95238095238095,-0.142857142857143,75,31,44,88,80,72,-5,1.1
1935,"Accrington Stanley",3,42,59,63,72,-9,1.4047619047619,1.5,1.71428571428571,-0.214285714285714,59,15,44,88,68,34,-9,-3.2
1935,"AFC Bournemouth",3,42,59,60,56,4,1.4047619047619,1.42857142857143,1.33333333333333,0.0952380952380952,60,16,44,88,52,90,8,-0.3
1935,"Aldershot",3,42,54,53,61,-8,1.28571428571429,1.26190476190476,1.45238095238095,-0.19047619047619,68,24,44,88,88,57,-20,-1.4
1935,"Arsenal",1,42,60,78,48,30,1.42857142857143,1.85714285714286,1.14285714285714,0.714285714285714,7,7,22,22,3,116,4,0.6
1935,"Aston Villa",1,42,48,81,110,-29,1.14285714285714,1.92857142857143,2.61904761904762,-0.69047619047619,21,21,22,22,31,121,-10,1
1935,"Barnsley",2,42,45,54,80,-26,1.07142857142857,1.28571428571429,1.9047619047619,-0.619047619047619,42,20,22,44,36,111,6,-0.2
1935,"Barrow",3,42,51,58,65,-7,1.21428571428571,1.38095238095238,1.54761904761905,-0.166666666666667,76,32,44,88,75,44,1,0.2
1935,"Birmingham City",1,42,56,61,63,-2,1.33333333333333,1.45238095238095,1.5,-0.0476190476190476,11,11,22,22,14,117,-3,-1.6
1935,"Blackburn Rovers",1,42,45,55,96,-41,1.07142857142857,1.30952380952381,2.28571428571429,-0.976190476190476,22,22,22,22,33,121,-11,-0.7
1935,"Blackpool",2,42,61,93,72,21,1.45238095238095,2.21428571428571,1.71428571428571,0.5,31,9,22,44,24,112,7,2.5
1935,"Bolton Wanderers",1,42,55,67,76,-9,1.30952380952381,1.5952380952381,1.80952380952381,-0.214285714285714,14,14,22,22,20,121,-6,0.2
1935,"Bradford City",2,42,58,55,65,-10,1.38095238095238,1.30952380952381,1.54761904761905,-0.238095238095238,34,12,22,44,43,106,-9,-4.1
1935,"Bradford Park Avenue",2,42,51,62,84,-22,1.21428571428571,1.47619047619048,2,-0.523809523809524,36,14,22,44,41,51,-5,-2
1935,"Brentford",1,42,63,81,60,21,1.5,1.92857142857143,1.42857142857143,0.5,5,5,22,22,7,93,-2,-3.2
1935,"Brighton & Hove Albion",3,42,62,70,63,7,1.47619047619048,1.66666666666667,1.5,0.166666666666667,58,14,44,88,49,93,9,0.1
1935,"Bristol City",3,42,55,48,59,-11,1.30952380952381,1.14285714285714,1.4047619047619,-0.261904761904762,67,23,44,88,72,108,-5,1.8
1935,"Bristol Rovers",3,42,51,69,95,-26,1.21428571428571,1.64285714285714,2.26190476190476,-0.619047619047619,77,33,44,88,71,92,6,3.2
1935,"Burnley",2,42,49,50,59,-9,1.16666666666667,1.19047619047619,1.4047619047619,-0.214285714285714,40,18,22,44,34,121,6,3.3
1935,"Bury",2,42,51,66,84,-18,1.21428571428571,1.57142857142857,2,-0.428571428571429,37,15,22,44,25,114,12,-0.5
1935,"Cardiff City",3,42,49,60,73,-13,1.16666666666667,1.42857142857143,1.73809523809524,-0.30952380952381,82,38,44,88,76,93,6,6.9
1935,"Carlisle United",3,42,54,56,62,-6,1.28571428571429,1.33333333333333,1.47619047619048,-0.142857142857143,69,25,44,88,61,84,8,0.8
1935,"Charlton Athletic",2,42,77,85,58,27,1.83333333333333,2.02380952380952,1.38095238095238,0.642857142857143,24,2,22,44,2,92,22,1.9
1935,"Chelsea",1,42,58,65,72,-7,1.38095238095238,1.54761904761905,1.71428571428571,-0.166666666666667,10,10,22,22,12,104,-2,-0.9
1935,"Chester",3,42,77,100,45,55,1.83333333333333,2.38095238095238,1.07142857142857,1.30952380952381,49,5,44,88,50,67,-1,-3.7
1935,"Chesterfield",3,42,84,92,39,53,2,2.19047619047619,0.928571428571429,1.26190476190476,45,1,44,88,37,100,8,-2
1935,"Coventry City",3,42,81,102,45,57,1.92857142857143,2.42857142857143,1.07142857142857,1.35714285714286,46,2,44,88,30,94,16,-1.2
1935,"Crewe Alexandra",3,42,66,80,76,4,1.57142857142857,1.9047619047619,1.80952380952381,0.0952380952380952,56,12,44,88,85,96,-29,-0.3
1935,"Crystal Palace",3,42,71,96,74,22,1.69047619047619,2.28571428571429,1.76190476190476,0.523809523809524,53,9,44,88,73,93,-20,-2.3
1935,"Darlington",3,42,57,74,79,-5,1.35714285714286,1.76190476190476,1.88095238095238,-0.119047619047619,61,17,44,88,87,81,-26,-2.6
1935,"Derby County",1,42,66,61,52,9,1.57142857142857,1.45238095238095,1.23809523809524,0.214285714285714,3,3,22,22,4,121,-1,-1.9
1935,"Doncaster Rovers",2,42,51,51,71,-20,1.21428571428571,1.21428571428571,1.69047619047619,-0.476190476190476,38,16,22,44,44,88,-6,0.3
1935,"Everton",1,42,52,89,89,0,1.23809523809524,2.11904761904762,2.11904761904762,0,18,18,22,22,16,121,2,-2
1935,"Exeter City",3,42,35,59,93,-34,0.833333333333333,1.4047619047619,2.21428571428571,-0.80952380952381,87,43,44,88,86,88,1,0.6
1935,"Fulham",2,42,59,76,52,24,1.4047619047619,1.80952380952381,1.23809523809524,0.571428571428571,33,11,22,44,35,102,-2,0.2
1935,"Gateshead",3,42,53,56,76,-20,1.26190476190476,1.33333333333333,1.80952380952381,-0.476190476190476,72,28,44,88,83,23,-11,0.8
1935,"Gillingham",3,42,51,66,77,-11,1.21428571428571,1.57142857142857,1.83333333333333,-0.261904761904762,78,34,44,88,62,88,16,-0.9
1935,"Grimsby Town",1,42,56,65,73,-8,1.33333333333333,1.54761904761905,1.73809523809524,-0.19047619047619,12,12,22,22,10,110,2,-4.1
1935,"Halifax Town",3,42,52,57,61,-4,1.23809523809524,1.35714285714286,1.45238095238095,-0.0952380952380952,74,30,44,88,58,69,16,0.6
1935,"Hartlepool United",3,42,57,57,61,-4,1.35714285714286,1.35714285714286,1.45238095238095,-0.0952380952380952,62,18,44,88,56,89,6,-0.8
1935,"Huddersfield Town",1,42,66,59,56,3,1.57142857142857,1.4047619047619,1.33333333333333,0.0714285714285714,4,4,22,22,17,99,-13,-2
1935,"Hull City",2,42,25,47,111,-64,0.595238095238095,1.11904761904762,2.64285714285714,-1.52380952380952,44,22,22,44,59,104,-15,0.5
1935,"Leeds United",1,42,56,66,64,2,1.33333333333333,1.57142857142857,1.52380952380952,0.0476190476190476,13,13,22,22,18,93,-5,-1.9
1935,"Leicester City",2,42,67,79,57,22,1.5952380952381,1.88095238095238,1.35714285714286,0.523809523809524,28,6,22,44,23,115,5,0
1935,"Leyton Orient",3,42,54,55,61,-6,1.28571428571429,1.30952380952381,1.45238095238095,-0.142857142857143,70,26,44,88,69,102,1,-0.7
1935,"Lincoln City",3,42,75,91,51,40,1.78571428571429,2.16666666666667,1.21428571428571,0.952380952380952,51,7,44,88,47,107,4,1.1
1935,"Liverpool",1,42,51,60,64,-4,1.21428571428571,1.42857142857143,1.52380952380952,-0.0952380952380952,19,19,22,22,19,116,0,0.2
1935,"Luton Town",3,42,78,81,45,36,1.85714285714286,1.92857142857143,1.07142857142857,0.857142857142857,48,4,44,88,45,91,3,2.3
1935,"Manchester City",1,42,59,68,60,8,1.4047619047619,1.61904761904762,1.42857142857143,0.19047619047619,8,8,22,22,1,117,7,-1
1935,"Manchester United",2,42,78,85,43,42,1.85714285714286,2.02380952380952,1.02380952380952,1,23,1,22,44,21,117,2,1.5
1935,"Mansfield Town",3,42,51,80,91,-11,1.21428571428571,1.9047619047619,2.16666666666667,-0.261904761904762,79,35,44,88,63,77,16,0.8
1935,"Middlesbrough",1,42,55,84,70,14,1.30952380952381,2,1.66666666666667,0.333333333333333,15,15,22,22,6,110,9,0.1
1935,"Millwall",3,42,54,58,71,-13,1.28571428571429,1.38095238095238,1.69047619047619,-0.30952380952381,71,27,44,88,57,93,14,2.4
1935,"New Brighton",3,42,33,43,102,-59,0.785714285714286,1.02380952380952,2.42857142857143,-1.4047619047619,88,44,44,88,74,21,14,NA
1935,"Newcastle United",2,42,66,88,79,9,1.57142857142857,2.0952380952381,1.88095238095238,0.214285714285714,30,8,22,44,26,116,4,1.4
1935,"Newport County",3,42,42,60,111,-51,1,1.42857142857143,2.64285714285714,-1.21428571428571,85,41,44,88,81,67,4,0.7
1935,"Northampton Town",3,42,53,62,90,-28,1.26190476190476,1.47619047619048,2.14285714285714,-0.666666666666667,73,29,44,88,55,93,18,2.7
1935,"Norwich City",2,42,60,72,65,7,1.42857142857143,1.71428571428571,1.54761904761905,0.166666666666667,32,10,22,44,39,93,-7,-1.6
1935,"Nottingham Forest",2,42,47,69,76,-7,1.11904761904762,1.64285714285714,1.80952380952381,-0.166666666666667,41,19,22,44,40,117,1,1.1
1935,"Notts County",3,42,57,60,57,3,1.35714285714286,1.42857142857143,1.35714285714286,0.0714285714285714,63,19,44,88,48,120,15,2.2
1935,"Oldham Athletic",3,42,63,86,73,13,1.5,2.04761904761905,1.73809523809524,0.30952380952381,57,13,44,88,51,102,6,0.7
1935,"Plymouth Argyle",2,42,68,71,57,14,1.61904761904762,1.69047619047619,1.35714285714286,0.333333333333333,27,5,22,44,28,93,-1,0.1
1935,"Port Vale",2,42,44,56,106,-50,1.04761904761905,1.33333333333333,2.52380952380952,-1.19047619047619,43,21,22,44,65,107,-22,-0.9
1935,"Portsmouth",1,42,59,54,67,-13,1.4047619047619,1.28571428571429,1.5952380952381,-0.30952380952381,9,9,22,22,9,93,0,-0.6
1935,"Preston North End",1,42,62,67,64,3,1.47619047619048,1.5952380952381,1.52380952380952,0.0714285714285714,6,6,22,22,13,121,-7,0.4
1935,"Queens Park Rangers",3,42,75,84,53,31,1.78571428571429,2,1.26190476190476,0.738095238095238,52,8,44,88,60,93,-8,-3.2
1935,"Reading",3,42,80,87,62,25,1.9047619047619,2.07142857142857,1.47619047619048,0.595238095238095,47,3,44,88,53,93,-6,-1.9
1935,"Rochdale",3,42,43,58,88,-30,1.02380952380952,1.38095238095238,2.0952380952381,-0.714285714285714,84,40,44,88,80,92,4,-0.5
1935,"Rotherham United",3,42,57,69,66,3,1.35714285714286,1.64285714285714,1.57142857142857,0.0714285714285714,64,20,44,88,77,88,-13,3.1
1935,"Sheffield United",2,42,72,79,50,29,1.71428571428571,1.88095238095238,1.19047619047619,0.69047619047619,26,4,22,44,29,117,-3,0.3
1935,"Sheffield Wednesday",1,42,51,63,77,-14,1.21428571428571,1.5,1.83333333333333,-0.333333333333333,20,20,22,22,22,117,-2,0
1935,"Southampton",2,42,51,47,65,-18,1.21428571428571,1.11904761904762,1.54761904761905,-0.428571428571429,39,17,22,44,42,93,-3,-0.4
1935,"Southend United",3,42,49,61,62,-1,1.16666666666667,1.45238095238095,1.47619047619048,-0.0238095238095238,83,39,44,88,64,93,19,2.1
1935,"Southport",3,42,42,48,90,-42,1,1.14285714285714,2.14285714285714,-1,86,42,44,88,78,50,8,3.1
1935,"Stockport County",3,42,68,65,49,16,1.61904761904762,1.54761904761905,1.16666666666667,0.380952380952381,55,11,44,88,46,99,9,-1.2
1935,"Stoke City",1,42,67,57,57,0,1.5952380952381,1.35714285714286,1.35714285714286,0,2,2,22,22,11,113,-9,-1.9
1935,"Sunderland",1,42,81,109,74,35,1.92857142857143,2.5952380952381,1.76190476190476,0.833333333333333,1,1,22,22,8,119,-7,-0.8
1935,"Swansea City",2,42,54,67,76,-9,1.28571428571429,1.5952380952381,1.80952380952381,-0.214285714285714,35,13,22,44,38,93,-3,0.1
1935,"Swindon Town",3,42,50,64,73,-9,1.19047619047619,1.52380952380952,1.73809523809524,-0.214285714285714,81,37,44,88,70,93,11,0.1
1935,"Torquay United",3,42,57,62,62,0,1.35714285714286,1.47619047619048,1.47619047619048,0,65,21,44,88,84,78,-19,-0.4
1935,"Tottenham Hotspur",2,42,67,91,55,36,1.5952380952381,2.16666666666667,1.30952380952381,0.857142857142857,29,7,22,44,32,101,-3,1.9
1935,"Tranmere Rovers",3,42,77,93,58,35,1.83333333333333,2.21428571428571,1.38095238095238,0.833333333333333,50,6,44,88,82,89,-32,-1
1935,"Walsall",3,42,57,79,59,20,1.35714285714286,1.88095238095238,1.4047619047619,0.476190476190476,66,22,44,88,79,100,-13,-2.6
1935,"Watford",3,42,69,80,54,26,1.64285714285714,1.9047619047619,1.28571428571429,0.619047619047619,54,10,44,88,54,93,0,-1.9
1935,"West Bromwich Albion",1,42,54,89,88,1,1.28571428571429,2.11904761904762,2.0952380952381,0.0238095238095238,17,17,22,22,15,121,2,1.4
1935,"West Ham United",2,42,74,90,68,22,1.76190476190476,2.14285714285714,1.61904761904762,0.523809523809524,25,3,22,44,27,94,-2,-1.1
1935,"Wolverhampton Wanderers",1,42,55,77,76,1,1.30952380952381,1.83333333333333,1.80952380952381,0.0238095238095238,16,16,22,22,5,121,11,1.2
1935,"Wrexham",3,42,52,66,75,-9,1.23809523809524,1.57142857142857,1.78571428571429,-0.214285714285714,75,31,44,88,66,80,9,2.4
1935,"York City",3,42,51,62,95,-33,1.21428571428571,1.47619047619048,2.26190476190476,-0.785714285714286,80,36,44,88,67,72,13,2.6
1936,"Accrington Stanley",3,42,57,76,69,7,1.35714285714286,1.80952380952381,1.64285714285714,0.166666666666667,68,24,44,88,85,34,-17,-0.7
1936,"AFC Bournemouth",3,42,69,65,59,6,1.64285714285714,1.54761904761905,1.4047619047619,0.142857142857143,52,8,44,88,68,90,-16,-2.7
1936,"Aldershot",3,42,30,50,89,-39,0.714285714285714,1.19047619047619,2.11904761904762,-0.928571428571429,88,44,44,88,75,57,13,1.5
1936,"Arsenal",1,42,70,80,49,31,1.66666666666667,1.9047619047619,1.16666666666667,0.738095238095238,3,3,22,22,1,116,2,-0.9
1936,"Aston Villa",2,42,60,82,70,12,1.42857142857143,1.95238095238095,1.66666666666667,0.285714285714286,31,9,22,44,23,121,8,1.8
1936,"Barnsley",2,42,57,50,64,-14,1.35714285714286,1.19047619047619,1.52380952380952,-0.333333333333333,36,14,22,44,43,111,-7,-1.2
1936,"Barrow",3,42,49,70,86,-16,1.16666666666667,1.66666666666667,2.04761904761905,-0.380952380952381,75,31,44,88,82,44,-7,0.1
1936,"Birmingham City",1,42,54,64,60,4,1.28571428571429,1.52380952380952,1.42857142857143,0.0952380952380952,14,14,22,22,22,117,-8,-1.5
1936,"Blackburn Rovers",2,42,58,70,62,8,1.38095238095238,1.66666666666667,1.47619047619048,0.19047619047619,33,11,22,44,38,121,-5,0.9
1936,"Blackpool",2,42,79,88,53,35,1.88095238095238,2.0952380952381,1.26190476190476,0.833333333333333,24,2,22,44,10,112,14,2
1936,"Bolton Wanderers",1,42,44,43,66,-23,1.04761904761905,1.02380952380952,1.57142857142857,-0.547619047619048,20,20,22,22,7,121,13,1.4
1936,"Bradford City",2,42,39,54,94,-40,0.928571428571429,1.28571428571429,2.23809523809524,-0.952380952380952,43,21,22,44,72,106,-29,-0.9
1936,"Bradford Park Avenue",2,42,45,52,88,-36,1.07142857142857,1.23809523809524,2.0952380952381,-0.857142857142857,41,19,22,44,29,51,12,-2
1936,"Brentford",1,42,64,82,78,4,1.52380952380952,1.95238095238095,1.85714285714286,0.0952380952380952,7,7,22,22,5,93,2,-3.6
1936,"Brighton & Hove Albion",3,42,77,74,43,31,1.83333333333333,1.76190476190476,1.02380952380952,0.738095238095238,49,5,44,88,52,93,-3,0.2
1936,"Bristol City",3,42,51,58,70,-12,1.21428571428571,1.38095238095238,1.66666666666667,-0.285714285714286,72,28,44,88,47,108,25,2.3
1936,"Bristol Rovers",3,42,52,71,80,-9,1.23809523809524,1.69047619047619,1.9047619047619,-0.214285714285714,71,27,44,88,73,92,-2,4
1936,"Burnley",2,42,58,57,61,-4,1.38095238095238,1.35714285714286,1.45238095238095,-0.0952380952380952,34,12,22,44,28,121,6,2.9
1936,"Bury",2,42,74,74,55,19,1.76190476190476,1.76190476190476,1.30952380952381,0.452380952380952,25,3,22,44,30,114,-5,-1.4
1936,"Cardiff City",3,42,49,54,87,-33,1.16666666666667,1.28571428571429,2.07142857142857,-0.785714285714286,76,32,44,88,65,93,11,6.7
1936,"Carlisle United",3,42,62,65,68,-3,1.47619047619048,1.54761904761905,1.61904761904762,-0.0714285714285714,61,17,44,88,69,84,-8,-1.6
1936,"Charlton Athletic",1,42,75,58,49,9,1.78571428571429,1.38095238095238,1.16666666666667,0.214285714285714,2,2,22,22,6,92,-4,-0.6
1936,"Chelsea",1,42,55,52,55,-3,1.30952380952381,1.23809523809524,1.30952380952381,-0.0714285714285714,12,12,22,22,13,104,-1,0.1
1936,"Chester",3,42,75,87,57,30,1.78571428571429,2.07142857142857,1.35714285714286,0.714285714285714,50,6,44,88,61,67,-11,-4
1936,"Chesterfield",2,42,56,84,89,-5,1.33333333333333,2,2.11904761904762,-0.119047619047619,37,15,22,44,32,100,5,-1.9
1936,"Coventry City",2,42,62,66,54,12,1.47619047619048,1.57142857142857,1.28571428571429,0.285714285714286,30,8,22,44,26,94,4,-3.7
1936,"Crewe Alexandra",3,42,42,55,83,-28,1,1.30952380952381,1.97619047619048,-0.666666666666667,85,41,44,88,59,96,26,0.5
1936,"Crystal Palace",3,42,51,62,61,1,1.21428571428571,1.47619047619048,1.45238095238095,0.0238095238095238,73,29,44,88,57,93,16,-1
1936,"Darlington",3,42,38,66,96,-30,0.904761904761905,1.57142857142857,2.28571428571429,-0.714285714285714,87,43,44,88,83,81,4,0
1936,"Derby County",1,42,70,96,90,6,1.66666666666667,2.28571428571429,2.14285714285714,0.142857142857143,4,4,22,22,14,121,-10,-3.6
1936,"Doncaster Rovers",2,42,31,30,84,-54,0.738095238095238,0.714285714285714,2,-1.28571428571429,44,22,22,44,48,88,-4,1.1
1936,"Everton",1,42,51,81,78,3,1.21428571428571,1.92857142857143,1.85714285714286,0.0714285714285714,16,16,22,22,15,121,1,-0.9
1936,"Exeter City",3,42,42,59,88,-29,1,1.4047619047619,2.0952380952381,-0.69047619047619,86,42,44,88,74,88,12,2.4
1936,"Fulham",2,42,58,71,61,10,1.38095238095238,1.69047619047619,1.45238095238095,0.238095238095238,35,13,22,44,31,102,4,0.5
1936,"Gateshead",3,42,43,63,98,-35,1.02380952380952,1.5,2.33333333333333,-0.833333333333333,83,39,44,88,53,23,30,3.2
1936,"Gillingham",3,42,62,52,66,-14,1.47619047619048,1.23809523809524,1.57142857142857,-0.333333333333333,62,18,44,88,88,88,-26,-1.7
1936,"Grimsby Town",1,42,58,86,81,5,1.38095238095238,2.04761904761905,1.92857142857143,0.119047619047619,10,10,22,22,17,110,-7,-6.8
1936,"Halifax Town",3,42,63,68,63,5,1.5,1.61904761904762,1.5,0.119047619047619,58,14,44,88,80,69,-22,-3.1
1936,"Hartlepool United",3,42,64,75,69,6,1.52380952380952,1.78571428571429,1.64285714285714,0.142857142857143,56,12,44,88,84,89,-28,-2.9
1936,"Huddersfield Town",1,42,51,62,64,-2,1.21428571428571,1.47619047619048,1.52380952380952,-0.0476190476190476,17,17,22,22,11,99,6,1.4
1936,"Hull City",3,42,63,68,69,-1,1.5,1.61904761904762,1.64285714285714,-0.0238095238095238,59,15,44,88,51,104,8,2.5
1936,"Leeds United",1,42,49,60,80,-20,1.16666666666667,1.42857142857143,1.9047619047619,-0.476190476190476,18,18,22,22,9,93,9,-1.4
1936,"Leicester City",2,42,80,89,57,32,1.9047619047619,2.11904761904762,1.35714285714286,0.761904761904762,23,1,22,44,16,115,7,0
1936,"Leyton Orient",3,42,57,52,52,0,1.35714285714286,1.23809523809524,1.23809523809524,0,69,25,44,88,81,102,-12,0.4
1936,"Lincoln City",3,42,82,103,57,46,1.95238095238095,2.45238095238095,1.35714285714286,1.0952380952381,47,3,44,88,58,107,-11,0.9
1936,"Liverpool",1,42,47,62,84,-22,1.11904761904762,1.47619047619048,2,-0.523809523809524,19,19,22,22,12,116,7,-0.3
1936,"Luton Town",3,42,85,103,53,50,2.02380952380952,2.45238095238095,1.26190476190476,1.19047619047619,45,1,44,88,34,91,11,1.7
1936,"Manchester City",1,42,79,107,61,46,1.88095238095238,2.54761904761905,1.45238095238095,1.0952380952381,1,1,22,22,20,117,-19,-1.6
1936,"Manchester United",1,42,42,55,78,-23,1,1.30952380952381,1.85714285714286,-0.547619047619048,21,21,22,22,24,117,-3,1.4
1936,"Mansfield Town",3,42,62,91,76,15,1.47619047619048,2.16666666666667,1.80952380952381,0.357142857142857,63,19,44,88,70,77,-7,0.6
1936,"Middlesbrough",1,42,65,74,71,3,1.54761904761905,1.76190476190476,1.69047619047619,0.0714285714285714,6,6,22,22,3,110,3,-1.5
1936,"Millwall",3,42,64,64,54,10,1.52380952380952,1.52380952380952,1.28571428571429,0.238095238095238,57,13,44,88,45,93,12,-0.7
1936,"New Brighton",3,42,50,55,70,-15,1.19047619047619,1.30952380952381,1.66666666666667,-0.357142857142857,74,30,44,88,71,21,3,NA
1936,"Newcastle United",2,42,71,80,56,24,1.69047619047619,1.9047619047619,1.33333333333333,0.571428571428571,26,4,22,44,41,116,-15,1
1936,"Newport County",3,42,46,67,98,-31,1.0952380952381,1.5952380952381,2.33333333333333,-0.738095238095238,81,37,44,88,79,67,2,1.3
1936,"Northampton Town",3,42,66,85,68,17,1.57142857142857,2.02380952380952,1.61904761904762,0.404761904761905,55,11,44,88,62,93,-7,-0.3
1936,"Norwich City",2,42,50,63,71,-8,1.19047619047619,1.5,1.69047619047619,-0.19047619047619,39,17,22,44,37,93,2,-2
1936,"Nottingham Forest",2,42,46,68,90,-22,1.0952380952381,1.61904761904762,2.14285714285714,-0.523809523809524,40,18,22,44,42,117,-2,1.4
1936,"Notts County",3,42,79,74,52,22,1.88095238095238,1.76190476190476,1.23809523809524,0.523809523809524,48,4,44,88,66,120,-18,1.1
1936,"Oldham Athletic",3,42,71,77,59,18,1.69047619047619,1.83333333333333,1.4047619047619,0.428571428571429,51,7,44,88,55,102,-4,0.7
1936,"Plymouth Argyle",2,42,67,71,53,18,1.5952380952381,1.69047619047619,1.26190476190476,0.428571428571429,28,6,22,44,35,93,-7,-1.4
1936,"Port Vale",3,42,61,58,64,-6,1.45238095238095,1.38095238095238,1.52380952380952,-0.142857142857143,65,21,44,88,76,107,-11,2
1936,"Portsmouth",1,42,61,62,66,-4,1.45238095238095,1.47619047619048,1.57142857142857,-0.0952380952380952,9,9,22,22,18,93,-9,-0.5
1936,"Preston North End",1,42,55,56,67,-11,1.30952380952381,1.33333333333333,1.5952380952381,-0.261904761904762,13,13,22,22,4,121,9,0.3
1936,"Queens Park Rangers",3,42,63,73,52,21,1.5,1.73809523809524,1.23809523809524,0.5,60,16,44,88,49,93,11,-1.6
1936,"Reading",3,42,68,76,60,16,1.61904761904762,1.80952380952381,1.42857142857143,0.380952380952381,53,9,44,88,54,93,-1,-0.7
1936,"Rochdale",3,42,48,69,86,-17,1.14285714285714,1.64285714285714,2.04761904761905,-0.404761904761905,80,36,44,88,77,92,3,-0.1
1936,"Rotherham United",3,42,49,78,91,-13,1.16666666666667,1.85714285714286,2.16666666666667,-0.30952380952381,77,33,44,88,56,88,21,5
1936,"Sheffield United",2,42,64,66,54,12,1.52380952380952,1.57142857142857,1.28571428571429,0.285714285714286,29,7,22,44,25,117,4,0.9
1936,"Sheffield Wednesday",1,42,39,53,69,-16,0.928571428571429,1.26190476190476,1.64285714285714,-0.380952380952381,22,22,22,22,39,117,-17,0.4
1936,"Southampton",2,42,45,53,77,-24,1.07142857142857,1.26190476190476,1.83333333333333,-0.571428571428571,42,20,22,44,36,93,6,-1.1
1936,"Southend United",3,42,62,78,67,11,1.47619047619048,1.85714285714286,1.5952380952381,0.261904761904762,64,20,44,88,67,93,-3,-0.7
1936,"Southport",3,42,49,73,87,-14,1.16666666666667,1.73809523809524,2.07142857142857,-0.333333333333333,78,34,44,88,78,50,0,0.9
1936,"Stockport County",3,42,83,84,39,45,1.97619047619048,2,0.928571428571429,1.07142857142857,46,2,44,88,44,99,2,-2
1936,"Stoke City",1,42,57,72,57,15,1.35714285714286,1.71428571428571,1.35714285714286,0.357142857142857,11,11,22,22,19,113,-8,-2.5
1936,"Sunderland",1,42,63,89,87,2,1.5,2.11904761904762,2.07142857142857,0.0476190476190476,8,8,22,22,8,119,0,-1.1
1936,"Swansea City",2,42,52,50,65,-15,1.23809523809524,1.19047619047619,1.54761904761905,-0.357142857142857,38,16,22,44,40,93,-2,-0.3
1936,"Swindon Town",3,42,53,75,73,2,1.26190476190476,1.78571428571429,1.73809523809524,0.0476190476190476,70,26,44,88,60,93,10,-1.2
1936,"Torquay United",3,42,43,57,80,-23,1.02380952380952,1.35714285714286,1.9047619047619,-0.547619047619048,84,40,44,88,87,78,-3,1.4
1936,"Tottenham Hotspur",2,42,60,88,66,22,1.42857142857143,2.0952380952381,1.57142857142857,0.523809523809524,32,10,22,44,27,101,5,1.7
1936,"Tranmere Rovers",3,42,45,71,88,-17,1.07142857142857,1.69047619047619,2.0952380952381,-0.404761904761905,82,38,44,88,46,89,36,1
1936,"Walsall",3,42,49,63,85,-22,1.16666666666667,1.5,2.02380952380952,-0.523809523809524,79,35,44,88,86,100,-7,-1.3
1936,"Watford",3,42,68,85,60,25,1.61904761904762,2.02380952380952,1.42857142857143,0.595238095238095,54,10,44,88,50,93,4,0
1936,"West Bromwich Albion",1,42,54,77,98,-21,1.28571428571429,1.83333333333333,2.33333333333333,-0.5,15,15,22,22,21,121,-6,1.3
1936,"West Ham United",2,42,68,73,55,18,1.61904761904762,1.73809523809524,1.30952380952381,0.428571428571429,27,5,22,44,33,94,-6,-0.8
1936,"Wolverhampton Wanderers",1,42,68,84,67,17,1.61904761904762,2,1.5952380952381,0.404761904761905,5,5,22,22,2,121,3,0.4
1936,"Wrexham",3,42,60,71,57,14,1.42857142857143,1.69047619047619,1.35714285714286,0.333333333333333,66,22,44,88,63,80,3,1.1
1936,"York City",3,42,59,79,70,9,1.4047619047619,1.88095238095238,1.66666666666667,0.214285714285714,67,23,44,88,64,72,3,-2.1
1937,"Accrington Stanley",3,42,40,45,75,-30,0.952380952380952,1.07142857142857,1.78571428571429,-0.714285714285714,85,41,44,88,88,34,-3,3.7
1937,"AFC Bournemouth",3,42,54,56,57,-1,1.28571428571429,1.33333333333333,1.35714285714286,-0.0238095238095238,68,24,44,88,76,90,-8,-1
1937,"Aldershot",3,42,50,39,59,-20,1.19047619047619,0.928571428571429,1.4047619047619,-0.476190476190476,75,31,44,88,59,57,16,0.4
1937,"Arsenal",1,42,73,77,44,33,1.73809523809524,1.83333333333333,1.04761904761905,0.785714285714286,1,1,22,22,5,116,-4,-0.7
1937,"Aston Villa",2,42,82,73,35,38,1.95238095238095,1.73809523809524,0.833333333333333,0.904761904761905,23,1,22,44,11,121,12,2.1
1937,"Barnsley",2,42,47,50,64,-14,1.11904761904762,1.19047619047619,1.52380952380952,-0.333333333333333,43,21,22,44,45,111,-2,-0.3
1937,"Barrow",3,42,43,41,71,-30,1.02380952380952,0.976190476190476,1.69047619047619,-0.714285714285714,82,38,44,88,67,44,15,0.7
1937,"Birmingham City",1,42,48,58,62,-4,1.14285714285714,1.38095238095238,1.47619047619048,-0.0952380952380952,22,22,22,22,21,117,1,-0.3
1937,"Blackburn Rovers",2,42,52,71,80,-9,1.23809523809524,1.69047619047619,1.9047619047619,-0.214285714285714,38,16,22,44,23,121,15,1
1937,"Blackpool",1,42,56,61,66,-5,1.33333333333333,1.45238095238095,1.57142857142857,-0.119047619047619,10,10,22,22,15,112,-5,-0.8
1937,"Bolton Wanderers",1,42,60,64,60,4,1.42857142857143,1.52380952380952,1.42857142857143,0.0952380952380952,7,7,22,22,8,121,-1,-1.2
1937,"Bradford City",3,42,52,66,69,-3,1.23809523809524,1.57142857142857,1.64285714285714,-0.0714285714285714,72,28,44,88,48,106,24,-1.1
1937,"Bradford Park Avenue",2,42,60,69,56,13,1.42857142857143,1.64285714285714,1.33333333333333,0.30952380952381,29,7,22,44,40,51,-11,-4.7
1937,"Brentford",1,42,63,69,59,10,1.5,1.64285714285714,1.4047619047619,0.238095238095238,5,5,22,22,16,93,-11,-6.5
1937,"Brighton & Hove Albion",3,42,72,64,44,20,1.71428571428571,1.52380952380952,1.04761904761905,0.476190476190476,52,8,44,88,53,93,-1,-0.5
1937,"Bristol City",3,42,76,68,40,28,1.80952380952381,1.61904761904762,0.952380952380952,0.666666666666667,47,3,44,88,60,108,-13,0.2
1937,"Bristol Rovers",3,42,52,46,61,-15,1.23809523809524,1.0952380952381,1.45238095238095,-0.357142857142857,73,29,44,88,86,92,-13,4.3
1937,"Burnley",2,42,61,54,54,0,1.45238095238095,1.28571428571429,1.28571428571429,0,28,6,22,44,36,121,-8,1.9
1937,"Bury",2,42,59,63,60,3,1.4047619047619,1.5,1.42857142857143,0.0714285714285714,30,8,22,44,38,114,-8,-0.5
1937,"Cardiff City",3,42,57,67,54,13,1.35714285714286,1.5952380952381,1.28571428571429,0.30952380952381,65,21,44,88,69,93,-4,4.5
1937,"Carlisle United",3,42,54,57,67,-10,1.28571428571429,1.35714285714286,1.5952380952381,-0.238095238095238,69,25,44,88,80,84,-11,-1.1
1937,"Charlton Athletic",1,42,62,65,51,14,1.47619047619048,1.54761904761905,1.21428571428571,0.333333333333333,6,6,22,22,3,92,3,-1
1937,"Chelsea",1,42,55,65,65,0,1.30952380952381,1.54761904761905,1.54761904761905,0,13,13,22,22,20,104,-7,1.2
1937,"Chester",3,42,60,77,72,5,1.42857142857143,1.83333333333333,1.71428571428571,0.119047619047619,61,17,44,88,52,67,9,-2.8
1937,"Chesterfield",2,42,57,63,63,0,1.35714285714286,1.5,1.5,0,32,10,22,44,29,100,3,-2.1
1937,"Coventry City",2,42,72,66,45,21,1.71428571428571,1.57142857142857,1.07142857142857,0.5,26,4,22,44,26,94,0,-3.7
1937,"Crewe Alexandra",3,42,63,71,53,18,1.5,1.69047619047619,1.26190476190476,0.428571428571429,59,15,44,88,55,96,4,-3.1
1937,"Crystal Palace",3,42,66,67,47,20,1.57142857142857,1.5952380952381,1.11904761904762,0.476190476190476,57,13,44,88,49,93,8,-2.7
1937,"Darlington",3,42,43,54,79,-25,1.02380952380952,1.28571428571429,1.88095238095238,-0.595238095238095,83,39,44,88,81,81,2,0.6
1937,"Derby County",1,42,55,66,87,-21,1.30952380952381,1.57142857142857,2.07142857142857,-0.5,14,14,22,22,6,121,8,-3
1937,"Doncaster Rovers",3,42,75,74,49,25,1.78571428571429,1.76190476190476,1.16666666666667,0.595238095238095,48,4,44,88,46,88,2,1
1937,"Everton",1,42,55,79,75,4,1.30952380952381,1.88095238095238,1.78571428571429,0.0952380952380952,15,15,22,22,1,121,14,0.4
1937,"Exeter City",3,42,51,57,70,-13,1.21428571428571,1.35714285714286,1.66666666666667,-0.30952380952381,74,30,44,88,74,88,0,-1.2
1937,"Fulham",2,42,59,61,57,4,1.4047619047619,1.45238095238095,1.35714285714286,0.0952380952380952,31,9,22,44,33,102,-2,-0.6
1937,"Gateshead",3,42,71,84,59,25,1.69047619047619,2,1.4047619047619,0.595238095238095,53,9,44,88,70,23,-17,-0.2
1937,"Gillingham",3,42,36,36,77,-41,0.857142857142857,0.857142857142857,1.83333333333333,-0.976190476190476,88,44,44,88,86,88,2,1.4
1937,"Grimsby Town",1,42,51,51,68,-17,1.21428571428571,1.21428571428571,1.61904761904762,-0.404761904761905,17,17,22,22,10,110,7,-7.1
1937,"Halifax Town",3,42,48,44,66,-22,1.14285714285714,1.04761904761905,1.57142857142857,-0.523809523809524,80,36,44,88,71,69,9,0.7
1937,"Hartlepool United",3,42,42,53,80,-27,1,1.26190476190476,1.9047619047619,-0.642857142857143,84,40,44,88,87,89,-3,3.2
1937,"Huddersfield Town",1,42,56,55,68,-13,1.33333333333333,1.30952380952381,1.61904761904762,-0.30952380952381,11,11,22,22,19,99,-8,-0.6
1937,"Hull City",3,42,73,80,43,37,1.73809523809524,1.9047619047619,1.02380952380952,0.880952380952381,51,7,44,88,54,104,-3,1
1937,"Leeds United",1,42,57,64,69,-5,1.35714285714286,1.52380952380952,1.64285714285714,-0.119047619047619,9,9,22,22,12,93,-3,-1.7
1937,"Leicester City",1,42,53,54,75,-21,1.26190476190476,1.28571428571429,1.78571428571429,-0.5,16,16,22,22,22,115,-6,-0.5
1937,"Leyton Orient",3,42,46,42,61,-19,1.0952380952381,1,1.45238095238095,-0.452380952380952,81,37,44,88,82,102,-1,3.4
1937,"Lincoln City",3,42,65,66,50,16,1.54761904761905,1.57142857142857,1.19047619047619,0.380952380952381,58,14,44,88,83,107,-25,1.9
1937,"Liverpool",1,42,56,65,71,-6,1.33333333333333,1.54761904761905,1.69047619047619,-0.142857142857143,12,12,22,22,13,116,-1,-2.2
1937,"Luton Town",2,42,55,89,86,3,1.30952380952381,2.11904761904762,2.04761904761905,0.0714285714285714,34,12,22,44,27,91,7,1
1937,"Manchester City",1,42,50,80,77,3,1.19047619047619,1.9047619047619,1.83333333333333,0.0714285714285714,20,20,22,22,28,117,-8,1.4
1937,"Manchester United",2,42,75,82,50,32,1.78571428571429,1.95238095238095,1.19047619047619,0.761904761904762,24,2,22,44,17,117,7,2.1
1937,"Mansfield Town",3,42,54,62,67,-5,1.28571428571429,1.47619047619048,1.5952380952381,-0.119047619047619,70,26,44,88,77,77,-7,0.2
1937,"Middlesbrough",1,42,65,72,65,7,1.54761904761905,1.71428571428571,1.54761904761905,0.166666666666667,3,3,22,22,4,110,-1,-2.9
1937,"Millwall",3,42,79,83,37,46,1.88095238095238,1.97619047619048,0.880952380952381,1.0952380952381,45,1,44,88,35,93,10,-1.1
1937,"New Brighton",3,42,53,60,61,-1,1.26190476190476,1.42857142857143,1.45238095238095,-0.0238095238095238,71,27,44,88,72,21,-1,NA
1937,"Newcastle United",2,42,50,51,58,-7,1.19047619047619,1.21428571428571,1.38095238095238,-0.166666666666667,41,19,22,44,31,116,10,3.1
1937,"Newport County",3,42,49,43,52,-9,1.16666666666667,1.02380952380952,1.23809523809524,-0.214285714285714,79,35,44,88,47,67,32,-0.6
1937,"Northampton Town",3,42,60,51,57,-6,1.42857142857143,1.21428571428571,1.35714285714286,-0.142857142857143,62,18,44,88,75,93,-13,-0.2
1937,"Norwich City",2,42,53,56,75,-19,1.26190476190476,1.33333333333333,1.78571428571429,-0.452380952380952,37,15,22,44,42,93,-5,-2.9
1937,"Nottingham Forest",2,42,50,47,60,-13,1.19047619047619,1.11904761904762,1.42857142857143,-0.30952380952381,42,20,22,44,43,117,-1,0.6
1937,"Notts County",3,42,57,50,50,0,1.35714285714286,1.19047619047619,1.19047619047619,0,66,22,44,88,62,120,4,3.7
1937,"Oldham Athletic",3,42,70,67,46,21,1.66666666666667,1.5952380952381,1.0952380952381,0.5,55,11,44,88,50,102,5,-0.5
1937,"Plymouth Argyle",2,42,54,57,65,-8,1.28571428571429,1.35714285714286,1.54761904761905,-0.19047619047619,35,13,22,44,37,93,-2,-0.7
1937,"Port Vale",3,42,50,65,73,-8,1.19047619047619,1.54761904761905,1.73809523809524,-0.19047619047619,76,32,44,88,78,107,-2,3.6
1937,"Portsmouth",1,42,51,62,68,-6,1.21428571428571,1.47619047619048,1.61904761904762,-0.142857142857143,18,18,22,22,18,93,0,1.3
1937,"Preston North End",1,42,65,64,44,20,1.54761904761905,1.52380952380952,1.04761904761905,0.476190476190476,4,4,22,22,9,121,-5,-0.9
1937,"Queens Park Rangers",3,42,75,80,47,33,1.78571428571429,1.9047619047619,1.11904761904762,0.785714285714286,49,5,44,88,64,93,-15,-2.3
1937,"Reading",3,42,71,71,63,8,1.69047619047619,1.69047619047619,1.5,0.19047619047619,54,10,44,88,57,93,-3,-2.5
1937,"Rochdale",3,42,50,67,78,-11,1.19047619047619,1.5952380952381,1.85714285714286,-0.261904761904762,77,33,44,88,73,92,4,1.2
1937,"Rotherham United",3,42,70,68,56,12,1.66666666666667,1.61904761904762,1.33333333333333,0.285714285714286,56,12,44,88,65,88,-9,3.3
1937,"Sheffield United",2,42,75,73,56,17,1.78571428571429,1.73809523809524,1.33333333333333,0.404761904761905,25,3,22,44,24,117,1,1.3
1937,"Sheffield Wednesday",2,42,52,49,56,-7,1.23809523809524,1.16666666666667,1.33333333333333,-0.166666666666667,39,17,22,44,25,117,14,1.7
1937,"Southampton",2,42,54,55,77,-22,1.28571428571429,1.30952380952381,1.83333333333333,-0.523809523809524,36,14,22,44,39,93,-3,-1.3
1937,"Southend United",3,42,55,70,68,2,1.30952380952381,1.66666666666667,1.61904761904762,0.0476190476190476,67,23,44,88,68,93,-1,-0.2
1937,"Southport",3,42,50,53,82,-29,1.19047619047619,1.26190476190476,1.95238095238095,-0.69047619047619,78,34,44,88,51,50,27,1.1
1937,"Stockport County",2,42,42,43,70,-27,1,1.02380952380952,1.66666666666667,-0.642857142857143,44,22,22,44,63,99,-19,-1.7
1937,"Stoke City",1,42,51,58,59,-1,1.21428571428571,1.38095238095238,1.4047619047619,-0.0238095238095238,19,19,22,22,7,113,12,-0.8
1937,"Sunderland",1,42,58,55,57,-2,1.38095238095238,1.30952380952381,1.35714285714286,-0.0476190476190476,8,8,22,22,14,119,-6,0.1
1937,"Swansea City",2,42,51,45,73,-28,1.21428571428571,1.07142857142857,1.73809523809524,-0.666666666666667,40,18,22,44,41,93,-1,0.7
1937,"Swindon Town",3,42,61,49,49,0,1.45238095238095,1.16666666666667,1.16666666666667,0,60,16,44,88,58,93,2,-2.7
1937,"Torquay United",3,42,39,38,73,-35,0.928571428571429,0.904761904761905,1.73809523809524,-0.833333333333333,87,43,44,88,79,78,8,2.5
1937,"Tottenham Hotspur",2,42,63,76,54,22,1.5,1.80952380952381,1.28571428571429,0.523809523809524,27,5,22,44,30,101,-3,1.3
1937,"Tranmere Rovers",3,42,79,81,41,40,1.88095238095238,1.92857142857143,0.976190476190476,0.952380952380952,46,2,44,88,44,89,2,-3.6
1937,"Walsall",3,42,40,52,88,-36,0.952380952380952,1.23809523809524,2.0952380952381,-0.857142857142857,86,42,44,88,84,100,2,-0.5
1937,"Watford",3,42,74,73,43,30,1.76190476190476,1.73809523809524,1.02380952380952,0.714285714285714,50,6,44,88,56,93,-6,-0.8
1937,"West Bromwich Albion",1,42,50,74,91,-17,1.19047619047619,1.76190476190476,2.16666666666667,-0.404761904761905,21,21,22,22,32,121,-11,0.6
1937,"West Ham United",2,42,56,53,52,1,1.33333333333333,1.26190476190476,1.23809523809524,0.0238095238095238,33,11,22,44,34,94,-1,0.2
1937,"Wolverhampton Wanderers",1,42,71,72,49,23,1.69047619047619,1.71428571428571,1.16666666666667,0.547619047619048,2,2,22,22,2,121,0,-0.2
1937,"Wrexham",3,42,59,58,63,-5,1.4047619047619,1.38095238095238,1.5,-0.119047619047619,63,19,44,88,66,80,-3,-1.8
1937,"York City",3,42,58,70,68,2,1.38095238095238,1.66666666666667,1.61904761904762,0.0476190476190476,64,20,44,88,85,72,-21,1.4
1938,"Accrington Stanley",3,42,27,49,103,-54,0.642857142857143,1.16666666666667,2.45238095238095,-1.28571428571429,88,44,44,88,81,34,7,3.8
1938,"AFC Bournemouth",3,42,52,52,58,-6,1.23809523809524,1.23809523809524,1.38095238095238,-0.142857142857143,76,32,44,88,57,90,19,1.5
1938,"Aldershot",3,42,60,53,66,-13,1.42857142857143,1.26190476190476,1.57142857142857,-0.30952380952381,59,15,44,88,84,57,-25,-2.5
1938,"Arsenal",1,42,66,55,41,14,1.57142857142857,1.30952380952381,0.976190476190476,0.333333333333333,5,5,22,22,13,116,-8,0.1
1938,"Aston Villa",1,42,57,71,60,11,1.35714285714286,1.69047619047619,1.42857142857143,0.261904761904762,11,11,22,22,8,121,3,-1
1938,"Barnsley",3,42,97,94,34,60,2.30952380952381,2.23809523809524,0.80952380952381,1.42857142857143,45,1,44,88,32,111,13,0.5
1938,"Barrow",3,42,57,66,65,1,1.35714285714286,1.57142857142857,1.54761904761905,0.0238095238095238,67,23,44,88,63,44,4,-2.3
1938,"Birmingham City",1,42,44,62,84,-22,1.04761904761905,1.47619047619048,2,-0.523809523809524,21,21,22,22,24,117,-3,1.5
1938,"Blackburn Rovers",2,42,80,94,60,34,1.9047619047619,2.23809523809524,1.42857142857143,0.80952380952381,23,1,22,44,17,121,6,-0.2
1938,"Blackpool",1,42,50,56,68,-12,1.19047619047619,1.33333333333333,1.61904761904762,-0.285714285714286,15,15,22,22,5,112,10,1.3
1938,"Bolton Wanderers",1,42,60,67,58,9,1.42857142857143,1.5952380952381,1.38095238095238,0.214285714285714,8,8,22,22,18,121,-10,0
1938,"Bradford City",3,42,74,89,56,33,1.76190476190476,2.11904761904762,1.33333333333333,0.785714285714286,48,4,44,88,52,106,-4,-1.4
1938,"Bradford Park Avenue",2,42,47,61,82,-21,1.11904761904762,1.45238095238095,1.95238095238095,-0.5,40,18,22,44,38,51,2,-4.8
1938,"Brentford",1,42,50,53,74,-21,1.19047619047619,1.26190476190476,1.76190476190476,-0.5,16,16,22,22,21,93,-5,-4.1
1938,"Brighton & Hove Albion",3,42,68,68,49,19,1.61904761904762,1.61904761904762,1.16666666666667,0.452380952380952,53,9,44,88,75,93,-22,0.6
1938,"Bristol City",3,42,60,61,63,-2,1.42857142857143,1.45238095238095,1.5,-0.0476190476190476,60,16,44,88,51,108,9,2.8
1938,"Bristol Rovers",3,42,43,55,61,-6,1.02380952380952,1.30952380952381,1.45238095238095,-0.142857142857143,86,42,44,88,66,92,20,6
1938,"Burnley",2,42,54,50,56,-6,1.28571428571429,1.19047619047619,1.33333333333333,-0.142857142857143,36,14,22,44,25,121,11,2.9
1938,"Bury",2,42,49,65,74,-9,1.16666666666667,1.54761904761905,1.76190476190476,-0.214285714285714,38,16,22,44,40,114,-2,0.2
1938,"Cardiff City",3,42,56,61,65,-4,1.33333333333333,1.45238095238095,1.54761904761905,-0.0952380952380952,69,25,44,88,46,93,23,5.3
1938,"Carlisle United",3,42,46,66,111,-45,1.0952380952381,1.57142857142857,2.64285714285714,-1.07142857142857,80,36,44,88,76,84,4,0.2
1938,"Charlton Athletic",1,42,72,75,59,16,1.71428571428571,1.78571428571429,1.4047619047619,0.380952380952381,3,3,22,22,20,92,-17,-1
1938,"Chelsea",1,42,45,64,80,-16,1.07142857142857,1.52380952380952,1.9047619047619,-0.380952380952381,20,20,22,22,15,104,5,0.3
1938,"Chester",3,42,69,88,70,18,1.64285714285714,2.0952380952381,1.66666666666667,0.428571428571429,52,8,44,88,48,67,4,-2.7
1938,"Chesterfield",2,42,69,69,52,17,1.64285714285714,1.64285714285714,1.23809523809524,0.404761904761905,29,7,22,44,26,100,3,-2.4
1938,"Coventry City",2,42,71,62,45,17,1.69047619047619,1.47619047619048,1.07142857142857,0.404761904761905,26,4,22,44,30,94,-4,-3.3
1938,"Crewe Alexandra",3,42,63,82,70,12,1.5,1.95238095238095,1.66666666666667,0.285714285714286,55,11,44,88,60,96,-5,-3.7
1938,"Crystal Palace",3,42,72,71,52,19,1.71428571428571,1.69047619047619,1.23809523809524,0.452380952380952,49,5,44,88,79,93,-30,-4
1938,"Darlington",3,42,46,62,92,-30,1.0952380952381,1.47619047619048,2.19047619047619,-0.714285714285714,81,37,44,88,77,81,4,0.8
1938,"Derby County",1,42,65,66,55,11,1.54761904761905,1.57142857142857,1.30952380952381,0.261904761904762,6,6,22,22,11,121,-5,-4.2
1938,"Doncaster Rovers",3,42,77,87,47,40,1.83333333333333,2.07142857142857,1.11904761904762,0.952380952380952,46,2,44,88,45,88,1,0.7
1938,"Everton",1,42,86,88,52,36,2.04761904761905,2.0952380952381,1.23809523809524,0.857142857142857,1,1,22,22,10,121,-9,-1.4
1938,"Exeter City",3,42,53,65,82,-17,1.26190476190476,1.54761904761905,1.95238095238095,-0.404761904761905,74,30,44,88,72,88,2,-0.1
1938,"Fulham",2,42,61,61,55,6,1.45238095238095,1.45238095238095,1.30952380952381,0.142857142857143,33,11,22,44,36,102,-3,0.4
1938,"Gateshead",3,42,56,74,67,7,1.33333333333333,1.76190476190476,1.5952380952381,0.166666666666667,70,26,44,88,73,23,-3,0
1938,"Grimsby Town",1,42,59,61,69,-8,1.4047619047619,1.45238095238095,1.64285714285714,-0.19047619047619,10,10,22,22,16,110,-6,-3.5
1938,"Halifax Town",3,42,55,52,54,-2,1.30952380952381,1.23809523809524,1.28571428571429,-0.0476190476190476,71,27,44,88,88,69,-17,-0.9
1938,"Hartlepool United",3,42,43,55,94,-39,1.02380952380952,1.30952380952381,2.23809523809524,-0.928571428571429,87,43,44,88,74,89,13,3.6
1938,"Huddersfield Town",1,42,47,58,64,-6,1.11904761904762,1.38095238095238,1.52380952380952,-0.142857142857143,19,19,22,22,19,99,0,-0.1
1938,"Hull City",3,42,64,83,74,9,1.52380952380952,1.97619047619048,1.76190476190476,0.214285714285714,54,10,44,88,67,104,-13,1
1938,"Ipswich Town",3,42,60,62,52,10,1.42857142857143,1.47619047619048,1.23809523809524,0.238095238095238,61,17,44,88,58,75,3,1.2
1938,"Leeds United",1,42,57,59,67,-8,1.35714285714286,1.4047619047619,1.5952380952381,-0.19047619047619,12,12,22,22,22,93,-10,-1.2
1938,"Leicester City",1,42,38,48,82,-34,0.904761904761905,1.14285714285714,1.95238095238095,-0.80952380952381,22,22,22,22,31,115,-9,-0.5
1938,"Leyton Orient",3,42,46,53,55,-2,1.0952380952381,1.26190476190476,1.30952380952381,-0.0476190476190476,82,38,44,88,82,102,0,3.6
1938,"Lincoln City",3,42,45,66,92,-26,1.07142857142857,1.57142857142857,2.19047619047619,-0.619047619047619,83,39,44,88,68,107,15,5
1938,"Liverpool",1,42,56,62,63,-1,1.33333333333333,1.47619047619048,1.5,-0.0238095238095238,13,13,22,22,1,116,12,-1.5
1938,"Luton Town",2,42,71,82,66,16,1.69047619047619,1.95238095238095,1.57142857142857,0.380952380952381,27,5,22,44,34,91,-7,1.7
1938,"Manchester City",2,42,70,96,72,24,1.66666666666667,2.28571428571429,1.71428571428571,0.571428571428571,28,6,22,44,23,117,5,2.3
1938,"Manchester United",1,42,49,57,65,-8,1.16666666666667,1.35714285714286,1.54761904761905,-0.19047619047619,17,17,22,22,4,117,13,1.6
1938,"Mansfield Town",3,42,51,44,62,-18,1.21428571428571,1.04761904761905,1.47619047619048,-0.428571428571429,77,33,44,88,86,77,-9,-0.4
1938,"Middlesbrough",1,42,69,93,74,19,1.64285714285714,2.21428571428571,1.76190476190476,0.452380952380952,4,4,22,22,12,110,-8,-3.3
1938,"Millwall",2,42,56,64,53,11,1.33333333333333,1.52380952380952,1.26190476190476,0.261904761904762,35,13,22,44,39,93,-4,-5
1938,"New Brighton",3,42,54,68,73,-5,1.28571428571429,1.61904761904762,1.73809523809524,-0.119047619047619,72,28,44,88,80,21,-8,NA
1938,"Newcastle United",2,42,64,61,48,13,1.52380952380952,1.45238095238095,1.14285714285714,0.30952380952381,31,9,22,44,28,116,3,1.9
1938,"Newport County",3,42,77,58,45,13,1.83333333333333,1.38095238095238,1.07142857142857,0.30952380952381,47,3,44,88,44,67,3,-2.9
1938,"Northampton Town",3,42,53,51,58,-7,1.26190476190476,1.21428571428571,1.38095238095238,-0.166666666666667,75,31,44,88,70,93,5,1.1
1938,"Norwich City",2,42,44,50,91,-41,1.04761904761905,1.19047619047619,2.16666666666667,-0.976190476190476,42,20,22,44,85,93,-43,-1.6
1938,"Nottingham Forest",2,42,41,49,82,-33,0.976190476190476,1.16666666666667,1.95238095238095,-0.785714285714286,43,21,22,44,35,117,8,1.3
1938,"Notts County",3,42,60,59,54,5,1.42857142857143,1.4047619047619,1.28571428571429,0.119047619047619,62,18,44,88,71,120,-9,2
1938,"Oldham Athletic",3,42,71,76,59,17,1.69047619047619,1.80952380952381,1.4047619047619,0.404761904761905,50,6,44,88,83,102,-33,-3.7
1938,"Plymouth Argyle",2,42,53,49,55,-6,1.26190476190476,1.16666666666667,1.30952380952381,-0.142857142857143,37,15,22,44,41,93,-4,-0.6
1938,"Port Vale",3,42,51,52,58,-6,1.21428571428571,1.23809523809524,1.38095238095238,-0.142857142857143,78,34,44,88,61,107,17,4.3
1938,"Portsmouth",1,42,49,47,70,-23,1.16666666666667,1.11904761904762,1.66666666666667,-0.547619047619048,18,18,22,22,14,93,4,0.4
1938,"Preston North End",1,42,60,63,59,4,1.42857142857143,1.5,1.4047619047619,0.0952380952380952,9,9,22,22,7,121,2,-1
1938,"Queens Park Rangers",3,42,59,68,49,19,1.4047619047619,1.61904761904762,1.16666666666667,0.452380952380952,64,20,44,88,49,93,15,-1.8
1938,"Reading",3,42,62,69,59,10,1.47619047619048,1.64285714285714,1.4047619047619,0.238095238095238,57,13,44,88,62,93,-5,-2
1938,"Rochdale",3,42,54,92,82,10,1.28571428571429,2.19047619047619,1.95238095238095,0.238095238095238,73,29,44,88,54,92,19,0.5
1938,"Rotherham United",3,42,59,64,64,0,1.4047619047619,1.52380952380952,1.52380952380952,0,65,21,44,88,47,88,18,2.4
1938,"Sheffield United",2,42,74,69,41,28,1.76190476190476,1.64285714285714,0.976190476190476,0.666666666666667,24,2,22,44,6,117,18,0.2
1938,"Sheffield Wednesday",2,42,74,88,59,29,1.76190476190476,2.0952380952381,1.4047619047619,0.69047619047619,25,3,22,44,42,117,-17,0.2
1938,"Southampton",2,42,48,56,82,-26,1.14285714285714,1.33333333333333,1.95238095238095,-0.619047619047619,39,17,22,44,37,93,2,-3.2
1938,"Southend United",3,42,57,61,64,-3,1.35714285714286,1.45238095238095,1.52380952380952,-0.0714285714285714,68,24,44,88,59,93,9,1.4
1938,"Southport",3,42,70,75,54,21,1.66666666666667,1.78571428571429,1.28571428571429,0.5,51,7,44,88,87,50,-36,-0.1
1938,"Stockport County",3,42,60,91,77,14,1.42857142857143,2.16666666666667,1.83333333333333,0.333333333333333,63,19,44,88,50,99,13,0.8
1938,"Stoke City",1,42,63,71,68,3,1.5,1.69047619047619,1.61904761904762,0.0714285714285714,7,7,22,22,3,113,4,-2.7
1938,"Sunderland",1,42,51,54,67,-13,1.21428571428571,1.28571428571429,1.5952380952381,-0.30952380952381,14,14,22,22,9,119,5,0.5
1938,"Swansea City",2,42,45,50,83,-33,1.07142857142857,1.19047619047619,1.97619047619048,-0.785714285714286,41,19,22,44,43,93,-2,1
1938,"Swindon Town",3,42,62,72,77,-5,1.47619047619048,1.71428571428571,1.83333333333333,-0.119047619047619,58,14,44,88,53,93,5,-3.3
1938,"Torquay United",3,42,51,54,70,-16,1.21428571428571,1.28571428571429,1.66666666666667,-0.380952380952381,79,35,44,88,65,78,14,2.3
1938,"Tottenham Hotspur",2,42,66,67,62,5,1.57142857142857,1.5952380952381,1.47619047619048,0.119047619047619,30,8,22,44,29,101,1,1.2
1938,"Tranmere Rovers",2,42,23,39,99,-60,0.547619047619048,0.928571428571429,2.35714285714286,-1.42857142857143,44,22,22,44,64,89,-20,-3
1938,"Walsall",3,42,44,68,69,-1,1.04761904761905,1.61904761904762,1.64285714285714,-0.0238095238095238,84,40,44,88,55,100,29,0.1
1938,"Watford",3,42,63,62,51,11,1.5,1.47619047619048,1.21428571428571,0.261904761904762,56,12,44,88,69,93,-13,-3
1938,"West Bromwich Albion",2,42,63,89,72,17,1.5,2.11904761904762,1.71428571428571,0.404761904761905,32,10,22,44,27,121,5,2.1
1938,"West Ham United",2,42,61,70,52,18,1.45238095238095,1.66666666666667,1.23809523809524,0.428571428571429,34,12,22,44,33,94,1,-0.4
1938,"Wolverhampton Wanderers",1,42,77,88,39,49,1.83333333333333,2.0952380952381,0.928571428571429,1.16666666666667,2,2,22,22,2,121,0,-0.1
1938,"Wrexham",3,42,58,66,79,-13,1.38095238095238,1.57142857142857,1.88095238095238,-0.30952380952381,66,22,44,88,56,80,10,-0.6
1938,"York City",3,42,44,64,92,-28,1.04761904761905,1.52380952380952,2.19047619047619,-0.666666666666667,85,41,44,88,78,72,7,1.9
1946,"Accrington Stanley",3,42,46,56,92,-36,1.0952380952381,1.33333333333333,2.19047619047619,-0.857142857142857,81,37,44,88,53,34,28,3.3
1946,"AFC Bournemouth",3,42,62,72,54,18,1.47619047619048,1.71428571428571,1.28571428571429,0.428571428571429,57,13,44,88,48,90,9,-0.2
1946,"Aldershot",3,42,42,48,78,-30,1,1.14285714285714,1.85714285714286,-0.714285714285714,84,40,44,88,85,57,-1,0.3
1946,"Arsenal",1,42,57,72,70,2,1.35714285714286,1.71428571428571,1.66666666666667,0.0476190476190476,13,13,22,22,1,116,12,0.8
1946,"Aston Villa",1,42,63,67,53,14,1.5,1.5952380952381,1.26190476190476,0.333333333333333,8,8,22,22,6,121,2,-0.2
1946,"Barnsley",2,42,59,84,86,-2,1.4047619047619,2,2.04761904761905,-0.0476190476190476,32,10,22,44,33,111,-1,-0.9
1946,"Barrow",3,42,58,54,62,-8,1.38095238095238,1.28571428571429,1.47619047619048,-0.19047619047619,63,19,44,88,58,44,5,0.5
1946,"Birmingham City",2,42,80,74,33,41,1.9047619047619,1.76190476190476,0.785714285714286,0.976190476190476,24,2,22,44,23,117,1,1.2
1946,"Blackburn Rovers",1,42,50,45,53,-8,1.19047619047619,1.07142857142857,1.26190476190476,-0.19047619047619,17,17,22,22,21,121,-4,-0.9
1946,"Blackpool",1,42,72,71,70,1,1.71428571428571,1.69047619047619,1.66666666666667,0.0238095238095238,5,5,22,22,9,112,-4,0.1
1946,"Bolton Wanderers",1,42,47,57,69,-12,1.11904761904762,1.35714285714286,1.64285714285714,-0.285714285714286,18,18,22,22,15,121,3,1
1946,"Bradford City",3,42,70,62,47,15,1.66666666666667,1.47619047619048,1.11904761904762,0.357142857142857,52,8,44,88,67,106,-15,-0.3
1946,"Bradford Park Avenue",2,42,53,65,77,-12,1.26190476190476,1.54761904761905,1.83333333333333,-0.285714285714286,38,16,22,44,32,51,6,-4.4
1946,"Brentford",1,42,34,45,88,-43,0.80952380952381,1.07142857142857,2.0952380952381,-1.02380952380952,21,21,22,22,38,93,-17,-4.5
1946,"Brighton & Hove Albion",3,42,51,54,72,-18,1.21428571428571,1.28571428571429,1.71428571428571,-0.428571428571429,75,31,44,88,86,93,-11,1.5
1946,"Bristol City",3,42,71,94,56,38,1.69047619047619,2.23809523809524,1.33333333333333,0.904761904761905,51,7,44,88,59,108,-8,1.6
1946,"Bristol Rovers",3,42,56,59,69,-10,1.33333333333333,1.4047619047619,1.64285714285714,-0.238095238095238,66,22,44,88,81,92,-15,3.4
1946,"Burnley",2,42,80,65,29,36,1.9047619047619,1.54761904761905,0.69047619047619,0.857142857142857,25,3,22,44,2,121,23,1.8
1946,"Bury",2,42,48,80,78,2,1.14285714285714,1.9047619047619,1.85714285714286,0.0476190476190476,40,18,22,44,42,114,-2,-0.3
1946,"Cardiff City",3,42,96,93,30,63,2.28571428571429,2.21428571428571,0.714285714285714,1.5,46,2,44,88,27,93,19,2.5
1946,"Carlisle United",3,42,51,70,93,-23,1.21428571428571,1.66666666666667,2.21428571428571,-0.547619047619048,76,32,44,88,60,84,16,0.5
1946,"Charlton Athletic",1,42,45,57,71,-14,1.07142857142857,1.35714285714286,1.69047619047619,-0.333333333333333,20,20,22,22,12,92,8,-0.2
1946,"Chelsea",1,42,55,69,84,-15,1.30952380952381,1.64285714285714,2,-0.357142857142857,15,15,22,22,17,104,-2,0.1
1946,"Chester",3,42,81,95,51,44,1.92857142857143,2.26190476190476,1.21428571428571,1.04761904761905,48,4,44,88,80,67,-32,-4
1946,"Chesterfield",2,42,68,58,44,14,1.61904761904762,1.38095238095238,1.04761904761905,0.333333333333333,26,4,22,44,34,100,-8,-2.8
1946,"Coventry City",2,42,61,66,59,7,1.45238095238095,1.57142857142857,1.4047619047619,0.166666666666667,30,8,22,44,35,94,-5,-4.5
1946,"Crewe Alexandra",3,42,60,70,74,-4,1.42857142857143,1.66666666666667,1.76190476190476,-0.0952380952380952,60,16,44,88,61,96,-1,-3.2
1946,"Crystal Palace",3,42,50,49,62,-13,1.19047619047619,1.16666666666667,1.47619047619048,-0.30952380952381,79,35,44,88,73,93,6,-0.4
1946,"Darlington",3,42,51,68,80,-12,1.21428571428571,1.61904761904762,1.9047619047619,-0.285714285714286,77,33,44,88,74,81,3,-0.2
1946,"Derby County",1,42,59,73,79,-6,1.4047619047619,1.73809523809524,1.88095238095238,-0.142857142857143,11,11,22,22,4,121,7,-3.4
1946,"Doncaster Rovers",3,42,105,123,40,83,2.5,2.92857142857143,0.952380952380952,1.97619047619048,45,1,44,88,43,88,2,0.8
1946,"Everton",1,42,60,62,67,-5,1.42857142857143,1.47619047619048,1.5952380952381,-0.119047619047619,10,10,22,22,13,121,-3,-0.5
1946,"Exeter City",3,42,54,60,69,-9,1.28571428571429,1.42857142857143,1.64285714285714,-0.214285714285714,72,28,44,88,64,88,8,-1.4
1946,"Fulham",2,42,54,63,74,-11,1.28571428571429,1.5,1.76190476190476,-0.261904761904762,36,14,22,44,36,102,0,0.3
1946,"Gateshead",3,42,54,62,72,-10,1.28571428571429,1.47619047619048,1.71428571428571,-0.238095238095238,73,29,44,88,52,23,21,0.1
1946,"Grimsby Town",1,42,51,61,82,-21,1.21428571428571,1.45238095238095,1.95238095238095,-0.5,16,16,22,22,22,110,-6,-2
1946,"Halifax Town",3,42,30,43,92,-49,0.714285714285714,1.02380952380952,2.19047619047619,-1.16666666666667,88,44,44,88,87,69,1,2.7
1946,"Hartlepool United",3,42,54,64,73,-9,1.28571428571429,1.52380952380952,1.73809523809524,-0.214285714285714,74,30,44,88,78,89,-4,2.8
1946,"Huddersfield Town",1,42,46,53,79,-26,1.0952380952381,1.26190476190476,1.88095238095238,-0.619047619047619,19,19,22,22,20,99,-1,-1.5
1946,"Hull City",3,42,56,49,53,-4,1.33333333333333,1.16666666666667,1.26190476190476,-0.0952380952380952,67,23,44,88,55,104,12,1.1
1946,"Ipswich Town",3,42,62,61,53,8,1.47619047619048,1.45238095238095,1.26190476190476,0.19047619047619,58,14,44,88,49,75,9,1.1
1946,"Leeds United",1,42,24,45,90,-45,0.571428571428571,1.07142857142857,2.14285714285714,-1.07142857142857,22,22,22,22,39,93,-17,1.3
1946,"Leicester City",2,42,61,69,64,5,1.45238095238095,1.64285714285714,1.52380952380952,0.119047619047619,31,9,22,44,30,115,1,0.8
1946,"Leyton Orient",3,42,44,54,75,-21,1.04761904761905,1.28571428571429,1.78571428571429,-0.5,82,38,44,88,79,102,3,4.4
1946,"Lincoln City",3,42,56,86,87,-1,1.33333333333333,2.04761904761905,2.07142857142857,-0.0238095238095238,68,24,44,88,46,107,22,2.8
1946,"Liverpool",1,42,82,84,52,32,1.95238095238095,2,1.23809523809524,0.761904761904762,1,1,22,22,10,116,-9,-2.4
1946,"Luton Town",2,42,55,71,73,-2,1.30952380952381,1.69047619047619,1.73809523809524,-0.0476190476190476,34,12,22,44,37,91,-3,1.8
1946,"Manchester City",2,42,88,78,35,43,2.0952380952381,1.85714285714286,0.833333333333333,1.02380952380952,23,1,22,44,14,117,9,0.5
1946,"Manchester United",1,42,78,95,54,41,1.85714285714286,2.26190476190476,1.28571428571429,0.976190476190476,4,4,22,22,3,117,1,0.3
1946,"Mansfield Town",3,42,37,48,96,-48,0.880952380952381,1.14285714285714,2.28571428571429,-1.14285714285714,86,42,44,88,57,77,29,1.3
1946,"Middlesbrough",1,42,59,73,68,5,1.4047619047619,1.73809523809524,1.61904761904762,0.119047619047619,12,12,22,22,18,110,-6,-1.6
1946,"Millwall",2,42,50,56,79,-23,1.19047619047619,1.33333333333333,1.88095238095238,-0.547619047619048,39,17,22,44,44,93,-5,-3.7
1946,"New Brighton",3,42,50,57,77,-20,1.19047619047619,1.35714285714286,1.83333333333333,-0.476190476190476,80,36,44,88,88,21,-8,NA
1946,"Newcastle United",2,42,67,95,62,33,1.5952380952381,2.26190476190476,1.47619047619048,0.785714285714286,28,6,22,44,24,116,4,1.1
1946,"Newport County",2,42,33,61,133,-72,0.785714285714286,1.45238095238095,3.16666666666667,-1.71428571428571,44,22,22,44,68,67,-24,-3
1946,"Northampton Town",3,42,55,72,75,-3,1.30952380952381,1.71428571428571,1.78571428571429,-0.0714285714285714,70,26,44,88,70,93,0,0.2
1946,"Norwich City",3,42,38,64,100,-36,0.904761904761905,1.52380952380952,2.38095238095238,-0.857142857142857,85,41,44,88,82,93,3,-0.5
1946,"Nottingham Forest",2,42,55,69,74,-5,1.30952380952381,1.64285714285714,1.76190476190476,-0.119047619047619,35,13,22,44,40,117,-5,1.1
1946,"Notts County",3,42,55,63,63,0,1.30952380952381,1.5,1.5,0,71,27,44,88,56,120,15,2.9
1946,"Oldham Athletic",3,42,44,55,80,-25,1.04761904761905,1.30952380952381,1.9047619047619,-0.595238095238095,83,39,44,88,69,102,14,-0.1
1946,"Plymouth Argyle",2,42,47,79,96,-17,1.11904761904762,1.88095238095238,2.28571428571429,-0.404761904761905,41,19,22,44,41,93,0,-3.9
1946,"Port Vale",3,42,60,68,63,5,1.42857142857143,1.61904761904762,1.5,0.119047619047619,61,17,44,88,62,107,-1,1.7
1946,"Portsmouth",1,42,57,66,60,6,1.35714285714286,1.57142857142857,1.42857142857143,0.142857142857143,14,14,22,22,8,93,6,-0.6
1946,"Preston North End",1,42,65,76,74,2,1.54761904761905,1.80952380952381,1.76190476190476,0.0476190476190476,7,7,22,22,5,121,2,0.5
1946,"Queens Park Rangers",3,42,80,74,40,34,1.9047619047619,1.76190476190476,0.952380952380952,0.80952380952381,49,5,44,88,45,93,4,-1.6
1946,"Reading",3,42,59,83,74,9,1.4047619047619,1.97619047619048,1.76190476190476,0.214285714285714,62,18,44,88,65,93,-3,-0.7
1946,"Rochdale",3,42,67,80,64,16,1.5952380952381,1.9047619047619,1.52380952380952,0.380952380952381,54,10,44,88,66,92,-12,-0.9
1946,"Rotherham United",3,42,93,114,53,61,2.21428571428571,2.71428571428571,1.26190476190476,1.45238095238095,47,3,44,88,47,88,0,0.8
1946,"Sheffield United",1,42,70,89,75,14,1.66666666666667,2.11904761904762,1.78571428571429,0.333333333333333,6,6,22,22,11,117,-5,-2.3
1946,"Sheffield Wednesday",2,42,44,67,88,-21,1.04761904761905,1.5952380952381,2.0952380952381,-0.5,42,20,22,44,26,117,16,2.9
1946,"Southampton",2,42,54,69,76,-7,1.28571428571429,1.64285714285714,1.80952380952381,-0.166666666666667,37,15,22,44,25,93,12,-1.6
1946,"Southend United",3,42,61,71,60,11,1.45238095238095,1.69047619047619,1.42857142857143,0.261904761904762,59,15,44,88,63,93,-4,-0.5
1946,"Southport",3,42,32,53,85,-32,0.761904761904762,1.26190476190476,2.02380952380952,-0.761904761904762,87,43,44,88,71,50,16,-0.2
1946,"Stockport County",3,42,74,78,53,25,1.76190476190476,1.85714285714286,1.26190476190476,0.595238095238095,50,6,44,88,77,99,-27,-0.2
1946,"Stoke City",1,42,79,90,53,37,1.88095238095238,2.14285714285714,1.26190476190476,0.880952380952381,3,3,22,22,16,113,-13,-2.4
1946,"Sunderland",1,42,62,65,66,-1,1.47619047619048,1.54761904761905,1.57142857142857,-0.0238095238095238,9,9,22,22,19,119,-10,-1
1946,"Swansea City",2,42,40,55,83,-28,0.952380952380952,1.30952380952381,1.97619047619048,-0.666666666666667,43,21,22,44,54,93,-11,1.2
1946,"Swindon Town",3,42,68,84,73,11,1.61904761904762,2,1.73809523809524,0.261904761904762,53,9,44,88,83,93,-30,-3.2
1946,"Torquay United",3,42,57,52,61,-9,1.35714285714286,1.23809523809524,1.45238095238095,-0.214285714285714,65,21,44,88,84,78,-19,1.6
1946,"Tottenham Hotspur",2,42,65,65,53,12,1.54761904761905,1.54761904761905,1.26190476190476,0.285714285714286,29,7,22,44,31,101,-2,2.6
1946,"Tranmere Rovers",3,42,58,66,77,-11,1.38095238095238,1.57142857142857,1.83333333333333,-0.261904761904762,64,20,44,88,75,89,-11,-2.7
1946,"Walsall",3,42,63,74,59,15,1.5,1.76190476190476,1.4047619047619,0.357142857142857,55,11,44,88,50,100,5,-2.3
1946,"Watford",3,42,56,61,76,-15,1.33333333333333,1.45238095238095,1.80952380952381,-0.357142857142857,69,25,44,88,76,93,-7,0.2
1946,"West Bromwich Albion",2,42,68,88,75,13,1.61904761904762,2.0952380952381,1.78571428571429,0.30952380952381,27,5,22,44,28,121,-1,1.6
1946,"West Ham United",2,42,56,70,76,-6,1.33333333333333,1.66666666666667,1.80952380952381,-0.142857142857143,33,11,22,44,29,94,4,0.3
1946,"Wolverhampton Wanderers",1,42,81,98,56,42,1.92857142857143,2.33333333333333,1.33333333333333,1,2,2,22,22,7,121,-5,-0.4
1946,"Wrexham",3,42,63,65,51,14,1.5,1.54761904761905,1.21428571428571,0.333333333333333,56,12,44,88,51,80,5,-0.6
1946,"York City",3,42,51,67,81,-14,1.21428571428571,1.5952380952381,1.92857142857143,-0.333333333333333,78,34,44,88,72,72,6,2.1
1947,"Accrington Stanley",3,42,66,62,59,3,1.57142857142857,1.47619047619048,1.4047619047619,0.0714285714285714,53,9,44,88,79,34,-26,0.7
1947,"AFC Bournemouth",3,42,81,76,35,41,1.92857142857143,1.80952380952381,0.833333333333333,0.976190476190476,48,4,44,88,49,90,-1,-0.9
1947,"Aldershot",3,42,45,45,67,-22,1.07142857142857,1.07142857142857,1.5952380952381,-0.523809523809524,85,41,44,88,84,57,1,0.3
1947,"Arsenal",1,42,82,81,32,49,1.95238095238095,1.92857142857143,0.761904761904762,1.16666666666667,1,1,22,22,5,116,-4,-1.1
1947,"Aston Villa",1,42,66,65,57,8,1.57142857142857,1.54761904761905,1.35714285714286,0.19047619047619,6,6,22,22,8,121,-2,-0.7
1947,"Barnsley",2,42,55,62,64,-2,1.30952380952381,1.47619047619048,1.52380952380952,-0.0476190476190476,33,11,22,44,33,111,0,-0.3
1947,"Barrow",3,42,61,49,40,9,1.45238095238095,1.16666666666667,0.952380952380952,0.214285714285714,58,14,44,88,68,44,-10,-2.3
1947,"Birmingham City",2,42,81,55,24,31,1.92857142857143,1.30952380952381,0.571428571428571,0.738095238095238,23,1,22,44,18,117,5,0.9
1947,"Blackburn Rovers",1,42,43,54,72,-18,1.02380952380952,1.28571428571429,1.71428571428571,-0.428571428571429,21,21,22,22,35,121,-14,-0.4
1947,"Blackpool",1,42,61,57,41,16,1.45238095238095,1.35714285714286,0.976190476190476,0.380952380952381,9,9,22,22,17,112,-8,0.2
1947,"Bolton Wanderers",1,42,53,46,58,-12,1.26190476190476,1.0952380952381,1.38095238095238,-0.285714285714286,15,15,22,22,13,121,2,0
1947,"Bradford City",3,42,55,65,66,-1,1.30952380952381,1.54761904761905,1.57142857142857,-0.0238095238095238,67,23,44,88,87,106,-20,1.6
1947,"Bradford Park Avenue",2,42,56,68,72,-4,1.33333333333333,1.61904761904762,1.71428571428571,-0.0952380952380952,32,10,22,44,38,51,-6,-5.4
1947,"Brentford",2,42,53,44,61,-17,1.26190476190476,1.04761904761905,1.45238095238095,-0.404761904761905,38,16,22,44,42,93,-4,-1.1
1947,"Brighton & Hove Albion",3,42,45,43,73,-30,1.07142857142857,1.02380952380952,1.73809523809524,-0.714285714285714,86,42,44,88,54,93,32,3.9
1947,"Bristol City",3,42,61,77,65,12,1.45238095238095,1.83333333333333,1.54761904761905,0.285714285714286,59,15,44,88,77,108,-18,2
1947,"Bristol Rovers",3,42,47,71,75,-4,1.11904761904762,1.69047619047619,1.78571428571429,-0.0952380952380952,81,37,44,88,52,92,29,4.9
1947,"Burnley",1,42,72,56,43,13,1.71428571428571,1.33333333333333,1.02380952380952,0.30952380952381,2,2,22,22,14,121,-12,-0.3
1947,"Bury",2,42,43,58,68,-10,1.02380952380952,1.38095238095238,1.61904761904762,-0.238095238095238,42,20,22,44,31,114,11,-0.8
1947,"Cardiff City",2,42,65,61,58,3,1.54761904761905,1.45238095238095,1.38095238095238,0.0714285714285714,27,5,22,44,26,93,1,-1
1947,"Carlisle United",3,42,61,88,77,11,1.45238095238095,2.0952380952381,1.83333333333333,0.261904761904762,60,16,44,88,71,84,-11,-0.8
1947,"Charlton Athletic",1,42,57,57,66,-9,1.35714285714286,1.35714285714286,1.57142857142857,-0.214285714285714,12,12,22,22,9,92,3,-1.2
1947,"Chelsea",1,42,51,53,71,-18,1.21428571428571,1.26190476190476,1.69047619047619,-0.428571428571429,17,17,22,22,15,104,2,0.6
1947,"Chester",3,42,48,64,67,-3,1.14285714285714,1.52380952380952,1.5952380952381,-0.0714285714285714,80,36,44,88,80,67,0,-0.3
1947,"Chesterfield",2,42,55,54,55,-1,1.30952380952381,1.28571428571429,1.30952380952381,-0.0238095238095238,34,12,22,44,29,100,5,-2.7
1947,"Coventry City",2,42,55,59,52,7,1.30952380952381,1.4047619047619,1.23809523809524,0.166666666666667,35,13,22,44,37,94,-2,-4.9
1947,"Crewe Alexandra",3,42,61,61,63,-2,1.45238095238095,1.45238095238095,1.5,-0.0476190476190476,61,17,44,88,65,96,-4,-3.1
1947,"Crystal Palace",3,42,52,49,49,0,1.23809523809524,1.16666666666667,1.16666666666667,0,73,29,44,88,88,93,-15,-0.2
1947,"Darlington",3,42,52,54,70,-16,1.23809523809524,1.28571428571429,1.66666666666667,-0.380952380952381,74,30,44,88,53,81,21,-0.2
1947,"Derby County",1,42,69,77,57,20,1.64285714285714,1.83333333333333,1.35714285714286,0.476190476190476,4,4,22,22,2,121,2,-3.4
1947,"Doncaster Rovers",2,42,38,40,66,-26,0.904761904761905,0.952380952380952,1.57142857142857,-0.619047619047619,43,21,22,44,50,88,-7,-0.1
1947,"Everton",1,42,57,52,66,-14,1.35714285714286,1.23809523809524,1.57142857142857,-0.333333333333333,13,13,22,22,16,121,-3,-0.4
1947,"Exeter City",3,42,56,55,63,-8,1.33333333333333,1.30952380952381,1.5,-0.19047619047619,64,20,44,88,67,88,-3,-2.5
1947,"Fulham",2,42,55,47,46,1,1.30952380952381,1.11904761904762,1.0952380952381,0.0238095238095238,36,14,22,44,23,102,13,0.8
1947,"Gateshead",3,42,68,75,57,18,1.61904761904762,1.78571428571429,1.35714285714286,0.428571428571429,52,8,44,88,61,23,-9,-2
1947,"Grimsby Town",1,42,30,45,111,-66,0.714285714285714,1.07142857142857,2.64285714285714,-1.57142857142857,22,22,22,22,32,110,-10,-1.3
1947,"Halifax Town",3,42,34,43,76,-33,0.80952380952381,1.02380952380952,1.80952380952381,-0.785714285714286,87,43,44,88,78,69,9,2.7
1947,"Hartlepool United",3,42,50,51,73,-22,1.19047619047619,1.21428571428571,1.73809523809524,-0.523809523809524,78,34,44,88,74,89,4,0.5
1947,"Huddersfield Town",1,42,48,51,60,-9,1.14285714285714,1.21428571428571,1.42857142857143,-0.214285714285714,20,20,22,22,19,99,1,-1.4
1947,"Hull City",3,42,65,59,48,11,1.54761904761905,1.4047619047619,1.14285714285714,0.261904761904762,55,11,44,88,45,104,10,-0.3
1947,"Ipswich Town",3,42,72,67,61,6,1.71428571428571,1.5952380952381,1.45238095238095,0.142857142857143,49,5,44,88,55,75,-6,1.9
1947,"Leeds United",2,42,50,62,72,-10,1.19047619047619,1.47619047619048,1.71428571428571,-0.238095238095238,39,17,22,44,39,93,0,2.3
1947,"Leicester City",2,42,59,60,57,3,1.4047619047619,1.42857142857143,1.35714285714286,0.0714285714285714,30,8,22,44,43,115,-13,1.2
1947,"Leyton Orient",3,42,49,51,73,-22,1.16666666666667,1.21428571428571,1.73809523809524,-0.523809523809524,79,35,44,88,81,102,-2,4.6
1947,"Lincoln City",3,42,86,81,40,41,2.04761904761905,1.92857142857143,0.952380952380952,0.976190476190476,46,2,44,88,44,107,2,0.5
1947,"Liverpool",1,42,58,65,61,4,1.38095238095238,1.54761904761905,1.45238095238095,0.0952380952380952,10,10,22,22,12,116,-2,-1.6
1947,"Luton Town",2,42,54,56,59,-3,1.28571428571429,1.33333333333333,1.4047619047619,-0.0714285714285714,37,15,22,44,34,91,3,2.9
1947,"Manchester City",1,42,57,52,47,5,1.35714285714286,1.23809523809524,1.11904761904762,0.119047619047619,14,14,22,22,7,117,7,1
1947,"Manchester United",1,42,71,81,48,33,1.69047619047619,1.92857142857143,1.14285714285714,0.785714285714286,3,3,22,22,3,117,0,-0.6
1947,"Mansfield Town",3,42,62,57,51,6,1.47619047619048,1.35714285714286,1.21428571428571,0.142857142857143,57,13,44,88,66,77,-9,0.1
1947,"Middlesbrough",1,42,51,71,73,-2,1.21428571428571,1.69047619047619,1.73809523809524,-0.0476190476190476,18,18,22,22,20,110,-2,-1.1
1947,"Millwall",2,42,38,44,74,-30,0.904761904761905,1.04761904761905,1.76190476190476,-0.714285714285714,44,22,22,44,58,93,-14,-4.6
1947,"New Brighton",3,42,33,38,81,-43,0.785714285714286,0.904761904761905,1.92857142857143,-1.02380952380952,88,44,44,88,76,21,12,NA
1947,"Newcastle United",2,42,80,72,41,31,1.9047619047619,1.71428571428571,0.976190476190476,0.738095238095238,24,2,22,44,4,116,20,0.5
1947,"Newport County",3,42,55,61,73,-12,1.30952380952381,1.45238095238095,1.73809523809524,-0.285714285714286,68,24,44,88,75,67,-7,0.5
1947,"Northampton Town",3,42,53,58,72,-14,1.26190476190476,1.38095238095238,1.71428571428571,-0.333333333333333,70,26,44,88,82,93,-12,0.1
1947,"Norwich City",3,42,47,61,76,-15,1.11904761904762,1.45238095238095,1.80952380952381,-0.357142857142857,82,38,44,88,62,93,20,2.3
1947,"Nottingham Forest",2,42,47,54,60,-6,1.11904761904762,1.28571428571429,1.42857142857143,-0.142857142857143,40,18,22,44,40,117,0,3
1947,"Notts County",3,42,65,68,59,9,1.54761904761905,1.61904761904762,1.4047619047619,0.214285714285714,56,12,44,88,59,120,-3,1.4
1947,"Oldham Athletic",3,42,55,63,64,-1,1.30952380952381,1.5,1.52380952380952,-0.0238095238095238,69,25,44,88,56,102,13,-0.5
1947,"Plymouth Argyle",2,42,47,40,58,-18,1.11904761904762,0.952380952380952,1.38095238095238,-0.428571428571429,41,19,22,44,41,93,0,-0.7
1947,"Port Vale",3,42,59,63,54,9,1.4047619047619,1.5,1.28571428571429,0.214285714285714,62,18,44,88,72,107,-10,-1.5
1947,"Portsmouth",1,42,64,68,50,18,1.52380952380952,1.61904761904762,1.19047619047619,0.428571428571429,8,8,22,22,1,93,7,-1.2
1947,"Preston North End",1,42,67,67,68,-1,1.5952380952381,1.5952380952381,1.61904761904762,-0.0238095238095238,5,5,22,22,21,121,-16,0.3
1947,"Queens Park Rangers",3,42,87,74,37,37,2.07142857142857,1.76190476190476,0.880952380952381,0.880952380952381,45,1,44,88,36,93,9,-1.7
1947,"Reading",3,42,56,56,58,-2,1.33333333333333,1.33333333333333,1.38095238095238,-0.0476190476190476,65,21,44,88,48,93,17,1.2
1947,"Rochdale",3,42,56,48,72,-24,1.33333333333333,1.14285714285714,1.71428571428571,-0.571428571428571,66,22,44,88,57,92,9,0.2
1947,"Rotherham United",3,42,84,95,49,46,2,2.26190476190476,1.16666666666667,1.0952380952381,47,3,44,88,46,88,1,0.7
1947,"Sheffield United",1,42,58,65,70,-5,1.38095238095238,1.54761904761905,1.66666666666667,-0.119047619047619,11,11,22,22,22,117,-11,-1.6
1947,"Sheffield Wednesday",2,42,71,66,53,13,1.69047619047619,1.57142857142857,1.26190476190476,0.30952380952381,26,4,22,44,30,117,-4,0.5
1947,"Southampton",2,42,73,71,53,18,1.73809523809524,1.69047619047619,1.26190476190476,0.428571428571429,25,3,22,44,25,93,0,-2.9
1947,"Southend United",3,42,58,51,58,-7,1.38095238095238,1.21428571428571,1.38095238095238,-0.166666666666667,63,19,44,88,85,93,-22,0.8
1947,"Southport",3,42,53,60,63,-3,1.26190476190476,1.42857142857143,1.5,-0.0714285714285714,71,27,44,88,86,50,-15,-2
1947,"Stockport County",3,42,51,63,67,-4,1.21428571428571,1.5,1.5952380952381,-0.0952380952380952,77,33,44,88,64,99,13,1.2
1947,"Stoke City",1,42,52,41,55,-14,1.23809523809524,0.976190476190476,1.30952380952381,-0.333333333333333,16,16,22,22,10,113,6,-1.5
1947,"Sunderland",1,42,49,56,67,-11,1.16666666666667,1.33333333333333,1.5952380952381,-0.261904761904762,19,19,22,22,11,119,8,-0.3
1947,"Swansea City",3,42,66,70,52,18,1.57142857142857,1.66666666666667,1.23809523809524,0.428571428571429,54,10,44,88,47,93,7,1.1
1947,"Swindon Town",3,42,46,41,46,-5,1.0952380952381,0.976190476190476,1.0952380952381,-0.119047619047619,83,39,44,88,51,93,32,3.1
1947,"Torquay United",3,42,46,63,62,1,1.0952380952381,1.5,1.47619047619048,0.0238095238095238,84,40,44,88,60,78,24,-0.4
1947,"Tottenham Hotspur",2,42,59,56,43,13,1.4047619047619,1.33333333333333,1.02380952380952,0.30952380952381,31,9,22,44,27,101,4,2.8
1947,"Tranmere Rovers",3,42,52,54,72,-18,1.23809523809524,1.28571428571429,1.71428571428571,-0.428571428571429,75,31,44,88,69,89,6,0.8
1947,"Walsall",3,42,72,70,40,30,1.71428571428571,1.66666666666667,0.952380952380952,0.714285714285714,50,6,44,88,73,100,-23,-3.5
1947,"Watford",3,42,52,57,79,-22,1.23809523809524,1.35714285714286,1.88095238095238,-0.523809523809524,76,32,44,88,83,93,-7,-0.3
1947,"West Bromwich Albion",2,42,63,63,58,5,1.5,1.5,1.38095238095238,0.119047619047619,28,6,22,44,24,121,4,2.2
1947,"West Ham United",2,42,62,55,53,2,1.47619047619048,1.30952380952381,1.26190476190476,0.0476190476190476,29,7,22,44,28,94,1,0.6
1947,"Wolverhampton Wanderers",1,42,66,83,70,13,1.57142857142857,1.97619047619048,1.66666666666667,0.30952380952381,7,7,22,22,6,121,1,0.6
1947,"Wrexham",3,42,71,74,54,20,1.69047619047619,1.76190476190476,1.28571428571429,0.476190476190476,51,7,44,88,63,80,-12,-1.9
1947,"York City",3,42,53,65,60,5,1.26190476190476,1.54761904761905,1.42857142857143,0.119047619047619,72,28,44,88,70,72,2,0.1
1948,"Accrington Stanley",3,42,46,55,64,-9,1.0952380952381,1.30952380952381,1.52380952380952,-0.214285714285714,79,35,44,88,71,34,8,1.7
1948,"AFC Bournemouth",3,42,74,69,48,21,1.76190476190476,1.64285714285714,1.14285714285714,0.5,49,5,44,88,66,90,-17,-0.8
1948,"Aldershot",3,42,44,48,59,-11,1.04761904761905,1.14285714285714,1.4047619047619,-0.261904761904762,84,40,44,88,77,57,7,-0.6
1948,"Arsenal",1,42,67,74,44,30,1.5952380952381,1.76190476190476,1.04761904761905,0.714285714285714,5,5,22,22,5,116,0,0.2
1948,"Aston Villa",1,42,58,60,76,-16,1.38095238095238,1.42857142857143,1.80952380952381,-0.380952380952381,8,8,22,22,12,121,-4,-1.3
1948,"Barnsley",2,42,54,62,61,1,1.28571428571429,1.47619047619048,1.45238095238095,0.0238095238095238,33,11,22,44,35,111,-2,-1
1948,"Barrow",3,42,54,41,48,-7,1.28571428571429,0.976190476190476,1.14285714285714,-0.166666666666667,68,24,44,88,75,44,-7,-2.3
1948,"Birmingham City",1,42,48,36,38,-2,1.14285714285714,0.857142857142857,0.904761904761905,-0.0476190476190476,18,18,22,22,22,117,-4,1
1948,"Blackburn Rovers",2,42,53,53,63,-10,1.26190476190476,1.26190476190476,1.5,-0.238095238095238,35,13,22,44,36,121,-1,2.5
1948,"Blackpool",1,42,49,54,67,-13,1.16666666666667,1.28571428571429,1.5952380952381,-0.30952380952381,17,17,22,22,8,112,9,0.8
1948,"Bolton Wanderers",1,42,52,59,68,-9,1.23809523809524,1.4047619047619,1.61904761904762,-0.214285714285714,13,13,22,22,18,121,-5,0.9
1948,"Bradford City",3,42,39,48,77,-29,0.928571428571429,1.14285714285714,1.83333333333333,-0.69047619047619,87,43,44,88,84,106,3,3.3
1948,"Bradford Park Avenue",2,42,50,65,78,-13,1.19047619047619,1.54761904761905,1.85714285714286,-0.30952380952381,38,16,22,44,43,51,-5,-4.2
1948,"Brentford",2,42,47,42,53,-11,1.11904761904762,1,1.26190476190476,-0.261904761904762,42,20,22,44,31,93,11,-0.6
1948,"Brighton & Hove Albion",3,42,63,55,55,0,1.5,1.30952380952381,1.30952380952381,0,54,10,44,88,62,93,-8,1.9
1948,"Bristol City",3,42,47,44,62,-18,1.11904761904762,1.04761904761905,1.47619047619048,-0.428571428571429,77,33,44,88,72,108,5,4.5
1948,"Bristol Rovers",3,42,67,61,51,10,1.5952380952381,1.45238095238095,1.21428571428571,0.238095238095238,52,8,44,88,60,92,-8,2.3
1948,"Burnley",1,42,50,43,50,-7,1.19047619047619,1.02380952380952,1.19047619047619,-0.166666666666667,14,14,22,22,10,121,4,0.8
1948,"Bury",2,42,57,67,76,-9,1.35714285714286,1.5952380952381,1.80952380952381,-0.214285714285714,31,9,22,44,38,114,-7,-2.4
1948,"Cardiff City",2,42,70,62,47,15,1.66666666666667,1.47619047619048,1.11904761904762,0.357142857142857,26,4,22,44,32,93,-6,-0.4
1948,"Carlisle United",3,42,53,60,77,-17,1.26190476190476,1.42857142857143,1.83333333333333,-0.404761904761905,71,27,44,88,59,84,12,-0.7
1948,"Charlton Athletic",1,42,57,63,67,-4,1.35714285714286,1.5,1.5952380952381,-0.0952380952380952,9,9,22,22,16,92,-7,-2.2
1948,"Chelsea",1,42,50,69,68,1,1.19047619047619,1.64285714285714,1.61904761904762,0.0238095238095238,15,15,22,22,14,104,1,0.4
1948,"Chester",3,42,46,57,56,1,1.0952380952381,1.35714285714286,1.33333333333333,0.0238095238095238,80,36,44,88,68,67,12,-0.1
1948,"Chesterfield",2,42,62,51,45,6,1.47619047619048,1.21428571428571,1.07142857142857,0.142857142857143,29,7,22,44,34,100,-5,-3
1948,"Coventry City",2,42,52,55,64,-9,1.23809523809524,1.30952380952381,1.52380952380952,-0.214285714285714,37,15,22,44,37,94,0,-3.3
1948,"Crewe Alexandra",3,42,57,52,74,-22,1.35714285714286,1.23809523809524,1.76190476190476,-0.523809523809524,65,21,44,88,57,96,8,-2
1948,"Crystal Palace",3,42,35,38,76,-38,0.833333333333333,0.904761904761905,1.80952380952381,-0.904761904761905,88,44,44,88,63,93,25,1.3
1948,"Darlington",3,42,66,83,74,9,1.57142857142857,1.97619047619048,1.76190476190476,0.214285714285714,53,9,44,88,82,81,-29,-3.3
1948,"Derby County",1,42,75,74,55,19,1.78571428571429,1.76190476190476,1.30952380952381,0.452380952380952,2,2,22,22,11,121,-9,-2.6
1948,"Doncaster Rovers",3,42,70,53,40,13,1.66666666666667,1.26190476190476,0.952380952380952,0.30952380952381,50,6,44,88,47,88,3,-1.6
1948,"Everton",1,42,50,41,63,-22,1.19047619047619,0.976190476190476,1.5,-0.523809523809524,16,16,22,22,19,121,-3,0.1
1948,"Exeter City",3,42,55,63,76,-13,1.30952380952381,1.5,1.80952380952381,-0.30952380952381,67,23,44,88,73,88,-6,-0.6
1948,"Fulham",2,42,81,77,37,40,1.92857142857143,1.83333333333333,0.880952380952381,0.952380952380952,23,1,22,44,20,102,3,-0.1
1948,"Gateshead",3,42,61,69,58,11,1.45238095238095,1.64285714285714,1.38095238095238,0.261904761904762,61,17,44,88,46,23,15,-2.3
1948,"Grimsby Town",2,42,55,72,76,-4,1.30952380952381,1.71428571428571,1.80952380952381,-0.0952380952380952,32,10,22,44,33,110,-1,-1.2
1948,"Halifax Town",3,42,47,45,62,-17,1.11904761904762,1.07142857142857,1.47619047619048,-0.404761904761905,78,34,44,88,85,69,-7,2.8
1948,"Hartlepool United",3,42,52,45,58,-13,1.23809523809524,1.07142857142857,1.38095238095238,-0.30952380952381,74,30,44,88,78,89,-4,-1.3
1948,"Huddersfield Town",1,42,46,40,69,-29,1.0952380952381,0.952380952380952,1.64285714285714,-0.69047619047619,19,19,22,22,15,99,4,-1.7
1948,"Hull City",3,42,92,93,28,65,2.19047619047619,2.21428571428571,0.666666666666667,1.54761904761905,45,1,44,88,29,104,16,0
1948,"Ipswich Town",3,42,63,78,77,1,1.5,1.85714285714286,1.83333333333333,0.0238095238095238,55,11,44,88,79,75,-24,2.2
1948,"Leeds United",2,42,49,55,63,-8,1.16666666666667,1.30952380952381,1.5,-0.19047619047619,39,17,22,44,27,93,12,2.3
1948,"Leicester City",2,42,46,62,79,-17,1.0952380952381,1.47619047619048,1.88095238095238,-0.404761904761905,43,21,22,44,39,115,4,2.4
1948,"Leyton Orient",3,42,45,58,80,-22,1.07142857142857,1.38095238095238,1.9047619047619,-0.523809523809524,81,37,44,88,80,102,1,4.2
1948,"Lincoln City",2,42,36,53,91,-38,0.857142857142857,1.26190476190476,2.16666666666667,-0.904761904761905,44,22,22,44,48,107,-4,0.3
1948,"Liverpool",1,42,53,53,43,10,1.26190476190476,1.26190476190476,1.02380952380952,0.238095238095238,12,12,22,22,9,116,3,-1.3
1948,"Luton Town",2,42,54,55,57,-2,1.28571428571429,1.30952380952381,1.35714285714286,-0.0476190476190476,34,12,22,44,40,91,-6,1.7
1948,"Manchester City",1,42,60,47,51,-4,1.42857142857143,1.11904761904762,1.21428571428571,-0.0952380952380952,7,7,22,22,21,117,-14,-1.3
1948,"Manchester United",1,42,74,77,44,33,1.76190476190476,1.83333333333333,1.04761904761905,0.785714285714286,3,3,22,22,6,117,-3,0.1
1948,"Mansfield Town",3,42,56,52,48,4,1.33333333333333,1.23809523809524,1.14285714285714,0.0952380952380952,66,22,44,88,56,77,10,0.2
1948,"Middlesbrough",1,42,45,46,57,-11,1.07142857142857,1.0952380952381,1.35714285714286,-0.261904761904762,20,20,22,22,7,110,13,-1.8
1948,"Millwall",3,42,62,63,64,-1,1.47619047619048,1.5,1.52380952380952,-0.0238095238095238,58,14,44,88,83,93,-25,-1.9
1948,"New Brighton",3,42,50,46,58,-12,1.19047619047619,1.0952380952381,1.38095238095238,-0.285714285714286,76,32,44,88,74,21,2,NA
1948,"Newcastle United",1,42,72,70,56,14,1.71428571428571,1.66666666666667,1.33333333333333,0.333333333333333,4,4,22,22,4,116,0,-0.8
1948,"Newport County",3,42,51,68,92,-24,1.21428571428571,1.61904761904762,2.19047619047619,-0.571428571428571,75,31,44,88,81,67,-6,1.4
1948,"Northampton Town",3,42,45,51,62,-11,1.07142857142857,1.21428571428571,1.47619047619048,-0.261904761904762,82,38,44,88,50,93,32,0.6
1948,"Norwich City",3,42,60,67,49,18,1.42857142857143,1.5952380952381,1.16666666666667,0.428571428571429,62,18,44,88,67,93,-5,1.5
1948,"Nottingham Forest",2,42,49,50,54,-4,1.16666666666667,1.19047619047619,1.28571428571429,-0.0952380952380952,40,18,22,44,52,117,-12,2.6
1948,"Notts County",3,42,62,102,68,34,1.47619047619048,2.42857142857143,1.61904761904762,0.80952380952381,59,15,44,88,45,120,14,-0.8
1948,"Oldham Athletic",3,42,63,75,67,8,1.5,1.78571428571429,1.5952380952381,0.19047619047619,56,12,44,88,64,102,-8,-3.3
1948,"Plymouth Argyle",2,42,48,49,64,-15,1.14285714285714,1.16666666666667,1.52380952380952,-0.357142857142857,41,19,22,44,44,93,-3,-0.5
1948,"Port Vale",3,42,53,51,54,-3,1.26190476190476,1.21428571428571,1.28571428571429,-0.0714285714285714,72,28,44,88,69,107,3,0.3
1948,"Portsmouth",1,42,83,84,42,42,1.97619047619048,2,1,1,1,1,22,22,1,93,0,-2.1
1948,"Preston North End",1,42,44,62,75,-13,1.04761904761905,1.47619047619048,1.78571428571429,-0.30952380952381,21,21,22,22,28,121,-7,0.8
1948,"Queens Park Rangers",2,42,53,44,62,-18,1.26190476190476,1.04761904761905,1.47619047619048,-0.428571428571429,36,14,22,44,42,93,-6,-2
1948,"Reading",3,42,80,77,50,27,1.9047619047619,1.83333333333333,1.19047619047619,0.642857142857143,48,4,44,88,65,93,-17,-0.3
1948,"Rochdale",3,42,63,55,53,2,1.5,1.30952380952381,1.26190476190476,0.0476190476190476,57,13,44,88,49,92,8,-1.1
1948,"Rotherham United",3,42,90,90,46,44,2.14285714285714,2.14285714285714,1.0952380952381,1.04761904761905,46,2,44,88,54,88,-8,0.4
1948,"Sheffield United",1,42,44,57,78,-21,1.04761904761905,1.35714285714286,1.85714285714286,-0.5,22,22,22,22,24,117,-2,-0.4
1948,"Sheffield Wednesday",2,42,58,63,56,7,1.38095238095238,1.5,1.33333333333333,0.166666666666667,30,8,22,44,26,117,4,0.7
1948,"Southampton",2,42,78,69,36,33,1.85714285714286,1.64285714285714,0.857142857142857,0.785714285714286,25,3,22,44,25,93,0,-3.3
1948,"Southend United",3,42,43,41,46,-5,1.02380952380952,0.976190476190476,1.0952380952381,-0.119047619047619,85,41,44,88,51,93,34,3.3
1948,"Southport",3,42,42,45,64,-19,1,1.07142857142857,1.52380952380952,-0.452380952380952,86,42,44,88,76,50,10,-0.6
1948,"Stockport County",3,42,59,61,56,5,1.4047619047619,1.45238095238095,1.33333333333333,0.119047619047619,64,20,44,88,58,99,6,-0.1
1948,"Stoke City",1,42,57,66,68,-2,1.35714285714286,1.57142857142857,1.61904761904762,-0.0476190476190476,10,10,22,22,17,113,-7,-1.7
1948,"Sunderland",1,42,56,49,58,-9,1.33333333333333,1.16666666666667,1.38095238095238,-0.214285714285714,11,11,22,22,2,119,9,-2.6
1948,"Swansea City",3,42,89,87,34,53,2.11904761904762,2.07142857142857,0.80952380952381,1.26190476190476,47,3,44,88,30,93,17,1.3
1948,"Swindon Town",3,42,69,64,56,8,1.64285714285714,1.52380952380952,1.33333333333333,0.19047619047619,51,7,44,88,70,93,-19,-0.9
1948,"Torquay United",3,42,62,65,70,-5,1.47619047619048,1.54761904761905,1.66666666666667,-0.119047619047619,60,16,44,88,55,78,5,-2.2
1948,"Tottenham Hotspur",2,42,67,72,44,28,1.5952380952381,1.71428571428571,1.04761904761905,0.666666666666667,27,5,22,44,23,101,4,0.9
1948,"Tranmere Rovers",3,42,54,46,57,-11,1.28571428571429,1.0952380952381,1.35714285714286,-0.261904761904762,69,25,44,88,53,89,16,1.6
1948,"Walsall",3,42,53,56,64,-8,1.26190476190476,1.33333333333333,1.52380952380952,-0.19047619047619,73,29,44,88,86,100,-13,-0.1
1948,"Watford",3,42,45,41,54,-13,1.07142857142857,0.976190476190476,1.28571428571429,-0.30952380952381,83,39,44,88,61,93,22,0
1948,"West Bromwich Albion",2,42,80,69,39,30,1.9047619047619,1.64285714285714,0.928571428571429,0.714285714285714,24,2,22,44,13,121,11,1.7
1948,"West Ham United",2,42,64,56,58,-2,1.52380952380952,1.33333333333333,1.38095238095238,-0.0476190476190476,28,6,22,44,41,94,-13,2.3
1948,"Wolverhampton Wanderers",1,42,63,79,66,13,1.5,1.88095238095238,1.57142857142857,0.30952380952381,6,6,22,22,3,121,3,0.5
1948,"Wrexham",3,42,60,56,62,-6,1.42857142857143,1.33333333333333,1.47619047619048,-0.142857142857143,63,19,44,88,87,80,-24,0
1948,"York City",3,42,54,74,74,0,1.28571428571429,1.76190476190476,1.76190476190476,0,70,26,44,88,88,72,-18,-0.2
1949,"Accrington Stanley",3,42,55,57,62,-5,1.30952380952381,1.35714285714286,1.47619047619048,-0.119047619047619,71,27,44,88,89,34,-18,0.3
1949,"AFC Bournemouth",3,42,58,57,56,1,1.38095238095238,1.35714285714286,1.33333333333333,0.0238095238095238,66,22,44,88,58,90,8,0.8
1949,"Aldershot",3,42,47,48,60,-12,1.11904761904762,1.14285714285714,1.42857142857143,-0.285714285714286,77,33,44,88,75,57,2,-0.4
1949,"Arsenal",1,42,68,79,55,24,1.61904761904762,1.88095238095238,1.30952380952381,0.571428571428571,5,5,22,22,5,116,0,-0.7
1949,"Aston Villa",1,42,57,61,61,0,1.35714285714286,1.45238095238095,1.45238095238095,0,12,12,22,22,19,121,-7,-1.1
1949,"Barnsley",2,42,52,64,67,-3,1.23809523809524,1.52380952380952,1.5952380952381,-0.0714285714285714,35,13,22,44,37,111,-2,-2.7
1949,"Barrow",3,42,51,47,53,-6,1.21428571428571,1.11904761904762,1.26190476190476,-0.142857142857143,75,31,44,88,78,44,-3,-1
1949,"Birmingham City",1,42,35,31,67,-36,0.833333333333333,0.738095238095238,1.5952380952381,-0.857142857142857,22,22,22,22,25,117,-3,0.3
1949,"Blackburn Rovers",2,42,52,55,60,-5,1.23809523809524,1.30952380952381,1.42857142857143,-0.119047619047619,36,14,22,44,28,121,8,2.1
1949,"Blackpool",1,42,66,46,35,11,1.57142857142857,1.0952380952381,0.833333333333333,0.261904761904762,8,8,22,22,3,112,5,-0.3
1949,"Bolton Wanderers",1,42,44,45,59,-14,1.04761904761905,1.07142857142857,1.4047619047619,-0.333333333333333,18,18,22,22,7,121,11,1.4
1949,"Bradford City",3,42,44,61,76,-15,1.04761904761905,1.45238095238095,1.80952380952381,-0.357142857142857,84,40,44,88,59,106,25,2.1
1949,"Bradford Park Avenue",2,42,41,51,77,-26,0.976190476190476,1.21428571428571,1.83333333333333,-0.619047619047619,43,21,22,44,55,51,-12,-3.6
1949,"Brentford",2,42,58,44,49,-5,1.38095238095238,1.04761904761905,1.16666666666667,-0.119047619047619,31,9,22,44,30,93,1,-1.7
1949,"Brighton & Hove Albion",3,42,60,57,69,-12,1.42857142857143,1.35714285714286,1.64285714285714,-0.285714285714286,62,18,44,88,73,93,-11,2.6
1949,"Bristol City",3,42,55,60,61,-1,1.30952380952381,1.42857142857143,1.45238095238095,-0.0238095238095238,72,28,44,88,61,108,11,2.8
1949,"Bristol Rovers",3,42,62,51,51,0,1.47619047619048,1.21428571428571,1.21428571428571,0,60,16,44,88,56,92,4,3.1
1949,"Burnley",1,42,61,40,40,0,1.45238095238095,0.952380952380952,0.952380952380952,0,10,10,22,22,10,121,0,0.9
1949,"Bury",2,42,51,60,65,-5,1.21428571428571,1.42857142857143,1.54761904761905,-0.119047619047619,38,16,22,44,41,114,-3,-1.1
1949,"Cardiff City",2,42,58,41,44,-3,1.38095238095238,0.976190476190476,1.04761904761905,-0.0714285714285714,32,10,22,44,27,93,5,0.8
1949,"Carlisle United",3,42,63,68,51,17,1.5,1.61904761904762,1.21428571428571,0.404761904761905,59,15,44,88,49,84,10,-2.7
1949,"Charlton Athletic",1,42,45,53,65,-12,1.07142857142857,1.26190476190476,1.54761904761905,-0.285714285714286,16,16,22,22,15,92,1,-1.4
1949,"Chelsea",1,42,52,58,65,-7,1.23809523809524,1.38095238095238,1.54761904761905,-0.166666666666667,14,14,22,22,20,104,-6,-0.3
1949,"Chester",3,42,57,70,79,-9,1.35714285714286,1.66666666666667,1.88095238095238,-0.214285714285714,68,24,44,88,68,67,0,-2
1949,"Chesterfield",2,42,54,43,47,-4,1.28571428571429,1.02380952380952,1.11904761904762,-0.0952380952380952,34,12,22,44,43,100,-9,-2.7
1949,"Coventry City",2,42,52,55,55,0,1.23809523809524,1.30952380952381,1.30952380952381,0,37,15,22,44,29,94,8,-1
1949,"Crewe Alexandra",3,42,65,68,55,13,1.54761904761905,1.61904761904762,1.30952380952381,0.30952380952381,57,13,44,88,64,96,-7,-2.5
1949,"Crystal Palace",3,42,59,55,54,1,1.4047619047619,1.30952380952381,1.28571428571429,0.0238095238095238,63,19,44,88,92,93,-29,-1.3
1949,"Darlington",3,42,46,56,69,-13,1.0952380952381,1.33333333333333,1.64285714285714,-0.30952380952381,82,38,44,88,81,81,1,-0.1
1949,"Derby County",1,42,61,69,61,8,1.45238095238095,1.64285714285714,1.45238095238095,0.19047619047619,11,11,22,22,11,121,0,-2.6
1949,"Doncaster Rovers",3,42,74,66,38,28,1.76190476190476,1.57142857142857,0.904761904761905,0.666666666666667,47,3,44,88,33,88,14,-3.7
1949,"Everton",1,42,44,42,66,-24,1.04761904761905,1,1.57142857142857,-0.571428571428571,19,19,22,22,21,121,-2,0.1
1949,"Exeter City",3,42,53,63,75,-12,1.26190476190476,1.5,1.78571428571429,-0.285714285714286,73,29,44,88,69,88,4,-0.4
1949,"Fulham",1,42,44,41,54,-13,1.04761904761905,0.976190476190476,1.28571428571429,-0.30952380952381,20,20,22,22,17,102,3,1.1
1949,"Gateshead",3,42,76,87,54,33,1.80952380952381,2.07142857142857,1.28571428571429,0.785714285714286,46,2,44,88,62,23,-16,-4.3
1949,"Grimsby Town",2,42,56,74,73,1,1.33333333333333,1.76190476190476,1.73809523809524,0.0238095238095238,33,11,22,44,44,110,-11,-1.7
1949,"Halifax Town",3,42,44,58,85,-27,1.04761904761905,1.38095238095238,2.02380952380952,-0.642857142857143,85,41,44,88,88,69,-3,2.6
1949,"Hartlepool United",3,42,47,52,79,-27,1.11904761904762,1.23809523809524,1.88095238095238,-0.642857142857143,78,34,44,88,76,89,2,-1.3
1949,"Huddersfield Town",1,42,51,52,73,-21,1.21428571428571,1.23809523809524,1.73809523809524,-0.5,15,15,22,22,16,99,-1,-1.3
1949,"Hull City",2,42,62,64,72,-8,1.47619047619048,1.52380952380952,1.71428571428571,-0.19047619047619,29,7,22,44,32,104,-3,-1.4
1949,"Ipswich Town",3,42,47,57,86,-29,1.11904761904762,1.35714285714286,2.04761904761905,-0.69047619047619,79,35,44,88,57,75,22,4.7
1949,"Leeds United",2,42,64,54,45,9,1.52380952380952,1.28571428571429,1.07142857142857,0.214285714285714,27,5,22,44,26,93,1,0.6
1949,"Leicester City",2,42,51,55,65,-10,1.21428571428571,1.30952380952381,1.54761904761905,-0.238095238095238,39,17,22,44,36,115,3,2.3
1949,"Leyton Orient",3,42,47,53,85,-32,1.11904761904762,1.26190476190476,2.02380952380952,-0.761904761904762,80,36,44,88,80,102,0,4.7
1949,"Lincoln City",3,42,72,60,39,21,1.71428571428571,1.42857142857143,0.928571428571429,0.5,48,4,44,88,50,107,-2,1.4
1949,"Liverpool",1,42,65,64,54,10,1.54761904761905,1.52380952380952,1.28571428571429,0.238095238095238,9,9,22,22,9,116,0,-1.6
1949,"Luton Town",2,42,48,41,51,-10,1.14285714285714,0.976190476190476,1.21428571428571,-0.238095238095238,40,18,22,44,42,91,-2,1.8
1949,"Manchester City",1,42,37,36,68,-32,0.880952380952381,0.857142857142857,1.61904761904762,-0.761904761904762,21,21,22,22,24,117,-3,0.8
1949,"Manchester United",1,42,68,69,44,25,1.61904761904762,1.64285714285714,1.04761904761905,0.595238095238095,6,6,22,22,2,117,4,-0.1
1949,"Mansfield Town",3,42,66,66,54,12,1.57142857142857,1.57142857142857,1.28571428571429,0.285714285714286,56,12,44,88,47,77,9,-0.9
1949,"Middlesbrough",1,42,67,59,48,11,1.5952380952381,1.4047619047619,1.14285714285714,0.261904761904762,7,7,22,22,6,110,1,-2
1949,"Millwall",3,42,46,55,63,-8,1.0952380952381,1.30952380952381,1.5,-0.19047619047619,83,39,44,88,53,93,30,0.8
1949,"New Brighton",3,42,52,45,63,-18,1.23809523809524,1.07142857142857,1.5,-0.428571428571429,74,30,44,88,90,21,-16,NA
1949,"Newcastle United",1,42,69,77,55,22,1.64285714285714,1.83333333333333,1.30952380952381,0.523809523809524,4,4,22,22,4,116,0,-0.4
1949,"Newport County",3,42,47,67,98,-31,1.11904761904762,1.5952380952381,2.33333333333333,-0.738095238095238,81,37,44,88,65,67,16,2.8
1949,"Northampton Town",3,42,71,72,50,22,1.69047619047619,1.71428571428571,1.19047619047619,0.523809523809524,50,6,44,88,87,93,-37,-2.3
1949,"Norwich City",3,42,58,65,63,2,1.38095238095238,1.54761904761905,1.5,0.0476190476190476,67,23,44,88,48,93,19,2.1
1949,"Nottingham Forest",3,42,69,67,39,28,1.64285714285714,1.5952380952381,0.928571428571429,0.666666666666667,52,8,44,88,46,117,6,3.2
1949,"Notts County",3,42,83,95,50,45,1.97619047619048,2.26190476190476,1.19047619047619,1.07142857142857,45,1,44,88,39,120,6,-2.5
1949,"Oldham Athletic",3,42,59,58,63,-5,1.4047619047619,1.38095238095238,1.5,-0.119047619047619,64,20,44,88,74,102,-10,-2.8
1949,"Plymouth Argyle",2,42,40,44,65,-21,0.952380952380952,1.04761904761905,1.54761904761905,-0.5,44,22,22,44,52,93,-8,0.4
1949,"Port Vale",3,42,56,47,42,5,1.33333333333333,1.11904761904762,1,0.119047619047619,69,25,44,88,67,107,2,1.4
1949,"Portsmouth",1,42,75,74,38,36,1.78571428571429,1.76190476190476,0.904761904761905,0.857142857142857,1,1,22,22,8,93,-7,-4.1
1949,"Preston North End",2,42,63,60,49,11,1.5,1.42857142857143,1.16666666666667,0.261904761904762,28,6,22,44,23,121,5,1.8
1949,"Queens Park Rangers",2,42,45,40,57,-17,1.07142857142857,0.952380952380952,1.35714285714286,-0.404761904761905,42,20,22,44,38,93,4,-1
1949,"Reading",3,42,59,70,64,6,1.4047619047619,1.66666666666667,1.52380952380952,0.142857142857143,65,21,44,88,54,93,11,0.5
1949,"Rochdale",3,42,72,68,41,27,1.71428571428571,1.61904761904762,0.976190476190476,0.642857142857143,49,5,44,88,66,92,-17,-3.1
1949,"Rotherham United",3,42,67,80,59,21,1.5952380952381,1.9047619047619,1.4047619047619,0.5,54,10,44,88,45,88,9,2.3
1949,"Sheffield United",2,42,71,68,49,19,1.69047619047619,1.61904761904762,1.16666666666667,0.452380952380952,24,2,22,44,31,117,-7,-0.2
1949,"Sheffield Wednesday",2,42,70,67,48,19,1.66666666666667,1.5952380952381,1.14285714285714,0.452380952380952,26,4,22,44,22,117,4,2.1
1949,"Southampton",2,42,71,64,48,16,1.69047619047619,1.52380952380952,1.14285714285714,0.380952380952381,25,3,22,44,34,93,-9,-2
1949,"Southend United",3,42,70,66,48,18,1.66666666666667,1.57142857142857,1.14285714285714,0.428571428571429,51,7,44,88,60,93,-9,-0.5
1949,"Southport",3,42,49,51,71,-20,1.16666666666667,1.21428571428571,1.69047619047619,-0.476190476190476,76,32,44,88,85,50,-9,-1.4
1949,"Stockport County",3,42,64,55,52,3,1.52380952380952,1.30952380952381,1.23809523809524,0.0714285714285714,58,14,44,88,63,99,-5,-2
1949,"Stoke City",1,42,45,45,75,-30,1.07142857142857,1.07142857142857,1.78571428571429,-0.714285714285714,17,17,22,22,12,113,5,-2.2
1949,"Sunderland",1,42,73,83,62,21,1.73809523809524,1.97619047619048,1.47619047619048,0.5,2,2,22,22,14,119,-12,-3.9
1949,"Swansea City",2,42,60,53,49,4,1.42857142857143,1.26190476190476,1.16666666666667,0.0952380952380952,30,8,22,44,40,93,-10,-0.5
1949,"Swindon Town",3,42,56,59,62,-3,1.33333333333333,1.4047619047619,1.47619047619048,-0.0714285714285714,70,26,44,88,70,93,0,1.3
1949,"Torquay United",3,42,67,66,63,3,1.5952380952381,1.57142857142857,1.5,0.0714285714285714,55,11,44,88,83,78,-28,-1.6
1949,"Tottenham Hotspur",2,42,88,81,35,46,2.0952380952381,1.92857142857143,0.833333333333333,1.0952380952381,23,1,22,44,1,101,22,2
1949,"Tranmere Rovers",3,42,68,51,48,3,1.61904761904762,1.21428571428571,1.14285714285714,0.0714285714285714,53,9,44,88,51,89,2,-1.1
1949,"Walsall",3,42,43,61,62,-1,1.02380952380952,1.45238095238095,1.47619047619048,-0.0238095238095238,86,42,44,88,77,100,9,1.7
1949,"Watford",3,42,61,45,35,10,1.45238095238095,1.07142857142857,0.833333333333333,0.238095238095238,61,17,44,88,91,93,-30,-1.1
1949,"West Bromwich Albion",1,42,54,47,53,-6,1.28571428571429,1.11904761904762,1.26190476190476,-0.142857142857143,13,13,22,22,18,121,-5,0.7
1949,"West Ham United",2,42,48,53,61,-8,1.14285714285714,1.26190476190476,1.45238095238095,-0.19047619047619,41,19,22,44,35,94,6,2.7
1949,"Wolverhampton Wanderers",1,42,73,76,49,27,1.73809523809524,1.80952380952381,1.16666666666667,0.642857142857143,3,3,22,22,13,121,-10,0.1
1949,"Wrexham",3,42,42,39,54,-15,1,0.928571428571429,1.28571428571429,-0.357142857142857,87,43,44,88,72,80,15,2
1949,"York City",3,42,40,52,70,-18,0.952380952380952,1.23809523809524,1.66666666666667,-0.428571428571429,88,44,44,88,84,72,4,2.2
1950,"Accrington Stanley",3,46,43,42,101,-59,0.934782608695652,0.91304347826087,2.19565217391304,-1.28260869565217,89,45,48,92,90,34,-1,0.3
1950,"AFC Bournemouth",3,46,73,65,57,8,1.58695652173913,1.41304347826087,1.23913043478261,0.173913043478261,58,14,48,92,71,90,-13,-0.4
1950,"Aldershot",3,46,55,56,88,-32,1.19565217391304,1.21739130434783,1.91304347826087,-0.695652173913043,75,31,48,92,67,57,8,-0.5
1950,"Arsenal",1,42,66,73,56,17,1.57142857142857,1.73809523809524,1.33333333333333,0.404761904761905,5,5,22,22,3,116,2,-0.6
1950,"Aston Villa",1,42,49,66,68,-2,1.16666666666667,1.57142857142857,1.61904761904762,-0.0476190476190476,19,19,22,22,6,121,13,1.1
1950,"Barnsley",2,42,55,74,68,6,1.30952380952381,1.76190476190476,1.61904761904762,0.142857142857143,37,15,22,44,43,111,-6,-1.3
1950,"Barrow",3,46,54,51,76,-25,1.17391304347826,1.10869565217391,1.65217391304348,-0.543478260869565,78,34,48,92,65,44,13,-1.2
1950,"Birmingham City",2,42,69,64,53,11,1.64285714285714,1.52380952380952,1.26190476190476,0.261904761904762,25,3,22,44,24,117,1,0.7
1950,"Blackburn Rovers",2,42,65,65,66,-1,1.54761904761905,1.54761904761905,1.57142857142857,-0.0238095238095238,28,6,22,44,33,121,-5,1.8
1950,"Blackpool",1,42,70,79,53,26,1.66666666666667,1.88095238095238,1.26190476190476,0.619047619047619,3,3,22,22,7,112,-4,-1.7
1950,"Bolton Wanderers",1,42,64,64,61,3,1.52380952380952,1.52380952380952,1.45238095238095,0.0714285714285714,7,7,22,22,5,121,2,-1.2
1950,"Bradford City",3,46,73,90,63,27,1.58695652173913,1.95652173913043,1.3695652173913,0.58695652173913,59,15,48,92,72,106,-13,-0.7
1950,"Bradford Park Avenue",3,46,77,90,72,18,1.67391304347826,1.95652173913043,1.56521739130435,0.391304347826087,55,11,48,92,61,51,-6,-1.6
1950,"Brentford",2,42,62,75,74,1,1.47619047619048,1.78571428571429,1.76190476190476,0.0238095238095238,30,8,22,44,34,93,-4,-3.1
1950,"Brighton & Hove Albion",3,46,56,71,79,-8,1.21739130434783,1.54347826086957,1.71739130434783,-0.173913043478261,73,29,48,92,50,93,23,3.5
1950,"Bristol City",3,46,71,64,59,5,1.54347826086957,1.39130434782609,1.28260869565217,0.108695652173913,61,17,48,92,74,108,-13,0.5
1950,"Bristol Rovers",3,46,75,64,42,22,1.6304347826087,1.39130434782609,0.91304347826087,0.478260869565217,56,12,48,92,57,92,-1,2
1950,"Burnley",1,42,56,48,43,5,1.33333333333333,1.14285714285714,1.02380952380952,0.119047619047619,10,10,22,22,12,121,-2,0.6
1950,"Bury",2,42,44,60,86,-26,1.04761904761905,1.42857142857143,2.04761904761905,-0.619047619047619,41,19,22,44,38,114,3,-0.4
1950,"Cardiff City",2,42,67,53,45,8,1.5952380952381,1.26190476190476,1.07142857142857,0.19047619047619,27,5,22,44,25,93,2,1.3
1950,"Carlisle United",3,46,87,79,50,29,1.89130434782609,1.71739130434783,1.08695652173913,0.630434782608696,49,5,48,92,60,84,-11,-3.9
1950,"Charlton Athletic",1,42,51,63,80,-17,1.21428571428571,1.5,1.9047619047619,-0.404761904761905,15,15,22,22,10,92,5,-1.6
1950,"Chelsea",1,42,44,53,65,-12,1.04761904761905,1.26190476190476,1.54761904761905,-0.285714285714286,20,20,22,22,18,104,2,0.8
1950,"Chester",3,46,60,62,64,-2,1.30434782608696,1.34782608695652,1.39130434782609,-0.0434782608695652,68,24,48,92,80,67,-12,-2.4
1950,"Chesterfield",2,42,39,44,69,-25,0.928571428571429,1.04761904761905,1.64285714285714,-0.595238095238095,43,21,22,44,68,100,-25,-2.5
1950,"Colchester United",3,46,54,63,76,-13,1.17391304347826,1.3695652173913,1.65217391304348,-0.282608695652174,79,35,48,92,66,68,13,1.2
1950,"Coventry City",2,42,64,75,59,16,1.52380952380952,1.78571428571429,1.4047619047619,0.380952380952381,29,7,22,44,41,94,-12,-2.9
1950,"Crewe Alexandra",3,46,67,61,60,1,1.45652173913043,1.32608695652174,1.30434782608696,0.0217391304347826,64,20,48,92,70,96,-6,-1.2
1950,"Crystal Palace",3,46,35,33,84,-51,0.760869565217391,0.717391304347826,1.82608695652174,-1.10869565217391,92,48,48,92,81,93,11,2.2
1950,"Darlington",3,46,52,59,77,-18,1.1304347826087,1.28260869565217,1.67391304347826,-0.391304347826087,81,37,48,92,91,81,-10,0.4
1950,"Derby County",1,42,56,81,75,6,1.33333333333333,1.92857142857143,1.78571428571429,0.142857142857143,11,11,22,22,15,121,-4,-2.3
1950,"Doncaster Rovers",2,42,58,64,68,-4,1.38095238095238,1.52380952380952,1.61904761904762,-0.0952380952380952,33,11,22,44,39,88,-6,-4.5
1950,"Everton",1,42,44,48,86,-38,1.04761904761905,1.14285714285714,2.04761904761905,-0.904761904761905,21,21,22,22,29,121,-8,1.6
1950,"Exeter City",3,46,60,62,85,-23,1.30434782608696,1.34782608695652,1.84782608695652,-0.5,69,25,48,92,86,88,-17,-2
1950,"Fulham",1,42,50,52,68,-16,1.19047619047619,1.23809523809524,1.61904761904762,-0.380952380952381,17,17,22,22,22,102,-5,0.2
1950,"Gateshead",3,46,71,84,62,22,1.54347826086957,1.82608695652174,1.34782608695652,0.478260869565217,62,18,48,92,55,23,7,NA
1950,"Gillingham",3,46,48,69,101,-32,1.04347826086957,1.5,2.19565217391304,-0.695652173913043,86,42,48,92,87,88,-1,0.1
1950,"Grimsby Town",2,42,36,61,95,-34,0.857142857142857,1.45238095238095,2.26190476190476,-0.80952380952381,44,22,22,44,46,110,-2,-0.7
1950,"Halifax Town",3,46,45,50,69,-19,0.978260869565217,1.08695652173913,1.5,-0.41304347826087,88,44,48,92,83,69,5,3.5
1950,"Hartlepool United",3,46,55,64,66,-2,1.19565217391304,1.39130434782609,1.43478260869565,-0.0434782608695652,76,32,48,92,58,89,18,-1.5
1950,"Huddersfield Town",1,42,51,64,92,-28,1.21428571428571,1.52380952380952,2.19047619047619,-0.666666666666667,16,16,22,22,21,99,-5,-2.5
1950,"Hull City",2,42,59,74,70,4,1.4047619047619,1.76190476190476,1.66666666666667,0.0952380952380952,32,10,22,44,40,104,-8,-2.2
1950,"Ipswich Town",3,46,75,69,58,11,1.6304347826087,1.5,1.26086956521739,0.239130434782609,57,13,48,92,75,75,-18,3.4
1950,"Leeds United",2,42,68,63,55,8,1.61904761904762,1.5,1.30952380952381,0.19047619047619,26,4,22,44,28,93,-2,-1.1
1950,"Leicester City",2,42,56,68,58,10,1.33333333333333,1.61904761904762,1.38095238095238,0.238095238095238,36,14,22,44,27,115,9,3
1950,"Leyton Orient",3,46,53,53,75,-22,1.15217391304348,1.15217391304348,1.6304347826087,-0.478260869565217,80,36,48,92,76,102,4,4.1
1950,"Lincoln City",3,46,83,89,58,31,1.80434782608696,1.93478260869565,1.26086956521739,0.673913043478261,50,6,48,92,45,107,5,0.6
1950,"Liverpool",1,42,59,53,59,-6,1.4047619047619,1.26190476190476,1.4047619047619,-0.142857142857143,9,9,22,22,13,116,-4,-1.6
1950,"Luton Town",2,42,41,57,70,-13,0.976190476190476,1.35714285714286,1.66666666666667,-0.30952380952381,42,20,22,44,30,91,12,0.7
1950,"Manchester City",2,42,71,89,61,28,1.69047619047619,2.11904761904762,1.45238095238095,0.666666666666667,24,2,22,44,16,117,8,0.8
1950,"Manchester United",1,42,80,74,40,34,1.9047619047619,1.76190476190476,0.952380952380952,0.80952380952381,2,2,22,22,1,117,1,-0.5
1950,"Mansfield Town",3,46,90,78,48,30,1.95652173913043,1.69565217391304,1.04347826086957,0.652173913043478,47,3,48,92,56,77,-9,-4
1950,"Middlesbrough",1,42,65,76,65,11,1.54761904761905,1.80952380952381,1.54761904761905,0.261904761904762,6,6,22,22,17,110,-11,-2.1
1950,"Millwall",3,46,79,80,57,23,1.71739130434783,1.73913043478261,1.23913043478261,0.5,53,9,48,92,52,93,1,-2.1
1950,"New Brighton",3,46,41,40,90,-50,0.891304347826087,0.869565217391304,1.95652173913043,-1.08695652173913,90,46,48,92,NA,21,NA,NA
1950,"Newcastle United",1,42,67,62,53,9,1.5952380952381,1.47619047619048,1.26190476190476,0.214285714285714,4,4,22,22,8,116,-4,-1.7
1950,"Newport County",3,46,66,77,70,7,1.43478260869565,1.67391304347826,1.52173913043478,0.152173913043478,65,21,48,92,54,67,11,1
1950,"Northampton Town",3,46,46,55,67,-12,1,1.19565217391304,1.45652173913043,-0.260869565217391,87,43,48,92,59,93,28,1.5
1950,"Norwich City",3,46,89,82,45,37,1.93478260869565,1.78260869565217,0.978260869565217,0.804347826086957,48,4,48,92,49,93,-1,2.2
1950,"Nottingham Forest",3,46,100,110,40,70,2.17391304347826,2.39130434782609,0.869565217391304,1.52173913043478,46,2,48,92,26,117,20,3.3
1950,"Notts County",2,42,52,61,60,1,1.23809523809524,1.45238095238095,1.42857142857143,0.0238095238095238,39,17,22,44,37,120,2,-0.9
1950,"Oldham Athletic",3,46,56,73,73,0,1.21739130434783,1.58695652173913,1.58695652173913,0,74,30,48,92,53,102,21,-0.5
1950,"Plymouth Argyle",3,46,81,85,55,30,1.76086956521739,1.84782608695652,1.19565217391304,0.652173913043478,52,8,48,92,47,93,5,2
1950,"Port Vale",3,46,61,60,65,-5,1.32608695652174,1.30434782608696,1.41304347826087,-0.108695652173913,67,23,48,92,77,107,-10,1.5
1950,"Portsmouth",1,42,63,71,68,3,1.5,1.69047619047619,1.61904761904762,0.0714285714285714,8,8,22,22,4,93,4,-3.5
1950,"Preston North End",2,42,83,91,49,42,1.97619047619048,2.16666666666667,1.16666666666667,1,23,1,22,44,9,121,14,0.1
1950,"Queens Park Rangers",2,42,55,71,82,-11,1.30952380952381,1.69047619047619,1.95238095238095,-0.261904761904762,38,16,22,44,44,93,-6,-0.9
1950,"Reading",3,46,78,88,53,35,1.69565217391304,1.91304347826087,1.15217391304348,0.760869565217391,54,10,48,92,48,93,6,-0.9
1950,"Rochdale",3,46,62,69,62,7,1.34782608695652,1.5,1.34782608695652,0.152173913043478,66,22,48,92,88,92,-22,-1.7
1950,"Rotherham United",3,46,102,103,41,62,2.21739130434783,2.23913043478261,0.891304347826087,1.34782608695652,45,1,48,92,31,88,14,0.5
1950,"Scunthorpe United",3,46,57,58,57,1,1.23913043478261,1.26086956521739,1.23913043478261,0.0217391304347826,71,27,48,92,73,70,-2,3.8
1950,"Sheffield United",2,42,60,72,62,10,1.42857142857143,1.71428571428571,1.47619047619048,0.238095238095238,31,9,22,44,32,117,-1,0.7
1950,"Sheffield Wednesday",1,42,44,64,83,-19,1.04761904761905,1.52380952380952,1.97619047619048,-0.452380952380952,22,22,22,22,23,117,-1,1.9
1950,"Shrewsbury Town",3,46,52,43,74,-31,1.1304347826087,0.934782608695652,1.60869565217391,-0.673913043478261,82,38,48,92,84,69,-2,2.5
1950,"Southampton",2,42,58,66,73,-7,1.38095238095238,1.57142857142857,1.73809523809524,-0.166666666666667,34,12,22,44,35,93,-1,0.4
1950,"Southend United",3,46,73,92,69,23,1.58695652173913,2,1.5,0.5,60,16,48,92,63,93,-3,-0.4
1950,"Southport",3,46,49,56,72,-16,1.06521739130435,1.21739130434783,1.56521739130435,-0.347826086956522,85,41,48,92,78,50,7,0.4
1950,"Stockport County",3,46,68,63,63,0,1.47826086956522,1.3695652173913,1.3695652173913,0,63,19,48,92,51,99,12,-1.9
1950,"Stoke City",1,42,53,50,59,-9,1.26190476190476,1.19047619047619,1.4047619047619,-0.214285714285714,12,12,22,22,20,113,-8,-3
1950,"Sunderland",1,42,52,63,73,-10,1.23809523809524,1.5,1.73809523809524,-0.238095238095238,14,14,22,22,11,119,3,-1.5
1950,"Swansea City",2,42,52,54,77,-23,1.23809523809524,1.28571428571429,1.83333333333333,-0.547619047619048,40,18,22,44,42,93,-2,1.2
1950,"Swindon Town",3,46,58,55,67,-12,1.26086956521739,1.19565217391304,1.45652173913043,-0.260869565217391,70,26,48,92,79,93,-9,1
1950,"Torquay United",3,46,51,64,81,-17,1.10869565217391,1.39130434782609,1.76086956521739,-0.369565217391304,83,39,48,92,69,78,14,2.4
1950,"Tottenham Hotspur",1,42,85,82,44,38,2.02380952380952,1.95238095238095,1.04761904761905,0.904761904761905,1,1,22,22,2,101,-1,0
1950,"Tranmere Rovers",3,46,83,83,62,21,1.80434782608696,1.80434782608696,1.34782608695652,0.456521739130435,51,7,48,92,62,89,-11,-1.4
1950,"Walsall",3,46,55,52,62,-10,1.19565217391304,1.1304347826087,1.34782608695652,-0.217391304347826,77,33,48,92,89,100,-12,3.1
1950,"Watford",3,46,38,54,88,-34,0.826086956521739,1.17391304347826,1.91304347826087,-0.739130434782609,91,47,48,92,85,93,6,4.2
1950,"West Bromwich Albion",1,42,50,53,61,-8,1.19047619047619,1.26190476190476,1.45238095238095,-0.19047619047619,18,18,22,22,14,121,4,0.9
1950,"West Ham United",2,42,58,68,69,-1,1.38095238095238,1.61904761904762,1.64285714285714,-0.0238095238095238,35,13,22,44,36,94,-1,1.8
1950,"Wolverhampton Wanderers",1,42,53,74,61,13,1.26190476190476,1.76190476190476,1.45238095238095,0.30952380952381,13,13,22,22,19,121,-6,1.1
1950,"Wrexham",3,46,57,55,71,-16,1.23913043478261,1.19565217391304,1.54347826086957,-0.347826086956522,72,28,48,92,82,80,-10,-1.2
1950,"York City",3,46,51,66,77,-11,1.10869565217391,1.43478260869565,1.67391304347826,-0.239130434782609,84,40,48,92,64,72,20,1.1
1951,"Accrington Stanley",3,46,42,61,92,-31,0.91304347826087,1.32608695652174,2,-0.673913043478261,90,46,48,92,91,34,-1,-0.2
1951,"AFC Bournemouth",3,46,58,69,75,-6,1.26086956521739,1.5,1.6304347826087,-0.130434782608696,71,27,48,92,63,90,8,2.2
1951,"Aldershot",3,46,62,78,89,-11,1.34782608695652,1.69565217391304,1.93478260869565,-0.239130434782609,67,23,48,92,82,57,-15,-0.6
1951,"Arsenal",1,42,74,80,61,19,1.76190476190476,1.9047619047619,1.45238095238095,0.452380952380952,3,3,22,22,1,116,2,-0.6
1951,"Aston Villa",1,42,66,79,70,9,1.57142857142857,1.88095238095238,1.66666666666667,0.214285714285714,6,6,22,22,11,121,-5,-0.1
1951,"Barnsley",2,42,47,59,72,-13,1.11904761904762,1.4047619047619,1.71428571428571,-0.30952380952381,43,21,22,44,44,111,-1,-2
1951,"Barrow",3,46,63,57,61,-4,1.3695652173913,1.23913043478261,1.32608695652174,-0.0869565217391304,65,21,48,92,74,44,-9,-1.3
1951,"Birmingham City",2,42,72,67,56,11,1.71428571428571,1.5952380952381,1.33333333333333,0.261904761904762,24,2,22,44,27,117,-3,0.7
1951,"Blackburn Rovers",2,42,57,54,63,-9,1.35714285714286,1.28571428571429,1.5,-0.214285714285714,33,11,22,44,29,121,4,1.7
1951,"Blackpool",1,42,63,64,64,0,1.5,1.52380952380952,1.52380952380952,0,7,7,22,22,6,112,1,-0.7
1951,"Bolton Wanderers",1,42,67,65,61,4,1.5952380952381,1.54761904761905,1.45238095238095,0.0952380952380952,5,5,22,22,12,121,-7,-0.5
1951,"Bradford City",3,46,58,61,68,-7,1.26086956521739,1.32608695652174,1.47826086956522,-0.152173913043478,72,28,48,92,75,106,-3,-0.2
1951,"Bradford Park Avenue",3,46,69,74,64,10,1.5,1.60869565217391,1.39130434782609,0.217391304347826,61,17,48,92,56,51,5,0.7
1951,"Brentford",2,42,57,54,55,-1,1.35714285714286,1.28571428571429,1.30952380952381,-0.0238095238095238,34,12,22,44,37,93,-3,-3.2
1951,"Brighton & Hove Albion",3,46,82,87,63,24,1.78260869565217,1.89130434782609,1.3695652173913,0.521739130434783,50,6,48,92,57,93,-7,0.6
1951,"Bristol City",3,46,57,58,69,-11,1.23913043478261,1.26086956521739,1.5,-0.239130434782609,74,30,48,92,49,108,25,2.4
1951,"Bristol Rovers",3,46,72,89,53,36,1.56521739130435,1.93478260869565,1.15217391304348,0.782608695652174,57,13,48,92,45,92,12,1.4
1951,"Burnley",1,42,55,56,63,-7,1.30952380952381,1.33333333333333,1.5,-0.166666666666667,12,12,22,22,7,121,5,1
1951,"Bury",2,42,52,67,69,-2,1.23809523809524,1.5952380952381,1.64285714285714,-0.0476190476190476,38,16,22,44,42,114,-4,0.6
1951,"Cardiff City",2,42,71,72,54,18,1.69047619047619,1.71428571428571,1.28571428571429,0.428571428571429,25,3,22,44,13,93,12,0.4
1951,"Carlisle United",3,46,70,62,57,5,1.52173913043478,1.34782608695652,1.23913043478261,0.108695652173913,60,16,48,92,61,84,-1,-1.2
1951,"Charlton Athletic",1,42,61,68,63,5,1.45238095238095,1.61904761904762,1.5,0.119047619047619,10,10,22,22,5,92,5,-2.6
1951,"Chelsea",1,42,50,52,72,-20,1.19047619047619,1.23809523809524,1.71428571428571,-0.476190476190476,18,18,22,22,19,104,-1,-0.4
1951,"Chester",3,46,54,72,85,-13,1.17391304347826,1.56521739130435,1.84782608695652,-0.282608695652174,80,36,48,92,86,67,-6,-1
1951,"Chesterfield",3,46,62,65,66,-1,1.34782608695652,1.41304347826087,1.43478260869565,-0.0217391304347826,68,24,48,92,65,100,3,-2
1951,"Colchester United",3,46,63,56,77,-21,1.3695652173913,1.21739130434783,1.67391304347826,-0.456521739130435,66,22,48,92,85,68,-19,-0.3
1951,"Coventry City",2,42,48,59,82,-23,1.14285714285714,1.4047619047619,1.95238095238095,-0.547619047619048,41,19,22,44,58,94,-17,-1.7
1951,"Crewe Alexandra",3,46,59,63,82,-19,1.28260869565217,1.3695652173913,1.78260869565217,-0.41304347826087,70,26,48,92,59,96,11,-0.9
1951,"Crystal Palace",3,46,54,61,80,-19,1.17391304347826,1.32608695652174,1.73913043478261,-0.41304347826087,81,37,48,92,76,93,5,2.2
1951,"Darlington",3,46,42,64,103,-39,0.91304347826087,1.39130434782609,2.23913043478261,-0.847826086956522,91,47,48,92,87,81,4,0.8
1951,"Derby County",1,42,52,63,80,-17,1.23809523809524,1.5,1.9047619047619,-0.404761904761905,15,15,22,22,22,121,-7,-2.3
1951,"Doncaster Rovers",2,42,51,55,60,-5,1.21428571428571,1.30952380952381,1.42857142857143,-0.119047619047619,39,17,22,44,35,88,4,-5
1951,"Everton",2,42,61,64,58,6,1.45238095238095,1.52380952380952,1.38095238095238,0.142857142857143,29,7,22,44,38,121,-9,2.5
1951,"Exeter City",3,46,48,65,86,-21,1.04347826086957,1.41304347826087,1.8695652173913,-0.456521739130435,86,42,48,92,81,88,5,0
1951,"Fulham",1,42,35,58,77,-19,0.833333333333333,1.38095238095238,1.83333333333333,-0.452380952380952,22,22,22,22,31,102,-9,0.2
1951,"Gateshead",3,46,74,66,49,17,1.60869565217391,1.43478260869565,1.06521739130435,0.369565217391304,55,11,48,92,64,23,-9,NA
1951,"Gillingham",3,46,46,71,81,-10,1,1.54347826086957,1.76086956521739,-0.217391304347826,87,43,48,92,83,88,4,0
1951,"Grimsby Town",3,46,95,96,45,51,2.06521739130435,2.08695652173913,0.978260869565217,1.10869565217391,46,2,48,92,53,110,-7,0
1951,"Halifax Town",3,46,49,61,97,-36,1.06521739130435,1.32608695652174,2.10869565217391,-0.782608695652174,83,39,48,92,68,69,15,2.3
1951,"Hartlepool United",3,46,71,71,65,6,1.54347826086957,1.54347826086957,1.41304347826087,0.130434782608696,58,14,48,92,70,89,-12,-3.3
1951,"Huddersfield Town",1,42,38,49,82,-33,0.904761904761905,1.16666666666667,1.95238095238095,-0.785714285714286,21,21,22,22,24,99,-3,-0.8
1951,"Hull City",2,42,50,60,70,-10,1.19047619047619,1.42857142857143,1.66666666666667,-0.238095238095238,40,18,22,44,39,104,1,-1.3
1951,"Ipswich Town",3,46,57,63,74,-11,1.23913043478261,1.3695652173913,1.60869565217391,-0.239130434782609,75,31,48,92,79,75,-4,7.4
1951,"Leeds United",2,42,65,59,57,2,1.54761904761905,1.4047619047619,1.35714285714286,0.0476190476190476,28,6,22,44,32,93,-4,-1.3
1951,"Leicester City",2,42,66,78,64,14,1.57142857142857,1.85714285714286,1.52380952380952,0.333333333333333,27,5,22,44,28,115,-1,1.4
1951,"Leyton Orient",3,46,57,55,68,-13,1.23913043478261,1.19565217391304,1.47826086956522,-0.282608695652174,76,32,48,92,77,102,-1,5.2
1951,"Lincoln City",3,46,99,121,52,69,2.15217391304348,2.6304347826087,1.1304347826087,1.5,45,1,48,92,40,107,5,-2.2
1951,"Liverpool",1,42,55,57,61,-4,1.30952380952381,1.35714285714286,1.45238095238095,-0.0952380952380952,13,13,22,22,17,116,-4,-1
1951,"Luton Town",2,42,60,77,78,-1,1.42857142857143,1.83333333333333,1.85714285714286,-0.0238095238095238,30,8,22,44,25,91,5,-0.3
1951,"Manchester City",1,42,52,58,61,-3,1.23809523809524,1.38095238095238,1.45238095238095,-0.0714285714285714,16,16,22,22,18,117,-2,0.5
1951,"Manchester United",1,42,80,95,52,43,1.9047619047619,2.26190476190476,1.23809523809524,1.02380952380952,1,1,22,22,8,117,-7,-1.4
1951,"Mansfield Town",3,46,74,73,60,13,1.60869565217391,1.58695652173913,1.30434782608696,0.282608695652174,56,12,48,92,71,77,-15,-2.8
1951,"Middlesbrough",1,42,51,64,88,-24,1.21428571428571,1.52380952380952,2.0952380952381,-0.571428571428571,17,17,22,22,14,110,3,-1.7
1951,"Millwall",3,46,81,74,53,21,1.76086956521739,1.60869565217391,1.15217391304348,0.456521739130435,52,8,48,92,47,93,5,-1.8
1951,"Newcastle United",1,42,63,98,73,25,1.5,2.33333333333333,1.73809523809524,0.595238095238095,8,8,22,22,16,116,-8,-2.9
1951,"Newport County",3,46,75,77,76,1,1.6304347826087,1.67391304347826,1.65217391304348,0.0217391304347826,54,10,48,92,78,67,-24,-1.4
1951,"Northampton Town",3,46,71,93,74,19,1.54347826086957,2.02173913043478,1.60869565217391,0.41304347826087,59,15,48,92,46,93,13,0.7
1951,"Norwich City",3,46,87,89,50,39,1.89130434782609,1.93478260869565,1.08695652173913,0.847826086956522,49,5,48,92,48,93,1,1
1951,"Nottingham Forest",2,42,67,77,62,15,1.5952380952381,1.83333333333333,1.47619047619048,0.357142857142857,26,4,22,44,30,117,-4,0.8
1951,"Notts County",2,42,55,71,68,3,1.30952380952381,1.69047619047619,1.61904761904762,0.0714285714285714,37,15,22,44,41,120,-4,-2
1951,"Oldham Athletic",3,46,81,90,61,29,1.76086956521739,1.95652173913043,1.32608695652174,0.630434782608696,53,9,48,92,50,102,3,-2.8
1951,"Plymouth Argyle",3,46,95,107,53,54,2.06521739130435,2.32608695652174,1.15217391304348,1.17391304347826,47,3,48,92,26,93,21,2
1951,"Port Vale",3,46,57,50,66,-16,1.23913043478261,1.08695652173913,1.43478260869565,-0.347826086956522,77,33,48,92,52,107,25,2.1
1951,"Portsmouth",1,42,68,68,58,10,1.61904761904762,1.61904761904762,1.38095238095238,0.238095238095238,4,4,22,22,15,93,-11,-4.1
1951,"Preston North End",1,42,63,74,54,20,1.5,1.76190476190476,1.28571428571429,0.476190476190476,9,9,22,22,2,121,7,-2.6
1951,"Queens Park Rangers",2,42,45,52,81,-29,1.07142857142857,1.23809523809524,1.92857142857143,-0.69047619047619,44,22,22,44,84,93,-40,-0.4
1951,"Reading",3,46,90,112,60,52,1.95652173913043,2.43478260869565,1.30434782608696,1.1304347826087,48,4,48,92,66,93,-18,-0.3
1951,"Rochdale",3,46,46,47,79,-32,1,1.02173913043478,1.71739130434783,-0.695652173913043,88,44,48,92,89,92,-1,1.1
1951,"Rotherham United",2,42,59,73,71,2,1.4047619047619,1.73809523809524,1.69047619047619,0.0476190476190476,31,9,22,44,33,88,-2,0
1951,"Scunthorpe United",3,46,58,65,74,-9,1.26086956521739,1.41304347826087,1.60869565217391,-0.195652173913043,73,29,48,92,72,70,1,4.7
1951,"Sheffield United",2,42,59,90,76,14,1.4047619047619,2.14285714285714,1.80952380952381,0.333333333333333,32,10,22,44,23,117,9,2.7
1951,"Sheffield Wednesday",2,42,74,100,66,34,1.76190476190476,2.38095238095238,1.57142857142857,0.80952380952381,23,1,22,44,20,117,3,1.7
1951,"Shrewsbury Town",3,46,49,62,86,-24,1.06521739130435,1.34782608695652,1.8695652173913,-0.521739130434783,84,40,48,92,88,69,-4,2
1951,"Southampton",2,42,56,61,73,-12,1.33333333333333,1.45238095238095,1.73809523809524,-0.285714285714286,35,13,22,44,43,93,-8,0.7
1951,"Southend United",3,46,67,75,66,9,1.45652173913043,1.6304347826087,1.43478260869565,0.195652173913043,63,19,48,92,62,93,1,0.2
1951,"Southport",3,46,56,53,71,-18,1.21739130434783,1.15217391304348,1.54347826086957,-0.391304347826087,78,34,48,92,55,50,23,-0.7
1951,"Stockport County",3,46,82,74,40,34,1.78260869565217,1.60869565217391,0.869565217391304,0.739130434782609,51,7,48,92,67,99,-16,-3.1
1951,"Stoke City",1,42,43,49,88,-39,1.02380952380952,1.16666666666667,2.0952380952381,-0.928571428571429,20,20,22,22,21,113,-1,-1
1951,"Sunderland",1,42,57,70,61,9,1.35714285714286,1.66666666666667,1.45238095238095,0.214285714285714,11,11,22,22,9,119,2,-1.4
1951,"Swansea City",2,42,48,72,76,-4,1.14285714285714,1.71428571428571,1.80952380952381,-0.0952380952380952,42,20,22,44,34,93,8,0
1951,"Swindon Town",3,46,56,51,68,-17,1.21739130434783,1.10869565217391,1.47826086956522,-0.369565217391304,79,35,48,92,80,93,-1,2.4
1951,"Torquay United",3,46,61,86,98,-12,1.32608695652174,1.8695652173913,2.1304347826087,-0.260869565217391,69,25,48,92,69,78,0,0.4
1951,"Tottenham Hotspur",1,42,75,76,51,25,1.78571428571429,1.80952380952381,1.21428571428571,0.595238095238095,2,2,22,22,10,101,-8,-0.1
1951,"Tranmere Rovers",3,46,69,76,71,5,1.5,1.65217391304348,1.54347826086957,0.108695652173913,62,18,48,92,60,89,2,-1.8
1951,"Walsall",3,46,44,55,94,-39,0.956521739130435,1.19565217391304,2.04347826086957,-0.847826086956522,89,45,48,92,92,100,-3,4.9
1951,"Watford",3,46,49,57,81,-24,1.06521739130435,1.23913043478261,1.76086956521739,-0.521739130434783,85,41,48,92,73,93,12,2.3
1951,"West Bromwich Albion",1,42,55,74,77,-3,1.30952380952381,1.76190476190476,1.83333333333333,-0.0714285714285714,14,14,22,22,3,121,11,0.2
1951,"West Ham United",2,42,56,67,77,-10,1.33333333333333,1.5952380952381,1.83333333333333,-0.238095238095238,36,14,22,44,36,94,0,2.8
1951,"Wolverhampton Wanderers",1,42,50,73,73,0,1.19047619047619,1.73809523809524,1.73809523809524,0,19,19,22,22,4,121,15,0
1951,"Workington",3,46,40,50,91,-41,0.869565217391304,1.08695652173913,1.97826086956522,-0.891304347826087,92,48,48,92,90,26,2,1.6
1951,"Wrexham",3,46,54,63,73,-10,1.17391304347826,1.3695652173913,1.58695652173913,-0.217391304347826,82,38,48,92,51,80,31,1.1
1951,"York City",3,46,67,73,52,21,1.45652173913043,1.58695652173913,1.1304347826087,0.456521739130435,64,20,48,92,54,72,10,-1.1
1952,"Accrington Stanley",3,46,35,39,89,-50,0.760869565217391,0.847826086956522,1.93478260869565,-1.08695652173913,91,47,48,92,75,34,16,NA
1952,"AFC Bournemouth",3,46,66,74,69,5,1.43478260869565,1.60869565217391,1.5,0.108695652173913,63,19,48,92,79,90,-16,1.3
1952,"Aldershot",3,46,51,61,77,-16,1.10869565217391,1.32608695652174,1.67391304347826,-0.347826086956522,82,38,48,92,73,57,9,0.2
1952,"Arsenal",1,42,75,97,64,33,1.78571428571429,2.30952380952381,1.52380952380952,0.785714285714286,1,1,22,22,12,116,-11,-0.6
1952,"Aston Villa",1,42,55,63,61,2,1.30952380952381,1.5,1.45238095238095,0.0476190476190476,11,11,22,22,13,121,-2,-0.3
1952,"Barnsley",2,42,23,47,108,-61,0.547619047619048,1.11904761904762,2.57142857142857,-1.45238095238095,44,22,22,44,48,111,-4,-1.8
1952,"Barrow",3,46,60,66,71,-5,1.30434782608696,1.43478260869565,1.54347826086957,-0.108695652173913,74,30,48,92,74,44,0,-0.3
1952,"Birmingham City",2,42,67,71,66,5,1.5952380952381,1.69047619047619,1.57142857142857,0.119047619047619,27,5,22,44,29,117,-2,0.7
1952,"Blackburn Rovers",2,42,62,68,65,3,1.47619047619048,1.61904761904762,1.54761904761905,0.0714285714285714,29,7,22,44,24,121,5,1.8
1952,"Blackpool",1,42,66,71,70,1,1.57142857142857,1.69047619047619,1.66666666666667,0.0238095238095238,6,6,22,22,4,112,2,-0.9
1952,"Bolton Wanderers",1,42,54,61,69,-8,1.28571428571429,1.45238095238095,1.64285714285714,-0.19047619047619,12,12,22,22,6,121,6,-0.5
1952,"Bradford City",3,46,60,75,80,-5,1.30434782608696,1.6304347826087,1.73913043478261,-0.108695652173913,75,31,48,92,52,106,23,-1.6
1952,"Bradford Park Avenue",3,46,69,75,61,14,1.5,1.6304347826087,1.32608695652174,0.304347826086957,56,12,48,92,61,51,-5,-0.9
1952,"Brentford",2,42,50,59,76,-17,1.19047619047619,1.4047619047619,1.80952380952381,-0.404761904761905,37,15,22,44,43,93,-6,-3.2
1952,"Brighton & Hove Albion",3,46,69,81,75,6,1.5,1.76086956521739,1.6304347826087,0.130434782608696,57,13,48,92,47,93,10,-0.9
1952,"Bristol City",3,46,81,95,61,34,1.76086956521739,2.06521739130435,1.32608695652174,0.739130434782609,49,5,48,92,49,108,0,-0.9
1952,"Bristol Rovers",3,46,90,92,46,46,1.95652173913043,2,1,1,45,1,48,92,31,92,14,-1.8
1952,"Burnley",1,42,66,67,52,15,1.57142857142857,1.5952380952381,1.23809523809524,0.357142857142857,7,7,22,22,5,121,2,0.4
1952,"Bury",2,42,48,53,81,-28,1.14285714285714,1.26190476190476,1.92857142857143,-0.666666666666667,42,20,22,44,39,114,3,1.4
1952,"Cardiff City",1,42,54,54,46,8,1.28571428571429,1.28571428571429,1.0952380952381,0.19047619047619,13,13,22,22,9,93,4,-1.8
1952,"Carlisle United",3,46,67,82,68,14,1.45652173913043,1.78260869565217,1.47826086956522,0.304347826086957,61,17,48,92,77,84,-16,-0.6
1952,"Charlton Athletic",1,42,68,77,63,14,1.61904761904762,1.83333333333333,1.5,0.333333333333333,5,5,22,22,8,92,-3,-3.7
1952,"Chelsea",1,42,47,56,66,-10,1.11904761904762,1.33333333333333,1.57142857142857,-0.238095238095238,19,19,22,22,11,104,8,-0.4
1952,"Chester",3,46,48,64,85,-21,1.04347826086957,1.39130434782609,1.84782608695652,-0.456521739130435,86,42,48,92,90,67,-4,-0.1
1952,"Chesterfield",3,46,65,65,63,2,1.41304347826087,1.41304347826087,1.3695652173913,0.0434782608695652,65,21,48,92,56,100,9,-2.1
1952,"Colchester United",3,46,50,59,76,-17,1.08695652173913,1.28260869565217,1.65217391304348,-0.369565217391304,85,41,48,92,91,68,-6,3
1952,"Coventry City",3,46,69,77,62,15,1.5,1.67391304347826,1.34782608695652,0.326086956521739,58,14,48,92,67,94,-9,1
1952,"Crewe Alexandra",3,46,68,70,68,2,1.47826086956522,1.52173913043478,1.47826086956522,0.0434782608695652,59,15,48,92,80,96,-21,-1.1
1952,"Crystal Palace",3,46,58,66,82,-16,1.26086956521739,1.43478260869565,1.78260869565217,-0.347826086956522,76,32,48,92,83,93,-7,2
1952,"Darlington",3,46,48,58,96,-38,1.04347826086957,1.26086956521739,2.08695652173913,-0.826086956521739,87,43,48,92,87,81,0,0.8
1952,"Derby County",1,42,43,59,74,-15,1.02380952380952,1.4047619047619,1.76190476190476,-0.357142857142857,22,22,22,22,40,121,-18,-1.8
1952,"Doncaster Rovers",2,42,52,58,64,-6,1.23809523809524,1.38095238095238,1.52380952380952,-0.142857142857143,35,13,22,44,33,88,2,-4.9
1952,"Everton",2,42,50,71,75,-4,1.19047619047619,1.69047619047619,1.78571428571429,-0.0952380952380952,38,16,22,44,25,121,13,3.7
1952,"Exeter City",3,46,53,61,71,-10,1.15217391304348,1.32608695652174,1.54347826086957,-0.217391304347826,81,37,48,92,62,88,19,-0.2
1952,"Fulham",2,42,61,81,71,10,1.45238095238095,1.92857142857143,1.69047619047619,0.238095238095238,31,9,22,44,30,102,1,1.5
1952,"Gateshead",3,46,66,76,60,16,1.43478260869565,1.65217391304348,1.30434782608696,0.347826086956522,64,20,48,92,51,23,13,NA
1952,"Gillingham",3,46,51,55,74,-19,1.10869565217391,1.19565217391304,1.60869565217391,-0.41304347826087,83,39,48,92,63,88,20,1
1952,"Grimsby Town",3,46,73,75,59,16,1.58695652173913,1.6304347826087,1.28260869565217,0.347826086956522,53,9,48,92,78,110,-25,1.2
1952,"Halifax Town",3,46,63,68,68,0,1.3695652173913,1.47826086956522,1.47826086956522,0,68,24,48,92,89,69,-21,0
1952,"Hartlepool United",3,46,62,57,61,-4,1.34782608695652,1.23913043478261,1.32608695652174,-0.0869565217391304,70,26,48,92,85,89,-15,-2.2
1952,"Huddersfield Town",2,42,82,84,33,51,1.95238095238095,2,0.785714285714286,1.21428571428571,24,2,22,44,3,99,21,-0.5
1952,"Hull City",2,42,50,57,69,-12,1.19047619047619,1.35714285714286,1.64285714285714,-0.285714285714286,39,17,22,44,34,104,5,-1.5
1952,"Ipswich Town",3,46,54,60,69,-9,1.17391304347826,1.30434782608696,1.5,-0.195652173913043,79,35,48,92,46,75,33,6.1
1952,"Leeds United",2,42,57,71,63,8,1.35714285714286,1.69047619047619,1.5,0.19047619047619,32,10,22,44,32,93,0,0.5
1952,"Leicester City",2,42,66,89,74,15,1.57142857142857,2.11904761904762,1.76190476190476,0.357142857142857,28,6,22,44,23,115,5,2.4
1952,"Leyton Orient",3,46,58,68,73,-5,1.26086956521739,1.47826086956522,1.58695652173913,-0.108695652173913,77,33,48,92,65,102,12,5.5
1952,"Lincoln City",2,42,50,64,71,-7,1.19047619047619,1.52380952380952,1.69047619047619,-0.166666666666667,40,18,22,44,38,107,2,-5
1952,"Liverpool",1,42,50,61,82,-21,1.19047619047619,1.45238095238095,1.95238095238095,-0.5,17,17,22,22,22,116,-5,0.9
1952,"Luton Town",2,42,74,84,49,35,1.76190476190476,2,1.16666666666667,0.833333333333333,25,3,22,44,28,91,-3,-1.9
1952,"Manchester City",1,42,49,72,87,-15,1.16666666666667,1.71428571428571,2.07142857142857,-0.357142857142857,18,18,22,22,17,117,1,-0.3
1952,"Manchester United",1,42,64,69,72,-3,1.52380952380952,1.64285714285714,1.71428571428571,-0.0714285714285714,8,8,22,22,7,117,1,-1.1
1952,"Mansfield Town",3,46,62,55,62,-7,1.34782608695652,1.19565217391304,1.34782608695652,-0.152173913043478,71,27,48,92,57,77,14,-0.1
1952,"Middlesbrough",1,42,53,70,77,-7,1.26190476190476,1.66666666666667,1.83333333333333,-0.166666666666667,14,14,22,22,21,110,-7,-1.2
1952,"Millwall",3,46,86,82,44,38,1.8695652173913,1.78260869565217,0.956521739130435,0.826086956521739,47,3,48,92,64,93,-17,-1.4
1952,"Newcastle United",1,42,51,59,70,-11,1.21428571428571,1.4047619047619,1.66666666666667,-0.261904761904762,16,16,22,22,16,116,0,-1.4
1952,"Newport County",3,46,58,70,82,-12,1.26086956521739,1.52173913043478,1.78260869565217,-0.260869565217391,78,34,48,92,68,67,10,-1.1
1952,"Northampton Town",3,46,88,109,70,39,1.91304347826087,2.3695652173913,1.52173913043478,0.847826086956522,46,2,48,92,58,93,-12,0.1
1952,"Norwich City",3,46,85,99,55,44,1.84782608695652,2.15217391304348,1.19565217391304,0.956521739130435,48,4,48,92,59,93,-11,1.5
1952,"Nottingham Forest",2,42,62,77,67,10,1.47619047619048,1.83333333333333,1.5952380952381,0.238095238095238,30,8,22,44,26,117,4,2.1
1952,"Notts County",2,42,50,60,88,-28,1.19047619047619,1.42857142857143,2.0952380952381,-0.666666666666667,41,19,22,44,37,120,4,-1
1952,"Oldham Athletic",3,46,81,77,45,32,1.76086956521739,1.67391304347826,0.978260869565217,0.695652173913043,50,6,48,92,44,102,6,-2.1
1952,"Plymouth Argyle",2,42,69,65,60,5,1.64285714285714,1.54761904761905,1.42857142857143,0.119047619047619,26,4,22,44,42,93,-16,-0.9
1952,"Port Vale",3,46,78,67,35,32,1.69565217391304,1.45652173913043,0.760869565217391,0.695652173913043,52,8,48,92,45,107,7,0.5
1952,"Portsmouth",1,42,52,74,83,-9,1.23809523809524,1.76190476190476,1.97619047619048,-0.214285714285714,15,15,22,22,14,93,1,-2.3
1952,"Preston North End",1,42,75,85,60,25,1.78571428571429,2.02380952380952,1.42857142857143,0.595238095238095,2,2,22,22,10,121,-8,-3.7
1952,"Queens Park Rangers",3,46,51,61,82,-21,1.10869565217391,1.32608695652174,1.78260869565217,-0.456521739130435,84,40,48,92,76,93,8,2.7
1952,"Reading",3,46,65,69,64,5,1.41304347826087,1.5,1.39130434782609,0.108695652173913,66,22,48,92,60,93,6,0.2
1952,"Rochdale",3,46,47,62,83,-21,1.02173913043478,1.34782608695652,1.80434782608696,-0.456521739130435,89,45,48,92,81,92,8,1.4
1952,"Rotherham United",2,42,57,75,74,1,1.35714285714286,1.78571428571429,1.76190476190476,0.0238095238095238,33,11,22,44,27,88,6,-0.3
1952,"Scunthorpe United",3,46,62,62,56,6,1.34782608695652,1.34782608695652,1.21739130434783,0.130434782608696,72,28,48,92,50,70,22,4
1952,"Sheffield United",2,42,85,97,55,42,2.02380952380952,2.30952380952381,1.30952380952381,1,23,1,22,44,20,117,3,1.3
1952,"Sheffield Wednesday",1,42,47,62,72,-10,1.11904761904762,1.47619047619048,1.71428571428571,-0.238095238095238,20,20,22,22,18,117,2,1.4
1952,"Shrewsbury Town",3,46,48,68,91,-23,1.04347826086957,1.47826086956522,1.97826086956522,-0.5,88,44,48,92,84,69,4,2.9
1952,"Southampton",2,42,43,68,85,-17,1.02380952380952,1.61904761904762,2.02380952380952,-0.404761904761905,43,21,22,44,53,93,-10,0.9
1952,"Southend United",3,46,67,69,74,-5,1.45652173913043,1.5,1.60869565217391,-0.108695652173913,62,18,48,92,71,93,-9,1
1952,"Southport",3,46,71,63,60,3,1.54347826086957,1.3695652173913,1.30434782608696,0.0652173913043478,55,11,48,92,69,50,-14,-2.6
1952,"Stockport County",3,46,64,82,69,13,1.39130434782609,1.78260869565217,1.5,0.282608695652174,67,23,48,92,66,99,1,-1.8
1952,"Stoke City",1,42,46,53,66,-13,1.0952380952381,1.26190476190476,1.57142857142857,-0.30952380952381,21,21,22,22,36,113,-15,-0.3
1952,"Sunderland",1,42,58,68,82,-14,1.38095238095238,1.61904761904762,1.95238095238095,-0.333333333333333,9,9,22,22,19,119,-10,-1.6
1952,"Swansea City",2,42,57,78,81,-3,1.35714285714286,1.85714285714286,1.92857142857143,-0.0714285714285714,34,12,22,44,41,93,-7,-0.3
1952,"Swindon Town",3,46,54,64,79,-15,1.17391304347826,1.39130434782609,1.71739130434783,-0.326086956521739,80,36,48,92,82,93,-2,3.4
1952,"Torquay United",3,46,63,87,88,-1,1.3695652173913,1.89130434782609,1.91304347826087,-0.0217391304347826,69,25,48,92,70,78,-1,-0.5
1952,"Tottenham Hotspur",1,42,56,78,69,9,1.33333333333333,1.85714285714286,1.64285714285714,0.214285714285714,10,10,22,22,15,101,-5,0.8
1952,"Tranmere Rovers",3,46,68,65,63,2,1.47826086956522,1.41304347826087,1.3695652173913,0.0434782608695652,60,16,48,92,72,89,-12,-1.6
1952,"Walsall",3,46,31,56,118,-62,0.673913043478261,1.21739130434783,2.56521739130435,-1.34782608695652,92,48,48,92,92,100,0,4.9
1952,"Watford",3,46,62,62,63,-1,1.34782608695652,1.34782608695652,1.3695652173913,-0.0217391304347826,73,29,48,92,54,93,19,1.3
1952,"West Bromwich Albion",1,42,71,66,60,6,1.69047619047619,1.57142857142857,1.42857142857143,0.142857142857143,3,3,22,22,2,121,1,-0.9
1952,"West Ham United",2,42,52,58,60,-2,1.23809523809524,1.38095238095238,1.42857142857143,-0.0476190476190476,36,14,22,44,35,94,1,2.3
1952,"Wolverhampton Wanderers",1,42,70,86,63,23,1.66666666666667,2.04761904761905,1.5,0.547619047619048,4,4,22,22,1,121,3,-0.1
1952,"Workington",3,46,43,55,91,-36,0.934782608695652,1.19565217391304,1.97826086956522,-0.782608695652174,90,46,48,92,86,26,4,1.2
1952,"Wrexham",3,46,80,86,66,20,1.73913043478261,1.8695652173913,1.43478260869565,0.434782608695652,51,7,48,92,55,80,-4,-0.2
1952,"York City",3,46,73,60,45,15,1.58695652173913,1.30434782608696,0.978260869565217,0.326086956521739,54,10,48,92,88,72,-34,-2.8
1953,"Accrington Stanley",3,46,58,66,74,-8,1.26086956521739,1.43478260869565,1.60869565217391,-0.173913043478261,75,31,48,92,48,34,27,NA
1953,"AFC Bournemouth",3,46,56,67,70,-3,1.21739130434783,1.45652173913043,1.52173913043478,-0.0652173913043478,79,35,48,92,78,90,1,3.1
1953,"Aldershot",3,46,60,74,86,-12,1.30434782608696,1.60869565217391,1.8695652173913,-0.260869565217391,73,29,48,92,71,57,2,-0.4
1953,"Arsenal",1,42,58,75,73,2,1.38095238095238,1.78571428571429,1.73809523809524,0.0476190476190476,12,12,22,22,8,116,4,0.4
1953,"Aston Villa",1,42,57,70,68,2,1.35714285714286,1.66666666666667,1.61904761904762,0.0476190476190476,13,13,22,22,2,121,11,-0.6
1953,"Barnsley",3,46,82,77,57,20,1.78260869565217,1.67391304347826,1.23913043478261,0.434782608695652,48,4,48,92,46,111,2,-1.7
1953,"Barrow",3,46,60,72,71,1,1.30434782608696,1.56521739130435,1.54347826086957,0.0217391304347826,74,30,48,92,75,44,-1,-1.8
1953,"Birmingham City",2,42,65,78,58,20,1.54761904761905,1.85714285714286,1.38095238095238,0.476190476190476,29,7,22,44,25,117,4,0.9
1953,"Blackburn Rovers",2,42,78,86,50,36,1.85714285714286,2.04761904761905,1.19047619047619,0.857142857142857,24,2,22,44,28,121,-4,1.7
1953,"Blackpool",1,42,67,80,69,11,1.5952380952381,1.9047619047619,1.64285714285714,0.261904761904762,4,4,22,22,18,112,-14,-1.4
1953,"Bolton Wanderers",1,42,66,75,60,15,1.57142857142857,1.78571428571429,1.42857142857143,0.357142857142857,6,6,22,22,19,121,-13,-1.5
1953,"Bradford City",3,46,75,60,55,5,1.6304347826087,1.30434782608696,1.19565217391304,0.108695652173913,52,8,48,92,83,106,-31,-2
1953,"Bradford Park Avenue",3,46,68,77,68,9,1.47826086956522,1.67391304347826,1.47826086956522,0.195652173913043,61,17,48,92,76,51,-15,-2
1953,"Brentford",2,42,41,40,78,-38,0.976190476190476,0.952380952380952,1.85714285714286,-0.904761904761905,43,21,22,44,70,93,-27,-1.7
1953,"Brighton & Hove Albion",3,46,87,86,61,25,1.89130434782609,1.8695652173913,1.32608695652174,0.543478260869565,47,3,48,92,57,93,-10,-2.9
1953,"Bristol City",3,46,81,88,66,22,1.76086956521739,1.91304347826087,1.43478260869565,0.478260869565217,49,5,48,92,45,108,4,0
1953,"Bristol Rovers",2,42,58,64,58,6,1.38095238095238,1.52380952380952,1.38095238095238,0.142857142857143,31,9,22,44,30,92,1,-2.2
1953,"Burnley",1,42,67,78,67,11,1.5952380952381,1.85714285714286,1.5952380952381,0.261904761904762,5,5,22,22,9,121,-4,-0.4
1953,"Bury",2,42,47,54,72,-18,1.11904761904762,1.28571428571429,1.71428571428571,-0.428571428571429,39,17,22,44,35,114,4,0
1953,"Cardiff City",1,42,62,51,71,-20,1.47619047619048,1.21428571428571,1.69047619047619,-0.476190476190476,9,9,22,22,20,93,-11,-2.7
1953,"Carlisle United",3,46,57,83,71,12,1.23913043478261,1.80434782608696,1.54347826086957,0.260869565217391,77,33,48,92,80,84,-3,0.8
1953,"Charlton Athletic",1,42,63,75,77,-2,1.5,1.78571428571429,1.83333333333333,-0.0476190476190476,8,8,22,22,16,92,-8,-1.8
1953,"Chelsea",1,42,60,74,68,6,1.42857142857143,1.76190476190476,1.61904761904762,0.142857142857143,11,11,22,22,1,104,10,0.6
1953,"Chester",3,46,43,48,67,-19,0.934782608695652,1.04347826086957,1.45652173913043,-0.41304347826087,90,46,48,92,89,67,1,1.1
1953,"Chesterfield",3,46,71,76,64,12,1.54347826086957,1.65217391304348,1.39130434782609,0.260869565217391,56,12,48,92,53,100,3,-2.7
1953,"Colchester United",3,46,40,50,78,-28,0.869565217391304,1.08695652173913,1.69565217391304,-0.608695652173913,91,47,48,92,92,68,-1,2.9
1953,"Coventry City",3,46,63,61,56,5,1.3695652173913,1.32608695652174,1.21739130434783,0.108695652173913,67,23,48,92,63,94,4,2.1
1953,"Crewe Alexandra",3,46,55,49,67,-18,1.19565217391304,1.06521739130435,1.45652173913043,-0.391304347826087,80,36,48,92,90,96,-10,1.4
1953,"Crystal Palace",3,46,54,60,86,-26,1.17391304347826,1.30434782608696,1.8695652173913,-0.565217391304348,83,39,48,92,84,93,-1,3.8
1953,"Darlington",3,46,50,50,71,-21,1.08695652173913,1.08695652173913,1.54347826086957,-0.456521739130435,87,43,48,92,77,81,10,0
1953,"Derby County",2,42,47,64,82,-18,1.11904761904762,1.52380952380952,1.95238095238095,-0.428571428571429,40,18,22,44,44,121,-4,0.5
1953,"Doncaster Rovers",2,42,57,59,63,-4,1.35714285714286,1.4047619047619,1.5,-0.0952380952380952,33,11,22,44,38,88,-5,-5.1
1953,"Everton",2,42,76,92,58,34,1.80952380952381,2.19047619047619,1.38095238095238,0.80952380952381,25,3,22,44,11,121,14,2.2
1953,"Exeter City",3,46,68,68,58,10,1.47826086956522,1.47826086956522,1.26086956521739,0.217391304347826,62,18,48,92,86,88,-24,-1.1
1953,"Fulham",2,42,61,98,85,13,1.45238095238095,2.33333333333333,2.02380952380952,0.30952380952381,30,8,22,44,37,102,-7,1.5
1953,"Gateshead",3,46,76,74,55,19,1.65217391304348,1.60869565217391,1.19565217391304,0.41304347826087,51,7,48,92,55,23,-4,NA
1953,"Gillingham",3,46,67,61,66,-5,1.45652173913043,1.32608695652174,1.43478260869565,-0.108695652173913,63,19,48,92,54,88,9,-0.7
1953,"Grimsby Town",3,46,57,51,77,-26,1.23913043478261,1.10869565217391,1.67391304347826,-0.565217391304348,78,34,48,92,88,110,-10,3.6
1953,"Halifax Town",3,46,46,44,73,-29,1,0.956521739130435,1.58695652173913,-0.630434782608696,89,45,48,92,73,69,16,0.9
1953,"Hartlepool United",3,46,53,59,65,-6,1.15217391304348,1.28260869565217,1.41304347826087,-0.130434782608696,85,41,48,92,52,89,33,-0.6
1953,"Huddersfield Town",1,42,71,78,61,17,1.69047619047619,1.85714285714286,1.45238095238095,0.404761904761905,3,3,22,22,17,99,-14,-3.1
1953,"Hull City",2,42,54,64,66,-2,1.28571428571429,1.52380952380952,1.57142857142857,-0.0476190476190476,34,12,22,44,41,104,-7,-2
1953,"Ipswich Town",3,46,91,82,51,31,1.97826086956522,1.78260869565217,1.10869565217391,0.673913043478261,46,2,48,92,43,75,3,2.4
1953,"Leeds United",2,42,58,89,81,8,1.38095238095238,2.11904761904762,1.92857142857143,0.19047619047619,32,10,22,44,26,93,6,0.9
1953,"Leicester City",2,42,79,97,60,37,1.88095238095238,2.30952380952381,1.42857142857143,0.880952380952381,23,1,22,44,21,115,2,1.3
1953,"Leyton Orient",3,46,65,79,73,6,1.41304347826087,1.71739130434783,1.58695652173913,0.130434782608696,65,21,48,92,47,102,18,2.7
1953,"Lincoln City",2,42,51,65,83,-18,1.21428571428571,1.54761904761905,1.97619047619048,-0.428571428571429,38,16,22,44,39,107,-1,-4
1953,"Liverpool",1,42,37,68,97,-29,0.880952380952381,1.61904761904762,2.30952380952381,-0.69047619047619,22,22,22,22,34,116,-12,2.1
1953,"Luton Town",2,42,66,64,59,5,1.57142857142857,1.52380952380952,1.4047619047619,0.119047619047619,28,6,22,44,24,91,4,-3.3
1953,"Manchester City",1,42,51,62,77,-15,1.21428571428571,1.47619047619048,1.83333333333333,-0.357142857142857,17,17,22,22,6,117,11,-1.2
1953,"Manchester United",1,42,66,73,58,15,1.57142857142857,1.73809523809524,1.38095238095238,0.357142857142857,7,7,22,22,3,117,4,0.5
1953,"Mansfield Town",3,46,71,88,67,21,1.54347826086957,1.91304347826087,1.45652173913043,0.456521739130435,57,13,48,92,68,77,-11,0.6
1953,"Middlesbrough",1,42,40,60,91,-31,0.952380952380952,1.42857142857143,2.16666666666667,-0.738095238095238,21,21,22,22,32,110,-11,-1.2
1953,"Millwall",3,46,66,74,77,-3,1.43478260869565,1.60869565217391,1.67391304347826,-0.0652173913043478,64,20,48,92,56,93,8,0
1953,"Newcastle United",1,42,52,72,77,-5,1.23809523809524,1.71428571428571,1.83333333333333,-0.119047619047619,16,16,22,22,10,116,6,-1.2
1953,"Newport County",3,46,63,61,81,-20,1.3695652173913,1.32608695652174,1.76086956521739,-0.434782608695652,68,24,48,92,85,67,-17,-1.4
1953,"Northampton Town",3,46,71,82,55,27,1.54347826086957,1.78260869565217,1.19565217391304,0.58695652173913,58,14,48,92,64,93,-6,2.6
1953,"Norwich City",3,46,71,73,66,7,1.54347826086957,1.58695652173913,1.43478260869565,0.152173913043478,59,15,48,92,66,93,-7,1.9
1953,"Nottingham Forest",2,42,72,86,59,27,1.71428571428571,2.04761904761905,1.4047619047619,0.642857142857143,26,4,22,44,36,117,-10,1.3
1953,"Notts County",2,42,52,54,74,-20,1.23809523809524,1.28571428571429,1.76190476190476,-0.476190476190476,37,15,22,44,29,120,8,-3.1
1953,"Oldham Athletic",2,42,33,40,89,-49,0.785714285714286,0.952380952380952,2.11904761904762,-1.16666666666667,44,22,22,44,60,102,-16,-0.8
1953,"Plymouth Argyle",2,42,43,65,82,-17,1.02380952380952,1.54761904761905,1.95238095238095,-0.404761904761905,42,20,22,44,42,93,0,-0.1
1953,"Port Vale",3,46,95,74,21,53,2.06521739130435,1.60869565217391,0.456521739130435,1.15217391304348,45,1,48,92,40,107,5,-1.3
1953,"Portsmouth",1,42,53,81,89,-8,1.26190476190476,1.92857142857143,2.11904761904762,-0.19047619047619,14,14,22,22,5,93,9,-1.7
1953,"Preston North End",1,42,62,87,58,29,1.47619047619048,2.07142857142857,1.38095238095238,0.69047619047619,10,10,22,22,13,121,-3,-1.5
1953,"Queens Park Rangers",3,46,58,60,68,-8,1.26086956521739,1.30434782608696,1.47826086956522,-0.173913043478261,76,32,48,92,72,93,4,1.9
1953,"Reading",3,46,69,86,73,13,1.5,1.8695652173913,1.58695652173913,0.282608695652174,60,16,48,92,79,93,-19,1
1953,"Rochdale",3,46,55,59,77,-18,1.19565217391304,1.28260869565217,1.67391304347826,-0.391304347826087,81,37,48,92,65,92,16,-0.8
1953,"Rotherham United",2,42,70,80,67,13,1.66666666666667,1.9047619047619,1.5952380952381,0.30952380952381,27,5,22,44,23,88,4,-0.3
1953,"Scunthorpe United",3,46,78,77,56,21,1.69565217391304,1.67391304347826,1.21739130434783,0.456521739130435,50,6,48,92,51,70,-1,0.6
1953,"Sheffield United",1,42,44,69,90,-21,1.04761904761905,1.64285714285714,2.14285714285714,-0.5,20,20,22,22,12,117,8,0.9
1953,"Sheffield Wednesday",1,42,51,70,91,-21,1.21428571428571,1.66666666666667,2.16666666666667,-0.5,18,18,22,22,22,117,-4,1.2
1953,"Shrewsbury Town",3,46,54,65,76,-11,1.17391304347826,1.41304347826087,1.65217391304348,-0.239130434782609,84,40,48,92,74,69,10,2.8
1953,"Southampton",3,46,73,76,63,13,1.58695652173913,1.65217391304348,1.3695652173913,0.282608695652174,53,9,48,92,49,93,4,2.6
1953,"Southend United",3,46,61,69,71,-2,1.32608695652174,1.5,1.54347826086957,-0.0434782608695652,71,27,48,92,69,93,2,1.2
1953,"Southport",3,46,63,63,60,3,1.3695652173913,1.3695652173913,1.30434782608696,0.0652173913043478,69,25,48,92,67,50,2,-1.9
1953,"Stockport County",3,46,65,77,67,10,1.41304347826087,1.67391304347826,1.45652173913043,0.217391304347826,66,22,48,92,61,99,5,-1.9
1953,"Stoke City",2,42,53,71,60,11,1.26190476190476,1.69047619047619,1.42857142857143,0.261904761904762,36,14,22,44,27,113,9,2
1953,"Sunderland",1,42,50,81,89,-8,1.19047619047619,1.92857142857143,2.11904761904762,-0.19047619047619,19,19,22,22,7,119,12,-0.5
1953,"Swansea City",2,42,47,58,82,-24,1.11904761904762,1.38095238095238,1.95238095238095,-0.571428571428571,41,19,22,44,33,93,8,0
1953,"Swindon Town",3,46,55,67,70,-3,1.19565217391304,1.45652173913043,1.52173913043478,-0.0652173913043478,82,38,48,92,87,93,-5,4.5
1953,"Torquay United",3,46,63,81,88,-7,1.3695652173913,1.76086956521739,1.91304347826087,-0.152173913043478,70,26,48,92,62,78,8,-0.4
1953,"Tottenham Hotspur",1,42,53,65,76,-11,1.26190476190476,1.54761904761905,1.80952380952381,-0.261904761904762,15,15,22,22,14,101,1,1.1
1953,"Tranmere Rovers",3,46,61,59,70,-11,1.32608695652174,1.28260869565217,1.52173913043478,-0.239130434782609,72,28,48,92,82,89,-10,-0.3
1953,"Walsall",3,46,35,40,87,-47,0.760869565217391,0.869565217391304,1.89130434782609,-1.02173913043478,92,48,48,92,91,100,1,2.9
1953,"Watford",3,46,73,85,69,16,1.58695652173913,1.84782608695652,1.5,0.347826086956522,54,10,48,92,58,93,-4,0.7
1953,"West Bromwich Albion",1,42,75,86,63,23,1.78571428571429,2.04761904761905,1.5,0.547619047619048,2,2,22,22,15,121,-13,-1
1953,"West Ham United",2,42,54,67,69,-2,1.28571428571429,1.5952380952381,1.64285714285714,-0.0476190476190476,35,13,22,44,31,94,4,2.1
1953,"Wolverhampton Wanderers",1,42,82,96,56,40,1.95238095238095,2.28571428571429,1.33333333333333,0.952380952380952,1,1,22,22,4,121,-3,-1.6
1953,"Workington",3,46,53,59,80,-21,1.15217391304348,1.28260869565217,1.73913043478261,-0.456521739130435,86,42,48,92,59,26,27,1.5
1953,"Wrexham",3,46,72,81,68,13,1.56521739130435,1.76086956521739,1.47826086956522,0.282608695652174,55,11,48,92,81,80,-26,-1.2
1953,"York City",3,46,49,64,86,-22,1.06521739130435,1.39130434782609,1.8695652173913,-0.478260869565217,88,44,48,92,50,72,38,-0.2
1954,"Accrington Stanley",3,46,86,96,67,29,1.8695652173913,2.08695652173913,1.45652173913043,0.630434782608696,48,4,48,92,50,34,-2,NA
1954,"AFC Bournemouth",3,46,54,57,65,-8,1.17391304347826,1.23913043478261,1.41304347826087,-0.173913043478261,78,34,48,92,61,90,17,2.4
1954,"Aldershot",3,46,61,75,71,4,1.32608695652174,1.6304347826087,1.54347826086957,0.0869565217391304,71,27,48,92,84,57,-13,-1.5
1954,"Arsenal",1,42,60,69,63,6,1.42857142857143,1.64285714285714,1.5,0.142857142857143,8,8,22,22,4,116,4,-0.2
1954,"Aston Villa",1,42,67,72,73,-1,1.5952380952381,1.71428571428571,1.73809523809524,-0.0238095238095238,2,2,22,22,21,121,-19,-1.2
1954,"Barnsley",3,46,95,86,46,40,2.06521739130435,1.8695652173913,1,0.869565217391304,46,2,48,92,40,111,6,-2.2
1954,"Barrow",3,46,57,70,89,-19,1.23913043478261,1.52173913043478,1.93478260869565,-0.41304347826087,75,31,48,92,90,44,-15,-1.3
1954,"Birmingham City",2,42,76,92,47,45,1.80952380952381,2.19047619047619,1.11904761904762,1.07142857142857,25,3,22,44,6,117,19,0.3
1954,"Blackburn Rovers",2,42,72,114,79,35,1.71428571428571,2.71428571428571,1.88095238095238,0.833333333333333,28,6,22,44,25,121,3,1.7
1954,"Blackpool",1,42,52,60,64,-4,1.23809523809524,1.42857142857143,1.52380952380952,-0.0952380952380952,18,18,22,22,2,112,16,0.1
1954,"Bolton Wanderers",1,42,52,62,69,-7,1.23809523809524,1.47619047619048,1.64285714285714,-0.166666666666667,19,19,22,22,8,121,11,-0.6
1954,"Bradford City",3,46,49,47,55,-8,1.06521739130435,1.02173913043478,1.19565217391304,-0.173913043478261,83,39,48,92,62,106,21,-0.4
1954,"Bradford Park Avenue",3,46,56,56,70,-14,1.21739130434783,1.21739130434783,1.52173913043478,-0.304347826086957,76,32,48,92,88,51,-12,0
1954,"Brentford",3,46,62,82,82,0,1.34782608695652,1.78260869565217,1.78260869565217,0,70,26,48,92,57,93,13,2.2
1954,"Brighton & Hove Albion",3,46,70,76,63,13,1.52173913043478,1.65217391304348,1.3695652173913,0.282608695652174,57,13,48,92,47,93,10,-1.3
1954,"Bristol City",3,46,100,101,47,54,2.17391304347826,2.19565217391304,1.02173913043478,1.17391304347826,45,1,48,92,32,108,13,-0.1
1954,"Bristol Rovers",2,42,64,75,70,5,1.52380952380952,1.78571428571429,1.66666666666667,0.119047619047619,30,8,22,44,26,92,4,-2.1
1954,"Burnley",1,42,60,51,48,3,1.42857142857143,1.21428571428571,1.14285714285714,0.0714285714285714,9,9,22,22,7,121,2,-0.3
1954,"Bury",2,42,56,77,72,5,1.33333333333333,1.83333333333333,1.71428571428571,0.119047619047619,35,13,22,44,36,114,-1,-0.3
1954,"Cardiff City",1,42,50,62,76,-14,1.19047619047619,1.47619047619048,1.80952380952381,-0.333333333333333,20,20,22,22,16,93,4,-1.7
1954,"Carlisle United",3,46,51,78,89,-11,1.10869565217391,1.69565217391304,1.93478260869565,-0.239130434782609,80,36,48,92,78,84,2,3.5
1954,"Charlton Athletic",1,42,55,76,75,1,1.30952380952381,1.80952380952381,1.78571428571429,0.0238095238095238,16,16,22,22,13,92,3,-2.3
1954,"Chelsea",1,42,72,81,57,24,1.71428571428571,1.92857142857143,1.35714285714286,0.571428571428571,1,1,22,22,17,104,-16,-0.2
1954,"Chester",3,46,45,44,77,-33,0.978260869565217,0.956521739130435,1.67391304347826,-0.717391304347826,89,45,48,92,79,67,10,1.5
1954,"Chesterfield",3,46,78,81,70,11,1.69565217391304,1.76086956521739,1.52173913043478,0.239130434782609,53,9,48,92,53,100,0,-2.6
1954,"Colchester United",3,46,40,53,91,-38,0.869565217391304,1.15217391304348,1.97826086956522,-0.826086956521739,92,48,48,92,67,68,25,2.5
1954,"Coventry City",3,46,65,67,59,8,1.41304347826087,1.45652173913043,1.28260869565217,0.173913043478261,63,19,48,92,59,94,4,3.2
1954,"Crewe Alexandra",3,46,44,68,91,-23,0.956521739130435,1.47826086956522,1.97826086956522,-0.5,90,46,48,92,92,96,-2,1
1954,"Crystal Palace",3,46,49,52,80,-28,1.06521739130435,1.1304347826087,1.73913043478261,-0.608695652173913,84,40,48,92,89,93,-5,5.5
1954,"Darlington",3,46,56,62,73,-11,1.21739130434783,1.34782608695652,1.58695652173913,-0.239130434782609,77,33,48,92,73,81,4,-0.4
1954,"Derby County",2,42,30,53,82,-29,0.714285714285714,1.26190476190476,1.95238095238095,-0.69047619047619,44,22,22,44,48,121,-4,1.2
1954,"Doncaster Rovers",2,42,49,58,95,-37,1.16666666666667,1.38095238095238,2.26190476190476,-0.880952380952381,38,16,22,44,39,88,-1,-3.9
1954,"Everton",1,42,58,62,68,-6,1.38095238095238,1.47619047619048,1.61904761904762,-0.142857142857143,11,11,22,22,15,121,-4,0.7
1954,"Exeter City",3,46,48,47,73,-26,1.04347826086957,1.02173913043478,1.58695652173913,-0.565217391304348,86,42,48,92,75,88,11,2.4
1954,"Fulham",2,42,53,76,79,-3,1.26190476190476,1.80952380952381,1.88095238095238,-0.0714285714285714,37,15,22,44,29,102,8,1.7
1954,"Gateshead",3,46,72,65,69,-4,1.56521739130435,1.41304347826087,1.5,-0.0869565217391304,55,11,48,92,70,23,-15,NA
1954,"Gillingham",3,46,75,77,66,11,1.6304347826087,1.67391304347826,1.43478260869565,0.239130434782609,54,10,48,92,63,88,-9,0.4
1954,"Grimsby Town",3,46,47,47,78,-31,1.02173913043478,1.02173913043478,1.69565217391304,-0.673913043478261,88,44,48,92,45,110,43,3.3
1954,"Halifax Town",3,46,58,63,67,-4,1.26086956521739,1.3695652173913,1.45652173913043,-0.0869565217391304,73,29,48,92,80,69,-7,-1.7
1954,"Hartlepool United",3,46,80,64,49,15,1.73913043478261,1.39130434782609,1.06521739130435,0.326086956521739,52,8,48,92,51,89,1,-3.3
1954,"Huddersfield Town",1,42,55,63,68,-5,1.30952380952381,1.5,1.61904761904762,-0.119047619047619,17,17,22,22,20,99,-3,-1.3
1954,"Hull City",2,42,46,44,69,-25,1.0952380952381,1.04761904761905,1.64285714285714,-0.595238095238095,41,19,22,44,44,104,-3,-0.8
1954,"Ipswich Town",2,42,39,57,92,-35,0.928571428571429,1.35714285714286,2.19047619047619,-0.833333333333333,43,21,22,44,49,75,-6,1.5
1954,"Leeds United",2,42,76,70,53,17,1.80952380952381,1.66666666666667,1.26190476190476,0.404761904761905,26,4,22,44,24,93,2,2.5
1954,"Leicester City",1,42,47,74,86,-12,1.11904761904762,1.76190476190476,2.04761904761905,-0.285714285714286,21,21,22,22,27,115,-6,0.2
1954,"Leyton Orient",3,46,87,89,47,42,1.89130434782609,1.93478260869565,1.02173913043478,0.91304347826087,47,3,48,92,46,102,1,0.6
1954,"Lincoln City",2,42,49,68,79,-11,1.16666666666667,1.61904761904762,1.88095238095238,-0.261904761904762,39,17,22,44,33,107,6,-5.2
1954,"Liverpool",2,42,58,92,96,-4,1.38095238095238,2.19047619047619,2.28571428571429,-0.0952380952380952,34,12,22,44,28,116,6,2.7
1954,"Luton Town",2,42,77,88,53,35,1.83333333333333,2.0952380952381,1.26190476190476,0.833333333333333,24,2,22,44,10,91,14,-4.1
1954,"Manchester City",1,42,64,76,69,7,1.52380952380952,1.80952380952381,1.64285714285714,0.166666666666667,6,6,22,22,5,117,1,-2.7
1954,"Manchester United",1,42,67,84,74,10,1.5952380952381,2,1.76190476190476,0.238095238095238,3,3,22,22,1,117,2,0.1
1954,"Mansfield Town",3,46,63,65,71,-6,1.3695652173913,1.41304347826087,1.54347826086957,-0.130434782608696,68,24,48,92,81,77,-13,2.1
1954,"Middlesbrough",2,42,60,73,82,-9,1.42857142857143,1.73809523809524,1.95238095238095,-0.214285714285714,32,10,22,44,37,110,-5,-0.8
1954,"Millwall",3,46,71,72,68,4,1.54347826086957,1.56521739130435,1.47826086956522,0.0869565217391304,56,12,48,92,85,93,-29,-1.6
1954,"Newcastle United",1,42,60,89,77,12,1.42857142857143,2.11904761904762,1.83333333333333,0.285714285714286,10,10,22,22,12,116,-2,-1.3
1954,"Newport County",3,46,49,60,73,-13,1.06521739130435,1.30434782608696,1.58695652173913,-0.282608695652174,85,41,48,92,76,67,9,0.2
1954,"Northampton Town",3,46,65,73,81,-8,1.41304347826087,1.58695652173913,1.76086956521739,-0.173913043478261,64,20,48,92,64,93,0,4
1954,"Norwich City",3,46,64,60,60,0,1.39130434782609,1.30434782608696,1.30434782608696,0,66,22,48,92,58,93,8,4
1954,"Nottingham Forest",2,42,55,58,62,-4,1.30952380952381,1.38095238095238,1.47619047619048,-0.0952380952380952,36,14,22,44,30,117,6,3.1
1954,"Notts County",2,42,69,74,71,3,1.64285714285714,1.76190476190476,1.69047619047619,0.0714285714285714,29,7,22,44,42,120,-13,-5.5
1954,"Oldham Athletic",3,46,67,74,68,6,1.45652173913043,1.60869565217391,1.47826086956522,0.130434782608696,60,16,48,92,87,102,-27,-0.4
1954,"Plymouth Argyle",2,42,43,57,82,-25,1.02380952380952,1.35714285714286,1.95238095238095,-0.595238095238095,42,20,22,44,43,93,-1,0.8
1954,"Port Vale",2,42,47,48,71,-23,1.11904761904762,1.14285714285714,1.69047619047619,-0.547619047619048,40,18,22,44,35,107,5,-2.6
1954,"Portsmouth",1,42,66,74,62,12,1.57142857142857,1.76190476190476,1.47619047619048,0.285714285714286,5,5,22,22,14,93,-9,-3.8
1954,"Preston North End",1,42,56,83,64,19,1.33333333333333,1.97619047619048,1.52380952380952,0.452380952380952,13,13,22,22,19,121,-6,-2.2
1954,"Queens Park Rangers",3,46,59,69,75,-6,1.28260869565217,1.5,1.6304347826087,-0.130434782608696,72,28,48,92,82,93,-10,1.5
1954,"Reading",3,46,54,65,73,-8,1.17391304347826,1.41304347826087,1.58695652173913,-0.173913043478261,79,35,48,92,77,93,2,2
1954,"Rochdale",3,46,65,69,66,3,1.41304347826087,1.5,1.43478260869565,0.0652173913043478,65,21,48,92,68,92,-3,-1
1954,"Rotherham United",2,42,79,94,64,30,1.88095238095238,2.23809523809524,1.52380952380952,0.714285714285714,23,1,22,44,41,88,-18,-1.3
1954,"Scunthorpe United",3,46,81,81,53,28,1.76086956521739,1.76086956521739,1.15217391304348,0.608695652173913,51,7,48,92,60,70,-9,-1
1954,"Sheffield United",1,42,58,70,86,-16,1.38095238095238,1.66666666666667,2.04761904761905,-0.380952380952381,12,12,22,22,22,117,-10,-0.6
1954,"Sheffield Wednesday",1,42,34,63,100,-37,0.80952380952381,1.5,2.38095238095238,-0.880952380952381,22,22,22,22,23,117,-1,1.3
1954,"Shrewsbury Town",3,46,58,70,78,-8,1.26086956521739,1.52173913043478,1.69565217391304,-0.173913043478261,74,30,48,92,69,69,5,1.4
1954,"Southampton",3,46,83,75,51,24,1.80434782608696,1.6304347826087,1.10869565217391,0.521739130434783,49,5,48,92,71,93,-22,2.2
1954,"Southend United",3,46,63,83,80,3,1.3695652173913,1.80434782608696,1.73913043478261,0.0652173913043478,69,25,48,92,54,93,15,1.3
1954,"Southport",3,46,64,47,44,3,1.39130434782609,1.02173913043478,0.956521739130435,0.0652173913043478,67,23,48,92,52,50,15,-2.2
1954,"Stockport County",3,46,66,84,70,14,1.43478260869565,1.82608695652174,1.52173913043478,0.304347826086957,61,17,48,92,55,99,6,-3.1
1954,"Stoke City",2,42,73,69,46,23,1.73809523809524,1.64285714285714,1.0952380952381,0.547619047619048,27,5,22,44,34,113,-7,1.4
1954,"Sunderland",1,42,63,64,54,10,1.5,1.52380952380952,1.28571428571429,0.238095238095238,7,7,22,22,9,119,-2,-0.9
1954,"Swansea City",2,42,60,86,83,3,1.42857142857143,2.04761904761905,1.97619047619048,0.0714285714285714,33,11,22,44,31,93,2,-1.1
1954,"Swindon Town",3,46,48,46,64,-18,1.04347826086957,1,1.39130434782609,-0.391304347826087,87,43,48,92,91,93,-4,4.5
1954,"Torquay United",3,46,66,82,82,0,1.43478260869565,1.78260869565217,1.78260869565217,0,62,18,48,92,56,78,6,-1.6
1954,"Tottenham Hotspur",1,42,56,72,73,-1,1.33333333333333,1.71428571428571,1.73809523809524,-0.0238095238095238,14,14,22,22,18,101,-4,0.8
1954,"Tranmere Rovers",3,46,50,55,70,-15,1.08695652173913,1.19565217391304,1.52173913043478,-0.326086956521739,82,38,48,92,74,89,8,1.1
1954,"Walsall",3,46,44,75,86,-11,0.956521739130435,1.6304347826087,1.8695652173913,-0.239130434782609,91,47,48,92,83,100,8,2.8
1954,"Watford",3,46,68,71,62,9,1.47826086956522,1.54347826086957,1.34782608695652,0.195652173913043,58,14,48,92,86,93,-28,0.5
1954,"West Bromwich Albion",1,42,56,76,96,-20,1.33333333333333,1.80952380952381,2.28571428571429,-0.476190476190476,15,15,22,22,11,121,4,0
1954,"West Ham United",2,42,64,74,70,4,1.52380952380952,1.76190476190476,1.66666666666667,0.0952380952380952,31,9,22,44,38,94,-7,2.3
1954,"Wolverhampton Wanderers",1,42,67,89,70,19,1.5952380952381,2.11904761904762,1.66666666666667,0.452380952380952,4,4,22,22,3,121,1,-1.7
1954,"Workington",3,46,68,68,55,13,1.47826086956522,1.47826086956522,1.19565217391304,0.282608695652174,59,15,48,92,65,26,-6,0.1
1954,"Wrexham",3,46,51,65,77,-12,1.10869565217391,1.41304347826087,1.67391304347826,-0.260869565217391,81,37,48,92,72,80,9,-0.1
1954,"York City",3,46,82,92,63,29,1.78260869565217,2,1.3695652173913,0.630434782608696,50,6,48,92,66,72,-16,-1.9
1955,"Accrington Stanley",3,46,84,92,57,35,1.82608695652174,2,1.23913043478261,0.760869565217391,50,6,48,92,48,34,2,NA
1955,"AFC Bournemouth",3,46,67,63,51,12,1.45652173913043,1.3695652173913,1.10869565217391,0.260869565217391,61,17,48,92,59,90,2,-0.3
1955,"Aldershot",3,46,52,70,90,-20,1.1304347826087,1.52173913043478,1.95652173913043,-0.434782608695652,84,40,48,92,81,57,3,-0.1
1955,"Arsenal",1,42,64,60,61,-1,1.52380952380952,1.42857142857143,1.45238095238095,-0.0238095238095238,4,4,22,22,5,116,-1,-1.5
1955,"Aston Villa",1,42,46,52,69,-17,1.0952380952381,1.23809523809524,1.64285714285714,-0.404761904761905,21,21,22,22,10,121,11,0.8
1955,"Barnsley",2,42,45,47,84,-37,1.07142857142857,1.11904761904762,2,-0.880952380952381,40,18,22,44,41,111,-1,-4.6
1955,"Barrow",3,46,45,61,83,-22,0.978260869565217,1.32608695652174,1.80434782608696,-0.478260869565217,90,46,48,92,58,44,32,1
1955,"Birmingham City",1,42,63,75,57,18,1.5,1.78571428571429,1.35714285714286,0.428571428571429,6,6,22,22,12,117,-6,-2.5
1955,"Blackburn Rovers",2,42,69,84,65,19,1.64285714285714,2,1.54761904761905,0.452380952380952,25,3,22,44,26,121,-1,0.3
1955,"Blackpool",1,42,69,86,62,24,1.64285714285714,2.04761904761905,1.47619047619048,0.571428571428571,2,2,22,22,4,112,-2,-1.2
1955,"Bolton Wanderers",1,42,61,71,58,13,1.45238095238095,1.69047619047619,1.38095238095238,0.30952380952381,8,8,22,22,8,121,0,-2.4
1955,"Bradford City",3,46,67,78,64,14,1.45652173913043,1.69565217391304,1.39130434782609,0.304347826086957,62,18,48,92,55,106,7,-2.9
1955,"Bradford Park Avenue",3,46,46,61,122,-61,1,1.32608695652174,2.65217391304348,-1.32608695652174,88,44,48,92,82,51,6,1.1
1955,"Brentford",3,46,71,69,66,3,1.54347826086957,1.5,1.43478260869565,0.0652173913043478,57,13,48,92,66,93,-9,-1
1955,"Brighton & Hove Albion",3,46,94,112,50,62,2.04347826086957,2.43478260869565,1.08695652173913,1.34782608695652,47,3,48,92,60,93,-13,-1.2
1955,"Bristol City",2,42,64,80,64,16,1.52380952380952,1.9047619047619,1.52380952380952,0.380952380952381,32,10,22,44,35,108,-3,0.4
1955,"Bristol Rovers",2,42,69,84,70,14,1.64285714285714,2,1.66666666666667,0.333333333333333,26,4,22,44,32,92,-6,-3.4
1955,"Burnley",1,42,62,64,54,10,1.47619047619048,1.52380952380952,1.28571428571429,0.238095238095238,7,7,22,22,7,121,0,0.5
1955,"Bury",2,42,56,86,90,-4,1.33333333333333,2.04761904761905,2.14285714285714,-0.0952380952380952,36,14,22,44,43,114,-7,-0.3
1955,"Cardiff City",1,42,54,55,69,-14,1.28571428571429,1.30952380952381,1.64285714285714,-0.333333333333333,16,16,22,22,21,93,-5,-2.6
1955,"Carlisle United",3,46,53,71,95,-24,1.15217391304348,1.54347826086957,2.06521739130435,-0.521739130434783,78,34,48,92,71,84,7,4.5
1955,"Charlton Athletic",1,42,57,75,81,-6,1.35714285714286,1.78571428571429,1.92857142857143,-0.142857142857143,13,13,22,22,22,92,-9,-2.5
1955,"Chelsea",1,42,53,64,77,-13,1.26190476190476,1.52380952380952,1.83333333333333,-0.30952380952381,17,17,22,22,14,104,3,1.3
1955,"Chester",3,46,53,52,82,-30,1.15217391304348,1.1304347826087,1.78260869565217,-0.652173913043478,79,35,48,92,88,67,-9,0.4
1955,"Chesterfield",3,46,79,94,66,28,1.71739130434783,2.04347826086957,1.43478260869565,0.608695652173913,53,9,48,92,54,100,-1,-3.6
1955,"Colchester United",3,46,65,76,81,-5,1.41304347826087,1.65217391304348,1.76086956521739,-0.108695652173913,67,23,48,92,51,68,16,-0.7
1955,"Coventry City",3,46,69,73,60,13,1.5,1.58695652173913,1.30434782608696,0.282608695652174,59,15,48,92,75,94,-16,3.4
1955,"Crewe Alexandra",3,46,37,50,105,-55,0.804347826086957,1.08695652173913,2.28260869565217,-1.19565217391304,92,48,48,92,92,96,0,1
1955,"Crystal Palace",3,46,46,54,83,-29,1,1.17391304347826,1.80434782608696,-0.630434782608696,89,45,48,92,83,93,6,5.4
1955,"Darlington",3,46,57,60,73,-13,1.23913043478261,1.30434782608696,1.58695652173913,-0.282608695652174,73,29,48,92,79,81,-6,0.4
1955,"Derby County",3,46,91,110,55,55,1.97826086956522,2.39130434782609,1.19565217391304,1.19565217391304,48,4,48,92,45,121,3,1.8
1955,"Doncaster Rovers",2,42,47,69,96,-27,1.11904761904762,1.64285714285714,2.28571428571429,-0.642857142857143,39,17,22,44,37,88,2,-3.1
1955,"Everton",1,42,55,55,69,-14,1.30952380952381,1.30952380952381,1.64285714285714,-0.333333333333333,15,15,22,22,15,121,0,0.4
1955,"Exeter City",3,46,55,58,77,-19,1.19565217391304,1.26086956521739,1.67391304347826,-0.41304347826087,75,31,48,92,86,88,-11,0.9
1955,"Fulham",2,42,66,89,79,10,1.57142857142857,2.11904761904762,1.88095238095238,0.238095238095238,29,7,22,44,33,102,-4,0.9
1955,"Gateshead",3,46,62,77,84,-7,1.34782608695652,1.67391304347826,1.82608695652174,-0.152173913043478,70,26,48,92,72,23,-2,NA
1955,"Gillingham",3,46,67,69,71,-2,1.45652173913043,1.5,1.54347826086957,-0.0434782608695652,63,19,48,92,87,88,-24,1.5
1955,"Grimsby Town",3,46,99,76,29,47,2.15217391304348,1.65217391304348,0.630434782608696,1.02173913043478,45,1,48,92,36,110,9,-1.1
1955,"Halifax Town",3,46,53,66,76,-10,1.15217391304348,1.43478260869565,1.65217391304348,-0.217391304347826,80,36,48,92,61,69,19,-0.3
1955,"Hartlepool United",3,46,83,81,60,21,1.80434782608696,1.76086956521739,1.30434782608696,0.456521739130435,51,7,48,92,46,89,5,-3.3
1955,"Huddersfield Town",1,42,49,54,83,-29,1.16666666666667,1.28571428571429,1.97619047619048,-0.69047619047619,20,20,22,22,34,99,-14,-0.6
1955,"Hull City",2,42,36,53,97,-44,0.857142857142857,1.26190476190476,2.30952380952381,-1.04761904761905,44,22,22,44,56,104,-12,-0.1
1955,"Ipswich Town",3,46,89,106,60,46,1.93478260869565,2.30434782608696,1.30434782608696,1,49,5,48,92,47,75,2,1.3
1955,"Leeds United",2,42,75,80,60,20,1.78571428571429,1.9047619047619,1.42857142857143,0.476190476190476,24,2,22,44,9,93,15,2.1
1955,"Leicester City",2,42,69,94,78,16,1.64285714285714,2.23809523809524,1.85714285714286,0.380952380952381,27,5,22,44,23,115,4,2.2
1955,"Leyton Orient",3,46,95,106,49,57,2.06521739130435,2.30434782608696,1.06521739130435,1.23913043478261,46,2,48,92,38,102,8,0.2
1955,"Lincoln City",2,42,64,79,65,14,1.52380952380952,1.88095238095238,1.54761904761905,0.333333333333333,33,11,22,44,40,107,-7,-5.7
1955,"Liverpool",2,42,69,85,63,22,1.64285714285714,2.02380952380952,1.5,0.523809523809524,28,6,22,44,25,116,3,2.7
1955,"Luton Town",1,42,59,66,64,2,1.4047619047619,1.57142857142857,1.52380952380952,0.0476190476190476,10,10,22,22,16,91,-6,-6.2
1955,"Manchester City",1,42,64,82,69,13,1.52380952380952,1.95238095238095,1.64285714285714,0.30952380952381,5,5,22,22,18,117,-13,-1.8
1955,"Manchester United",1,42,85,83,51,32,2.02380952380952,1.97619047619048,1.21428571428571,0.761904761904762,1,1,22,22,1,117,0,-0.5
1955,"Mansfield Town",3,46,53,84,81,3,1.15217391304348,1.82608695652174,1.76086956521739,0.0652173913043478,81,37,48,92,73,77,8,1.9
1955,"Middlesbrough",2,42,56,76,78,-2,1.33333333333333,1.80952380952381,1.85714285714286,-0.0476190476190476,37,15,22,44,28,110,9,-0.6
1955,"Millwall",3,46,51,83,100,-17,1.10869565217391,1.80434782608696,2.17391304347826,-0.369565217391304,85,41,48,92,76,93,9,3.9
1955,"Newcastle United",1,42,58,85,70,15,1.38095238095238,2.02380952380952,1.66666666666667,0.357142857142857,12,12,22,22,17,116,-5,-0.3
1955,"Newport County",3,46,54,58,79,-21,1.17391304347826,1.26086956521739,1.71739130434783,-0.456521739130435,76,32,48,92,74,67,2,-0.2
1955,"Northampton Town",3,46,67,67,71,-4,1.45652173913043,1.45652173913043,1.54347826086957,-0.0869565217391304,64,20,48,92,68,93,-4,4.3
1955,"Norwich City",3,46,70,86,82,4,1.52173913043478,1.8695652173913,1.78260869565217,0.0869565217391304,58,14,48,92,90,93,-32,2.1
1955,"Nottingham Forest",2,42,66,68,63,5,1.57142857142857,1.61904761904762,1.5,0.119047619047619,30,8,22,44,24,117,6,1.4
1955,"Notts County",2,42,42,55,82,-27,1,1.30952380952381,1.95238095238095,-0.642857142857143,42,20,22,44,42,120,0,-3.4
1955,"Oldham Athletic",3,46,48,76,86,-10,1.04347826086957,1.65217391304348,1.8695652173913,-0.217391304347826,87,43,48,92,84,102,3,2.2
1955,"Plymouth Argyle",2,42,38,54,87,-33,0.904761904761905,1.28571428571429,2.07142857142857,-0.785714285714286,43,21,22,44,80,93,-37,0.3
1955,"Port Vale",2,42,61,60,58,2,1.45238095238095,1.42857142857143,1.38095238095238,0.0476190476190476,35,13,22,44,44,107,-9,-5.2
1955,"Portsmouth",1,42,57,78,85,-7,1.35714285714286,1.85714285714286,2.02380952380952,-0.166666666666667,14,14,22,22,20,93,-6,-2
1955,"Preston North End",1,42,50,73,72,1,1.19047619047619,1.73809523809524,1.71428571428571,0.0238095238095238,19,19,22,22,2,121,17,-2.2
1955,"Queens Park Rangers",3,46,53,64,86,-22,1.15217391304348,1.39130434782609,1.8695652173913,-0.478260869565217,82,38,48,92,65,93,17,3.5
1955,"Reading",3,46,54,70,79,-9,1.17391304347826,1.52173913043478,1.71739130434783,-0.195652173913043,77,33,48,92,69,93,8,2.6
1955,"Rochdale",3,46,64,66,84,-18,1.39130434782609,1.43478260869565,1.82608695652174,-0.391304347826087,68,24,48,92,63,92,5,-2
1955,"Rotherham United",2,42,45,56,75,-19,1.07142857142857,1.33333333333333,1.78571428571429,-0.452380952380952,41,19,22,44,39,88,2,1.2
1955,"Scunthorpe United",3,46,68,75,63,12,1.47826086956522,1.6304347826087,1.3695652173913,0.260869565217391,60,16,48,92,77,70,-17,1.1
1955,"Sheffield United",1,42,45,63,77,-14,1.07142857142857,1.5,1.83333333333333,-0.333333333333333,22,22,22,22,29,117,-7,1.3
1955,"Sheffield Wednesday",2,42,76,101,62,39,1.80952380952381,2.4047619047619,1.47619047619048,0.928571428571429,23,1,22,44,13,117,10,0.6
1955,"Shrewsbury Town",3,46,63,69,66,3,1.3695652173913,1.5,1.43478260869565,0.0652173913043478,69,25,48,92,70,69,-1,1.5
1955,"Southampton",3,46,62,91,81,10,1.34782608695652,1.97826086956522,1.76086956521739,0.217391304347826,71,27,48,92,53,93,18,4.7
1955,"Southend United",3,46,74,88,80,8,1.60869565217391,1.91304347826087,1.73913043478261,0.173913043478261,54,10,48,92,64,93,-10,-0.9
1955,"Southport",3,46,80,66,53,13,1.73913043478261,1.43478260869565,1.15217391304348,0.282608695652174,52,8,48,92,89,50,-37,-2.7
1955,"Stockport County",3,46,72,90,61,29,1.56521739130435,1.95652173913043,1.32608695652174,0.630434782608696,55,11,48,92,52,99,3,-2.6
1955,"Stoke City",2,42,64,71,62,9,1.52380952380952,1.69047619047619,1.47619047619048,0.214285714285714,34,12,22,44,27,113,7,2.4
1955,"Sunderland",1,42,60,80,95,-15,1.42857142857143,1.9047619047619,2.26190476190476,-0.357142857142857,9,9,22,22,19,119,-10,-0.9
1955,"Swansea City",2,42,66,83,81,2,1.57142857142857,1.97619047619048,1.92857142857143,0.0476190476190476,31,9,22,44,31,93,0,-3
1955,"Swindon Town",3,46,38,34,78,-44,0.826086956521739,0.739130434782609,1.69565217391304,-0.956521739130435,91,47,48,92,85,93,6,3.9
1955,"Torquay United",3,46,72,86,63,23,1.56521739130435,1.8695652173913,1.3695652173913,0.5,56,12,48,92,49,78,7,-1.5
1955,"Tottenham Hotspur",1,42,52,61,71,-10,1.23809523809524,1.45238095238095,1.69047619047619,-0.238095238095238,18,18,22,22,3,101,15,1
1955,"Tranmere Rovers",3,46,57,59,84,-25,1.23913043478261,1.28260869565217,1.82608695652174,-0.543478260869565,74,30,48,92,91,89,-17,0.1
1955,"Walsall",3,46,53,68,84,-16,1.15217391304348,1.47826086956522,1.82608695652174,-0.347826086956522,83,39,48,92,78,100,5,3
1955,"Watford",3,46,50,52,85,-33,1.08695652173913,1.1304347826087,1.84782608695652,-0.717391304347826,86,42,48,92,67,93,19,2.9
1955,"West Bromwich Albion",1,42,59,58,70,-12,1.4047619047619,1.38095238095238,1.66666666666667,-0.285714285714286,11,11,22,22,11,121,0,0.4
1955,"West Ham United",2,42,53,74,69,5,1.26190476190476,1.76190476190476,1.64285714285714,0.119047619047619,38,16,22,44,30,94,8,2.6
1955,"Wolverhampton Wanderers",1,42,69,89,65,24,1.64285714285714,2.11904761904762,1.54761904761905,0.571428571428571,3,3,22,22,6,121,-3,-2.4
1955,"Workington",3,46,66,75,63,12,1.43478260869565,1.6304347826087,1.3695652173913,0.260869565217391,65,21,48,92,50,26,15,1.5
1955,"Wrexham",3,46,58,66,73,-7,1.26086956521739,1.43478260869565,1.58695652173913,-0.152173913043478,72,28,48,92,62,80,10,-2
1955,"York City",3,46,66,85,72,13,1.43478260869565,1.84782608695652,1.56521739130435,0.282608695652174,66,22,48,92,57,72,9,-0.2
1956,"Accrington Stanley",3,46,83,95,64,31,1.80434782608696,2.06521739130435,1.39130434782609,0.673913043478261,48,4,48,92,46,34,2,NA
1956,"AFC Bournemouth",3,46,71,88,62,26,1.54347826086957,1.91304347826087,1.34782608695652,0.565217391304348,59,15,48,92,57,90,2,-0.5
1956,"Aldershot",3,46,57,79,92,-13,1.23913043478261,1.71739130434783,2,-0.282608695652174,81,37,48,92,82,57,-1,0.2
1956,"Arsenal",1,42,71,85,69,16,1.69047619047619,2.02380952380952,1.64285714285714,0.380952380952381,5,5,22,22,12,116,-7,-0.2
1956,"Aston Villa",1,42,57,65,55,10,1.35714285714286,1.54761904761905,1.30952380952381,0.238095238095238,10,10,22,22,13,121,-3,-1.1
1956,"Barnsley",2,42,46,59,89,-30,1.0952380952381,1.4047619047619,2.11904761904762,-0.714285714285714,41,19,22,44,36,111,5,-4.5
1956,"Barrow",3,46,72,76,62,14,1.56521739130435,1.65217391304348,1.34782608695652,0.304347826086957,58,14,48,92,81,44,-23,-1.2
1956,"Birmingham City",1,42,54,69,69,0,1.28571428571429,1.64285714285714,1.64285714285714,0,12,12,22,22,14,117,-2,-1.9
1956,"Blackburn Rovers",2,42,73,83,75,8,1.73809523809524,1.97619047619048,1.78571428571429,0.19047619047619,26,4,22,44,25,121,1,0
1956,"Blackpool",1,42,75,93,65,28,1.78571428571429,2.21428571428571,1.54761904761905,0.666666666666667,4,4,22,22,7,112,-3,-1.8
1956,"Bolton Wanderers",1,42,60,65,65,0,1.42857142857143,1.54761904761905,1.54761904761905,0,8,8,22,22,15,121,-7,-2.4
1956,"Bradford City",3,46,74,78,68,10,1.60869565217391,1.69565217391304,1.47826086956522,0.217391304347826,55,11,48,92,51,106,4,-2.2
1956,"Bradford Park Avenue",3,46,51,66,93,-27,1.10869565217391,1.43478260869565,2.02173913043478,-0.58695652173913,82,38,48,92,86,51,-4,-0.9
1956,"Brentford",3,46,64,78,76,2,1.39130434782609,1.69565217391304,1.65217391304348,0.0434782608695652,66,22,48,92,49,93,17,-1.2
1956,"Brighton & Hove Albion",3,46,71,86,65,21,1.54347826086957,1.8695652173913,1.41304347826087,0.456521739130435,60,16,48,92,47,93,13,-0.3
1956,"Bristol City",2,42,57,74,79,-5,1.35714285714286,1.76190476190476,1.88095238095238,-0.119047619047619,35,13,22,44,39,108,-4,-0.3
1956,"Bristol Rovers",2,42,63,81,67,14,1.5,1.92857142857143,1.5952380952381,0.333333333333333,32,10,22,44,32,92,0,-1.7
1956,"Burnley",1,42,64,56,50,6,1.52380952380952,1.33333333333333,1.19047619047619,0.142857142857143,7,7,22,22,5,121,2,-0.7
1956,"Bury",2,42,33,60,96,-36,0.785714285714286,1.42857142857143,2.28571428571429,-0.857142857142857,43,21,22,44,50,114,-7,-0.1
1956,"Cardiff City",1,42,39,53,88,-35,0.928571428571429,1.26190476190476,2.0952380952381,-0.833333333333333,21,21,22,22,37,93,-16,-2.1
1956,"Carlisle United",3,46,61,76,85,-9,1.32608695652174,1.65217391304348,1.84782608695652,-0.195652173913043,71,27,48,92,68,84,3,4.6
1956,"Charlton Athletic",1,42,31,62,120,-58,0.738095238095238,1.47619047619048,2.85714285714286,-1.38095238095238,22,22,22,22,24,92,-2,-1.8
1956,"Chelsea",1,42,52,73,73,0,1.23809523809524,1.73809523809524,1.73809523809524,0,14,14,22,22,11,104,3,0.5
1956,"Chester",3,46,43,55,84,-29,0.934782608695652,1.19565217391304,1.82608695652174,-0.630434782608696,88,44,48,92,83,67,5,0.3
1956,"Chesterfield",3,46,75,96,79,17,1.6304347826087,2.08695652173913,1.71739130434783,0.369565217391304,54,10,48,92,61,100,-7,-2.6
1956,"Colchester United",3,46,80,84,56,28,1.73913043478261,1.82608695652174,1.21739130434783,0.608695652173913,51,7,48,92,66,68,-15,-0.5
1956,"Coventry City",3,46,60,74,84,-10,1.30434782608696,1.60869565217391,1.82608695652174,-0.217391304347826,75,31,48,92,84,94,-9,5.1
1956,"Crewe Alexandra",3,46,27,43,110,-67,0.58695652173913,0.934782608695652,2.39130434782609,-1.45652173913043,92,48,48,92,92,96,0,1.9
1956,"Crystal Palace",3,46,51,62,75,-13,1.10869565217391,1.34782608695652,1.6304347826087,-0.282608695652174,83,39,48,92,75,93,8,5.5
1956,"Darlington",3,46,59,82,95,-13,1.28260869565217,1.78260869565217,2.06521739130435,-0.282608695652174,79,35,48,92,76,81,3,1.3
1956,"Derby County",3,46,89,111,53,58,1.93478260869565,2.41304347826087,1.15217391304348,1.26086956521739,45,1,48,92,38,121,7,0.4
1956,"Doncaster Rovers",2,42,55,77,77,0,1.30952380952381,1.83333333333333,1.83333333333333,0,37,15,22,44,44,88,-7,-3
1956,"Everton",1,42,52,61,79,-18,1.23809523809524,1.45238095238095,1.88095238095238,-0.428571428571429,15,15,22,22,17,121,-2,0.9
1956,"Exeter City",3,46,49,61,79,-18,1.06521739130435,1.32608695652174,1.71739130434783,-0.391304347826087,86,42,48,92,89,88,-3,0.4
1956,"Fulham",2,42,61,84,76,8,1.45238095238095,2,1.80952380952381,0.19047619047619,33,11,22,44,28,102,5,1.4
1956,"Gateshead",3,46,61,72,90,-18,1.32608695652174,1.56521739130435,1.95652173913043,-0.391304347826087,72,28,48,92,72,23,0,NA
1956,"Gillingham",3,46,49,54,85,-31,1.06521739130435,1.17391304347826,1.84782608695652,-0.673913043478261,87,43,48,92,87,88,0,3
1956,"Grimsby Town",2,42,56,61,62,-1,1.33333333333333,1.45238095238095,1.47619047619048,-0.0238095238095238,36,14,22,44,35,110,1,-2.2
1956,"Halifax Town",3,46,70,65,70,-5,1.52173913043478,1.41304347826087,1.52173913043478,-0.108695652173913,61,17,48,92,60,69,1,-2
1956,"Hartlepool United",3,46,84,90,63,27,1.82608695652174,1.95652173913043,1.3695652173913,0.58695652173913,46,2,48,92,73,89,-27,-2.9
1956,"Huddersfield Town",2,42,60,68,74,-6,1.42857142857143,1.61904761904762,1.76190476190476,-0.142857142857143,34,12,22,44,34,99,0,0.7
1956,"Hull City",3,46,73,84,69,15,1.58695652173913,1.82608695652174,1.5,0.326086956521739,56,12,48,92,58,104,-2,2.3
1956,"Ipswich Town",3,46,84,101,54,47,1.82608695652174,2.19565217391304,1.17391304347826,1.02173913043478,47,3,48,92,30,75,17,1.8
1956,"Leeds United",1,42,59,72,63,9,1.4047619047619,1.71428571428571,1.5,0.214285714285714,9,9,22,22,16,93,-7,0.5
1956,"Leicester City",2,42,86,109,67,42,2.04761904761905,2.5952380952381,1.5952380952381,1,23,1,22,44,18,115,5,1.5
1956,"Leyton Orient",2,42,55,66,84,-18,1.30952380952381,1.57142857142857,2,-0.428571428571429,38,16,22,44,33,102,5,-2.3
1956,"Lincoln City",2,42,48,54,80,-26,1.14285714285714,1.28571428571429,1.9047619047619,-0.619047619047619,40,18,22,44,41,107,-1,-5.2
1956,"Liverpool",2,42,74,82,54,28,1.76190476190476,1.95238095238095,1.28571428571429,0.666666666666667,25,3,22,44,26,116,-1,2
1956,"Luton Town",1,42,51,58,76,-18,1.21428571428571,1.38095238095238,1.80952380952381,-0.428571428571429,16,16,22,22,8,91,8,-6.7
1956,"Manchester City",1,42,48,78,88,-10,1.14285714285714,1.85714285714286,2.0952380952381,-0.238095238095238,18,18,22,22,4,117,14,0.3
1956,"Manchester United",1,42,92,103,54,49,2.19047619047619,2.45238095238095,1.28571428571429,1.16666666666667,1,1,22,22,9,117,-8,0
1956,"Mansfield Town",3,46,61,91,90,1,1.32608695652174,1.97826086956522,1.95652173913043,0.0217391304347826,73,29,48,92,56,77,17,2
1956,"Middlesbrough",2,42,67,84,60,24,1.5952380952381,2,1.42857142857143,0.571428571428571,28,6,22,44,29,110,-1,-1.8
1956,"Millwall",3,46,60,64,84,-20,1.30434782608696,1.39130434782609,1.82608695652174,-0.434782608695652,76,32,48,92,90,93,-14,4.6
1956,"Newcastle United",1,42,50,67,87,-20,1.19047619047619,1.5952380952381,2.07142857142857,-0.476190476190476,17,17,22,22,19,116,-2,-0.3
1956,"Newport County",3,46,61,65,62,3,1.32608695652174,1.41304347826087,1.34782608695652,0.0652173913043478,74,30,48,92,63,67,11,-1.3
1956,"Northampton Town",3,46,63,66,73,-7,1.3695652173913,1.43478260869565,1.58695652173913,-0.152173913043478,68,24,48,92,69,93,-1,2.5
1956,"Norwich City",3,46,39,61,94,-33,0.847826086956522,1.32608695652174,2.04347826086957,-0.717391304347826,90,46,48,92,59,93,31,5.5
1956,"Nottingham Forest",2,42,76,94,55,39,1.80952380952381,2.23809523809524,1.30952380952381,0.928571428571429,24,2,22,44,10,117,14,2.1
1956,"Notts County",2,42,39,58,86,-28,0.928571428571429,1.38095238095238,2.04761904761905,-0.666666666666667,42,20,22,44,42,120,0,-4.6
1956,"Oldham Athletic",3,46,51,66,74,-8,1.10869565217391,1.43478260869565,1.60869565217391,-0.173913043478261,84,40,48,92,74,102,10,3
1956,"Plymouth Argyle",3,46,59,68,73,-5,1.28260869565217,1.47826086956522,1.58695652173913,-0.108695652173913,80,36,48,92,48,93,32,4.3
1956,"Port Vale",2,42,30,57,101,-44,0.714285714285714,1.35714285714286,2.4047619047619,-1.04761904761905,44,22,22,44,77,107,-33,-4
1956,"Portsmouth",1,42,43,62,92,-30,1.02380952380952,1.47619047619048,2.19047619047619,-0.714285714285714,20,20,22,22,20,93,0,-1.6
1956,"Preston North End",1,42,79,84,56,28,1.88095238095238,2,1.33333333333333,0.666666666666667,2,2,22,22,2,121,0,-3.2
1956,"Queens Park Rangers",3,46,65,61,60,1,1.41304347826087,1.32608695652174,1.30434782608696,0.0217391304347826,65,21,48,92,62,93,3,2
1956,"Reading",3,46,63,80,81,-1,1.3695652173913,1.73913043478261,1.76086956521739,-0.0217391304347826,69,25,48,92,53,93,16,2.2
1956,"Rochdale",3,46,66,65,65,0,1.43478260869565,1.41304347826087,1.41304347826087,0,63,19,48,92,64,92,-1,-2.6
1956,"Rotherham United",2,42,50,74,75,-1,1.19047619047619,1.76190476190476,1.78571428571429,-0.0238095238095238,39,17,22,44,40,88,-1,0
1956,"Scunthorpe United",3,46,60,71,69,2,1.30434782608696,1.54347826086957,1.5,0.0434782608695652,77,33,48,92,45,70,32,1.8
1956,"Sheffield United",2,42,65,87,76,11,1.54761904761905,2.07142857142857,1.80952380952381,0.261904761904762,29,7,22,44,27,117,2,1.9
1956,"Sheffield Wednesday",1,42,54,82,88,-6,1.28571428571429,1.95238095238095,2.0952380952381,-0.142857142857143,13,13,22,22,21,117,-8,0.1
1956,"Shrewsbury Town",3,46,63,72,79,-7,1.3695652173913,1.56521739130435,1.71739130434783,-0.152173913043478,70,26,48,92,78,69,-8,2
1956,"Southampton",3,46,76,76,52,24,1.65217391304348,1.65217391304348,1.1304347826087,0.521739130434783,53,9,48,92,54,93,-1,3.5
1956,"Southend United",3,46,66,73,65,8,1.43478260869565,1.58695652173913,1.41304347826087,0.173913043478261,64,20,48,92,55,93,9,-1
1956,"Southport",3,46,42,52,94,-42,0.91304347826087,1.1304347826087,2.04347826086957,-0.91304347826087,89,45,48,92,91,50,-2,1.8
1956,"Stockport County",3,46,77,91,75,16,1.67391304347826,1.97826086956522,1.6304347826087,0.347826086956522,52,8,48,92,65,99,-13,-1.7
1956,"Stoke City",2,42,68,83,58,25,1.61904761904762,1.97619047619048,1.38095238095238,0.595238095238095,27,5,22,44,31,113,-4,1.6
1956,"Sunderland",1,42,44,67,88,-21,1.04761904761905,1.5952380952381,2.0952380952381,-0.5,19,19,22,22,22,119,-3,0.3
1956,"Swansea City",2,42,64,90,90,0,1.52380952380952,2.14285714285714,2.14285714285714,0,31,9,22,44,43,93,-12,-3.4
1956,"Swindon Town",3,46,51,66,96,-30,1.10869565217391,1.43478260869565,2.08695652173913,-0.652173913043478,85,41,48,92,52,93,33,3.3
1956,"Torquay United",3,46,83,89,64,25,1.80434782608696,1.93478260869565,1.39130434782609,0.543478260869565,49,5,48,92,88,78,-39,-0.2
1956,"Tottenham Hotspur",1,42,78,104,56,48,1.85714285714286,2.47619047619048,1.33333333333333,1.14285714285714,3,3,22,22,3,101,0,0.1
1956,"Tranmere Rovers",3,46,34,51,91,-40,0.739130434782609,1.10869565217391,1.97826086956522,-0.869565217391304,91,47,48,92,67,89,24,1.9
1956,"Walsall",3,46,60,80,74,6,1.30434782608696,1.73913043478261,1.60869565217391,0.130434782608696,78,34,48,92,85,100,-7,2.3
1956,"Watford",3,46,64,72,75,-3,1.39130434782609,1.56521739130435,1.6304347826087,-0.0652173913043478,67,23,48,92,79,93,-12,1.9
1956,"West Bromwich Albion",1,42,56,59,61,-2,1.33333333333333,1.4047619047619,1.45238095238095,-0.0476190476190476,11,11,22,22,6,121,5,-0.2
1956,"West Ham United",2,42,65,59,63,-4,1.54761904761905,1.4047619047619,1.5,-0.0952380952380952,30,8,22,44,23,94,7,1.3
1956,"Wolverhampton Wanderers",1,42,68,94,70,24,1.61904761904762,2.23809523809524,1.66666666666667,0.571428571428571,6,6,22,22,1,121,5,-1.7
1956,"Workington",3,46,82,93,63,30,1.78260869565217,2.02173913043478,1.3695652173913,0.652173913043478,50,6,48,92,80,26,-30,-1.8
1956,"Wrexham",3,46,67,97,74,23,1.45652173913043,2.10869565217391,1.60869565217391,0.5,62,18,48,92,70,80,-8,-1.4
1956,"York City",3,46,73,75,61,14,1.58695652173913,1.6304347826087,1.32608695652174,0.304347826086957,57,13,48,92,71,72,-14,-3.3
1957,"Accrington Stanley",3,46,84,83,61,22,1.82608695652174,1.80434782608696,1.32608695652174,0.478260869565217,46,2,48,92,62,34,-16,NA
1957,"AFC Bournemouth",3,46,72,81,74,7,1.56521739130435,1.76086956521739,1.60869565217391,0.152173913043478,57,13,48,92,57,90,0,-0.1
1957,"Aldershot",3,46,52,59,89,-30,1.1304347826087,1.28260869565217,1.93478260869565,-0.652173913043478,82,38,48,92,90,57,-8,0.5
1957,"Arsenal",1,42,55,73,85,-12,1.30952380952381,1.73809523809524,2.02380952380952,-0.285714285714286,12,12,22,22,3,116,9,0.3
1957,"Aston Villa",1,42,55,73,86,-13,1.30952380952381,1.73809523809524,2.04761904761905,-0.30952380952381,13,13,22,22,21,121,-8,-2.1
1957,"Barnsley",2,42,54,70,74,-4,1.28571428571429,1.66666666666667,1.76190476190476,-0.0952380952380952,36,14,22,44,43,111,-7,-3.4
1957,"Barrow",3,46,54,66,74,-8,1.17391304347826,1.43478260869565,1.60869565217391,-0.173913043478261,81,37,48,92,91,44,-10,3.1
1957,"Birmingham City",1,42,53,76,89,-13,1.26190476190476,1.80952380952381,2.11904761904762,-0.30952380952381,14,14,22,22,8,117,6,-1.2
1957,"Blackburn Rovers",2,42,78,93,57,36,1.85714285714286,2.21428571428571,1.35714285714286,0.857142857142857,25,3,22,44,10,121,15,-0.4
1957,"Blackpool",1,42,63,80,67,13,1.5,1.9047619047619,1.5952380952381,0.30952380952381,7,7,22,22,9,112,-2,-1.7
1957,"Bolton Wanderers",1,42,52,65,87,-22,1.23809523809524,1.54761904761905,2.07142857142857,-0.523809523809524,15,15,22,22,4,121,11,-2
1957,"Bradford City",3,46,78,73,49,24,1.69565217391304,1.58695652173913,1.06521739130435,0.521739130434783,51,7,48,92,54,106,-3,-2.1
1957,"Bradford Park Avenue",3,46,50,68,95,-27,1.08695652173913,1.47826086956522,2.06521739130435,-0.58695652173913,86,42,48,92,80,51,6,-0.6
1957,"Brentford",3,46,82,82,56,26,1.78260869565217,1.78260869565217,1.21739130434783,0.565217391304348,49,5,48,92,48,93,1,-3
1957,"Brighton & Hove Albion",3,46,84,88,64,24,1.82608695652174,1.91304347826087,1.39130434782609,0.521739130434783,47,3,48,92,35,93,12,-1
1957,"Bristol City",2,42,48,63,88,-25,1.14285714285714,1.5,2.0952380952381,-0.595238095238095,39,17,22,44,32,108,7,0.1
1957,"Bristol Rovers",2,42,59,85,80,5,1.4047619047619,2.02380952380952,1.9047619047619,0.119047619047619,32,10,22,44,29,92,3,-2.9
1957,"Burnley",1,42,68,80,74,6,1.61904761904762,1.9047619047619,1.76190476190476,0.142857142857143,5,5,22,22,6,121,-1,-0.7
1957,"Bury",3,46,79,94,62,32,1.71739130434783,2.04347826086957,1.34782608695652,0.695652173913043,50,6,48,92,55,114,-5,0.5
1957,"Cardiff City",2,42,51,63,77,-14,1.21428571428571,1.5,1.83333333333333,-0.333333333333333,37,15,22,44,30,93,7,0.1
1957,"Carlisle United",3,46,63,80,78,2,1.3695652173913,1.73913043478261,1.69565217391304,0.0434782608695652,68,24,48,92,78,84,-10,3.6
1957,"Charlton Athletic",2,42,79,107,69,38,1.88095238095238,2.54761904761905,1.64285714285714,0.904761904761905,24,2,22,44,31,92,-7,-1.5
1957,"Chelsea",1,42,57,83,79,4,1.35714285714286,1.97619047619048,1.88095238095238,0.0952380952380952,11,11,22,22,11,104,0,0.5
1957,"Chester",3,46,52,73,81,-8,1.1304347826087,1.58695652173913,1.76086956521739,-0.173913043478261,83,39,48,92,81,67,2,-0.7
1957,"Chesterfield",3,46,69,71,69,2,1.5,1.54347826086957,1.5,0.0434782608695652,61,17,48,92,59,100,2,-1.3
1957,"Colchester United",3,46,64,77,79,-2,1.39130434782609,1.67391304347826,1.71739130434783,-0.0434782608695652,66,22,48,92,49,68,17,-0.1
1957,"Coventry City",3,46,52,61,81,-20,1.1304347826087,1.32608695652174,1.76086956521739,-0.434782608695652,84,40,48,92,70,94,14,6.3
1957,"Crewe Alexandra",3,46,31,47,93,-46,0.673913043478261,1.02173913043478,2.02173913043478,-1,92,48,48,92,85,96,7,1.9
1957,"Crystal Palace",3,46,58,70,72,-2,1.26086956521739,1.52173913043478,1.56521739130435,-0.0434782608695652,75,31,48,92,75,93,0,4.2
1957,"Darlington",3,46,58,78,89,-11,1.26086956521739,1.69565217391304,1.93478260869565,-0.239130434782609,76,32,48,92,86,81,-10,-0.9
1957,"Derby County",2,42,50,60,81,-21,1.19047619047619,1.42857142857143,1.92857142857143,-0.5,38,16,22,44,28,121,10,-0.2
1957,"Doncaster Rovers",2,42,35,56,88,-32,0.833333333333333,1.33333333333333,2.0952380952381,-0.761904761904762,44,22,22,44,66,88,-22,-3.4
1957,"Everton",1,42,50,65,75,-10,1.19047619047619,1.54761904761905,1.78571428571429,-0.238095238095238,17,17,22,22,15,121,2,1.3
1957,"Exeter City",3,46,42,57,99,-42,0.91304347826087,1.23913043478261,2.15217391304348,-0.91304347826087,89,45,48,92,73,88,16,0.1
1957,"Fulham",2,42,72,97,59,38,1.71428571428571,2.30952380952381,1.4047619047619,0.904761904761905,28,6,22,44,24,102,4,0.6
1957,"Gateshead",3,46,60,68,76,-8,1.30434782608696,1.47826086956522,1.65217391304348,-0.173913043478261,72,28,48,92,84,23,-12,NA
1957,"Gillingham",3,46,48,52,81,-29,1.04347826086957,1.1304347826087,1.76086956521739,-0.630434782608696,87,43,48,92,79,88,8,3.3
1957,"Grimsby Town",2,42,57,86,83,3,1.35714285714286,2.04761904761905,1.97619047619048,0.0714285714285714,35,13,22,44,44,110,-9,-3
1957,"Halifax Town",3,46,71,83,69,14,1.54347826086957,1.80434782608696,1.5,0.304347826086957,60,16,48,92,50,69,10,-2
1957,"Hartlepool United",3,46,60,73,76,-3,1.30434782608696,1.58695652173913,1.65217391304348,-0.0652173913043478,73,29,48,92,87,89,-14,0.2
1957,"Huddersfield Town",2,42,58,63,66,-3,1.38095238095238,1.5,1.57142857142857,-0.0714285714285714,34,12,22,44,36,99,-2,-0.3
1957,"Hull City",3,46,72,78,67,11,1.56521739130435,1.69565217391304,1.45652173913043,0.239130434782609,58,14,48,92,45,104,13,1.7
1957,"Ipswich Town",2,42,60,68,69,-1,1.42857142857143,1.61904761904762,1.64285714285714,-0.0238095238095238,30,8,22,44,33,75,-3,0.5
1957,"Leeds United",1,42,51,51,63,-12,1.21428571428571,1.21428571428571,1.5,-0.285714285714286,16,16,22,22,16,93,0,1.1
1957,"Leicester City",1,42,47,91,112,-21,1.11904761904762,2.16666666666667,2.66666666666667,-0.5,18,18,22,22,19,115,-1,0.4
1957,"Leyton Orient",2,42,59,77,79,-2,1.4047619047619,1.83333333333333,1.88095238095238,-0.0476190476190476,33,11,22,44,39,102,-6,-3.1
1957,"Lincoln City",2,42,42,55,82,-27,1,1.30952380952381,1.95238095238095,-0.642857142857143,41,19,22,44,41,107,0,-4.1
1957,"Liverpool",2,42,76,79,54,25,1.80952380952381,1.88095238095238,1.28571428571429,0.595238095238095,26,4,22,44,25,116,1,2.3
1957,"Luton Town",1,42,63,69,63,6,1.5,1.64285714285714,1.5,0.142857142857143,8,8,22,22,17,91,-9,-6.1
1957,"Manchester City",1,42,71,104,100,4,1.69047619047619,2.47619047619048,2.38095238095238,0.0952380952380952,4,4,22,22,20,117,-16,0.3
1957,"Manchester United",1,42,59,85,75,10,1.4047619047619,2.02380952380952,1.78571428571429,0.238095238095238,9,9,22,22,2,117,7,0.7
1957,"Mansfield Town",3,46,74,100,92,8,1.60869565217391,2.17391304347826,2,0.173913043478261,56,12,48,92,64,77,-8,-1
1957,"Middlesbrough",2,42,64,83,74,9,1.52380952380952,1.97619047619048,1.76190476190476,0.214285714285714,29,7,22,44,38,110,-9,0.1
1957,"Millwall",3,46,42,63,91,-28,0.91304347826087,1.3695652173913,1.97826086956522,-0.608695652173913,90,46,48,92,77,93,13,6
1957,"Newcastle United",1,42,44,73,81,-8,1.04761904761905,1.73809523809524,1.92857142857143,-0.19047619047619,19,19,22,22,12,116,7,0.9
1957,"Newport County",3,46,65,73,67,6,1.41304347826087,1.58695652173913,1.45652173913043,0.130434782608696,63,19,48,92,61,67,2,-1.8
1957,"Northampton Town",3,46,63,87,79,8,1.3695652173913,1.89130434782609,1.71739130434783,0.173913043478261,69,25,48,92,76,93,-7,0.7
1957,"Norwich City",3,46,72,75,70,5,1.56521739130435,1.6304347826087,1.52173913043478,0.108695652173913,59,15,48,92,47,93,12,2.8
1957,"Nottingham Forest",1,42,58,69,63,6,1.38095238095238,1.64285714285714,1.5,0.142857142857143,10,10,22,22,14,117,-4,-0.1
1957,"Notts County",2,42,42,44,80,-36,1,1.04761904761905,1.9047619047619,-0.857142857142857,42,20,22,44,67,120,-25,-4.2
1957,"Oldham Athletic",3,46,59,72,84,-12,1.28260869565217,1.56521739130435,1.82608695652174,-0.260869565217391,74,30,48,92,89,102,-15,1.4
1957,"Plymouth Argyle",3,46,83,67,48,19,1.80434782608696,1.45652173913043,1.04347826086957,0.41304347826087,48,4,48,92,46,93,2,0.4
1957,"Port Vale",3,46,58,67,58,9,1.26086956521739,1.45652173913043,1.26086956521739,0.195652173913043,77,33,48,92,69,107,8,-0.9
1957,"Portsmouth",1,42,44,73,88,-15,1.04761904761905,1.73809523809524,2.0952380952381,-0.357142857142857,20,20,22,22,22,93,-2,-0.7
1957,"Preston North End",1,42,85,100,51,49,2.02380952380952,2.38095238095238,1.21428571428571,1.16666666666667,2,2,22,22,13,121,-11,-4
1957,"Queens Park Rangers",3,46,68,64,65,-1,1.47826086956522,1.39130434782609,1.41304347826087,-0.0217391304347826,62,18,48,92,56,93,6,3.9
1957,"Reading",3,46,76,79,51,28,1.65217391304348,1.71739130434783,1.10869565217391,0.608695652173913,53,9,48,92,51,93,2,0.4
1957,"Rochdale",3,46,65,79,67,12,1.41304347826087,1.71739130434783,1.45652173913043,0.260869565217391,64,20,48,92,68,92,-4,-2.3
1957,"Rotherham United",2,42,47,65,101,-36,1.11904761904762,1.54761904761905,2.4047619047619,-0.857142857142857,40,18,22,44,42,88,-2,-0.3
1957,"Scunthorpe United",3,46,95,88,50,38,2.06521739130435,1.91304347826087,1.08695652173913,0.826086956521739,45,1,48,92,40,70,5,-2.3
1957,"Sheffield United",2,42,73,75,50,25,1.73809523809524,1.78571428571429,1.19047619047619,0.595238095238095,27,5,22,44,26,117,1,0.7
1957,"Sheffield Wednesday",1,42,43,69,92,-23,1.02380952380952,1.64285714285714,2.19047619047619,-0.547619047619048,21,21,22,22,23,117,-2,0.2
1957,"Shrewsbury Town",3,46,55,49,71,-22,1.19565217391304,1.06521739130435,1.54347826086957,-0.478260869565217,78,34,48,92,71,69,7,3.1
1957,"Southampton",3,46,76,112,72,40,1.65217391304348,2.43478260869565,1.56521739130435,0.869565217391304,54,10,48,92,58,93,-4,3.9
1957,"Southend United",3,46,75,90,58,32,1.6304347826087,1.95652173913043,1.26086956521739,0.695652173913043,55,11,48,92,52,93,3,-2
1957,"Southport",3,46,39,52,88,-36,0.847826086956522,1.1304347826087,1.91304347826087,-0.782608695652174,91,47,48,92,92,50,-1,3.2
1957,"Stockport County",3,46,65,74,67,7,1.41304347826087,1.60869565217391,1.45652173913043,0.152173913043478,65,21,48,92,65,99,0,1
1957,"Stoke City",2,42,60,75,73,2,1.42857142857143,1.78571428571429,1.73809523809524,0.0476190476190476,31,9,22,44,27,113,4,1.3
1957,"Sunderland",1,42,42,54,97,-43,1,1.28571428571429,2.30952380952381,-1.02380952380952,22,22,22,22,37,119,-15,0.6
1957,"Swansea City",2,42,42,72,99,-27,1,1.71428571428571,2.35714285714286,-0.642857142857143,43,21,22,44,34,93,9,-4
1957,"Swindon Town",3,46,78,79,50,29,1.69565217391304,1.71739130434783,1.08695652173913,0.630434782608696,52,8,48,92,60,93,-8,-0.4
1957,"Torquay United",3,46,46,49,74,-25,1,1.06521739130435,1.60869565217391,-0.543478260869565,88,44,48,92,82,78,6,4
1957,"Tottenham Hotspur",1,42,72,93,77,16,1.71428571428571,2.21428571428571,1.83333333333333,0.380952380952381,3,3,22,22,18,101,-15,-0.4
1957,"Tranmere Rovers",3,46,64,82,76,6,1.39130434782609,1.78260869565217,1.65217391304348,0.130434782608696,67,23,48,92,53,89,14,0.4
1957,"Walsall",3,46,51,61,75,-14,1.10869565217391,1.32608695652174,1.6304347826087,-0.304347826086957,85,41,48,92,74,100,11,3.2
1957,"Watford",3,46,55,59,77,-18,1.19565217391304,1.28260869565217,1.67391304347826,-0.391304347826087,79,35,48,92,83,93,-4,2.8
1957,"West Bromwich Albion",1,42,68,92,70,22,1.61904761904762,2.19047619047619,1.66666666666667,0.523809523809524,6,6,22,22,7,121,-1,-0.2
1957,"West Ham United",2,42,80,101,54,47,1.9047619047619,2.4047619047619,1.28571428571429,1.11904761904762,23,1,22,44,5,94,18,1
1957,"Wolverhampton Wanderers",1,42,92,103,47,56,2.19047619047619,2.45238095238095,1.11904761904762,1.33333333333333,1,1,22,22,1,121,0,-1.6
1957,"Workington",3,46,55,72,81,-9,1.19565217391304,1.56521739130435,1.76086956521739,-0.195652173913043,80,36,48,92,88,26,-8,-1.1
1957,"Wrexham",3,46,63,61,63,-2,1.3695652173913,1.32608695652174,1.3695652173913,-0.0434782608695652,70,26,48,92,63,80,7,-0.6
1957,"York City",3,46,63,68,76,-8,1.3695652173913,1.47826086956522,1.65217391304348,-0.173913043478261,71,27,48,92,72,72,-1,-1.8
1958,"Accrington Stanley",3,46,57,71,87,-16,1.23913043478261,1.54347826086957,1.89130434782609,-0.347826086956522,62,18,24,68,68,34,-6,NA
1958,"AFC Bournemouth",3,46,63,69,69,0,1.3695652173913,1.5,1.5,0,57,13,24,68,58,90,-1,0.9
1958,"Aldershot",4,46,49,63,97,-34,1.06521739130435,1.3695652173913,2.10869565217391,-0.739130434782609,90,22,24,92,81,57,9,1
1958,"Arsenal",1,42,71,88,68,20,1.69047619047619,2.0952380952381,1.61904761904762,0.476190476190476,3,3,22,22,12,116,-9,0
1958,"Aston Villa",1,42,41,58,87,-29,0.976190476190476,1.38095238095238,2.07142857142857,-0.69047619047619,21,21,22,22,23,121,-2,-1.6
1958,"Barnsley",2,42,37,55,91,-36,0.880952380952381,1.30952380952381,2.16666666666667,-0.857142857142857,43,21,22,44,62,111,-19,-1
1958,"Barrow",4,46,37,51,104,-53,0.804347826086957,1.10869565217391,2.26086956521739,-1.15217391304348,91,23,24,92,85,44,6,3.4
1958,"Birmingham City",1,42,66,84,68,16,1.57142857142857,2,1.61904761904762,0.380952380952381,8,8,22,22,19,117,-11,-2.1
1958,"Blackburn Rovers",1,42,61,76,70,6,1.45238095238095,1.80952380952381,1.66666666666667,0.142857142857143,10,10,22,22,15,121,-5,-2.8
1958,"Blackpool",1,42,65,66,49,17,1.54761904761905,1.57142857142857,1.16666666666667,0.404761904761905,9,9,22,22,11,112,-2,-2.4
1958,"Bolton Wanderers",1,42,70,79,66,13,1.66666666666667,1.88095238095238,1.57142857142857,0.30952380952381,4,4,22,22,4,121,0,-3.5
1958,"Bradford City",3,46,65,84,76,8,1.41304347826087,1.82608695652174,1.65217391304348,0.173913043478261,54,10,24,68,63,106,-9,-1.7
1958,"Bradford Park Avenue",4,46,61,75,77,-2,1.32608695652174,1.6304347826087,1.67391304347826,-0.0434782608695652,80,12,24,92,79,51,1,-1.2
1958,"Brentford",3,46,78,76,49,27,1.69565217391304,1.65217391304348,1.06521739130435,0.58695652173913,48,4,24,68,48,93,0,-3.1
1958,"Brighton & Hove Albion",2,42,56,74,90,-16,1.33333333333333,1.76190476190476,2.14285714285714,-0.380952380952381,35,13,22,44,36,93,-1,-2
1958,"Bristol City",2,42,58,74,70,4,1.38095238095238,1.76190476190476,1.66666666666667,0.0952380952380952,32,10,22,44,44,108,-12,-0.9
1958,"Bristol Rovers",2,42,66,80,64,16,1.57142857142857,1.9047619047619,1.52380952380952,0.380952380952381,29,7,22,44,29,92,0,-2.9
1958,"Burnley",1,42,67,81,70,11,1.5952380952381,1.92857142857143,1.66666666666667,0.261904761904762,6,6,22,22,1,121,5,-0.8
1958,"Bury",3,46,65,69,58,11,1.41304347826087,1.5,1.26086956521739,0.239130434782609,55,11,24,68,49,114,6,1.2
1958,"Cardiff City",2,42,61,65,65,0,1.45238095238095,1.54761904761905,1.54761904761905,0,30,8,22,44,24,93,6,0.3
1958,"Carlisle United",4,46,69,62,65,-3,1.5,1.34782608695652,1.41304347826087,-0.0652173913043478,78,10,24,92,86,84,-8,4.6
1958,"Charlton Athletic",2,42,61,92,90,2,1.45238095238095,2.19047619047619,2.14285714285714,0.0476190476190476,31,9,22,44,30,92,1,0.6
1958,"Chelsea",1,42,58,77,98,-21,1.38095238095238,1.83333333333333,2.33333333333333,-0.5,11,11,22,22,17,104,-6,0.6
1958,"Chester",4,46,60,72,84,-12,1.30434782608696,1.56521739130435,1.82608695652174,-0.260869565217391,81,13,24,92,88,67,-7,-0.3
1958,"Chesterfield",3,46,61,67,64,3,1.32608695652174,1.45652173913043,1.39130434782609,0.0652173913043478,59,15,24,68,61,100,-2,-2.8
1958,"Colchester United",3,46,73,71,67,4,1.58695652173913,1.54347826086957,1.45652173913043,0.0869565217391304,49,5,24,68,54,68,-5,-2.4
1958,"Coventry City",4,46,84,84,47,37,1.82608695652174,1.82608695652174,1.02173913043478,0.804347826086957,70,2,24,92,47,94,23,5
1958,"Crewe Alexandra",4,46,55,70,82,-12,1.19565217391304,1.52173913043478,1.78260869565217,-0.260869565217391,85,17,24,92,82,96,3,1.8
1958,"Crystal Palace",4,46,72,90,71,19,1.56521739130435,1.95652173913043,1.54347826086957,0.41304347826087,75,7,24,92,76,93,-1,5.1
1958,"Darlington",4,46,55,66,68,-2,1.19565217391304,1.43478260869565,1.47826086956522,-0.0434782608695652,86,18,24,92,83,81,3,1.1
1958,"Derby County",2,42,68,74,71,3,1.61904761904762,1.76190476190476,1.69047619047619,0.0714285714285714,28,6,22,44,37,121,-9,0.5
1958,"Doncaster Rovers",3,46,47,50,90,-40,1.02173913043478,1.08695652173913,1.95652173913043,-0.869565217391304,66,22,24,68,84,88,-18,-0.3
1958,"Everton",1,42,55,71,87,-16,1.30952380952381,1.69047619047619,2.07142857142857,-0.380952380952381,15,15,22,22,18,121,-3,1.1
1958,"Exeter City",4,46,80,87,61,26,1.73913043478261,1.89130434782609,1.32608695652174,0.565217391304348,73,5,24,92,77,88,-4,-1.2
1958,"Fulham",2,42,87,96,61,35,2.07142857142857,2.28571428571429,1.45238095238095,0.833333333333333,24,2,22,44,9,102,15,-2
1958,"Gateshead",4,46,56,56,85,-29,1.21739130434783,1.21739130434783,1.84782608695652,-0.630434782608696,84,16,24,92,89,23,-5,NA
1958,"Gillingham",4,46,69,82,77,5,1.5,1.78260869565217,1.67391304347826,0.108695652173913,79,11,24,92,74,88,5,1.5
1958,"Grimsby Town",2,42,37,62,90,-28,0.880952380952381,1.47619047619048,2.14285714285714,-0.666666666666667,44,22,22,44,50,110,-6,-4.7
1958,"Halifax Town",3,46,71,80,77,3,1.54347826086957,1.73913043478261,1.67391304347826,0.0652173913043478,50,6,24,68,59,69,-9,-2
1958,"Hartlepool United",4,46,55,74,88,-14,1.19565217391304,1.60869565217391,1.91304347826087,-0.304347826086957,87,19,24,92,91,89,-4,2.1
1958,"Huddersfield Town",2,42,56,62,55,7,1.33333333333333,1.47619047619048,1.30952380952381,0.166666666666667,36,14,22,44,28,99,8,0.8
1958,"Hull City",3,46,87,90,55,35,1.89130434782609,1.95652173913043,1.19565217391304,0.760869565217391,45,1,24,68,43,104,2,1.1
1958,"Ipswich Town",2,42,57,62,77,-15,1.35714285714286,1.47619047619048,1.83333333333333,-0.357142857142857,33,11,22,44,32,75,1,2.1
1958,"Leeds United",1,42,54,57,74,-17,1.28571428571429,1.35714285714286,1.76190476190476,-0.404761904761905,16,16,22,22,21,93,-5,1.5
1958,"Leicester City",1,42,43,67,98,-31,1.02380952380952,1.5952380952381,2.33333333333333,-0.738095238095238,19,19,22,22,16,115,3,-0.2
1958,"Leyton Orient",2,42,50,71,78,-7,1.19047619047619,1.69047619047619,1.85714285714286,-0.166666666666667,39,17,22,44,33,102,6,-2.4
1958,"Lincoln City",2,42,40,63,93,-30,0.952380952380952,1.5,2.21428571428571,-0.714285714285714,41,19,22,44,34,107,7,-3.5
1958,"Liverpool",2,42,77,87,62,25,1.83333333333333,2.07142857142857,1.47619047619048,0.595238095238095,25,3,22,44,25,116,0,2.3
1958,"Luton Town",1,42,49,68,71,-3,1.16666666666667,1.61904761904762,1.69047619047619,-0.0714285714285714,17,17,22,22,22,91,-5,-3
1958,"Manchester City",1,42,42,64,95,-31,1,1.52380952380952,2.26190476190476,-0.738095238095238,20,20,22,22,13,117,7,0.7
1958,"Manchester United",1,42,79,103,66,37,1.88095238095238,2.45238095238095,1.57142857142857,0.880952380952381,2,2,22,22,7,117,-5,-0.8
1958,"Mansfield Town",3,46,55,73,98,-25,1.19565217391304,1.58695652173913,2.1304347826087,-0.543478260869565,64,20,24,68,65,77,-1,0.5
1958,"Middlesbrough",2,42,55,87,71,16,1.30952380952381,2.07142857142857,1.69047619047619,0.380952380952381,38,16,22,44,27,110,11,1.2
1958,"Millwall",4,46,70,76,69,7,1.52173913043478,1.65217391304348,1.5,0.152173913043478,77,9,24,92,75,93,2,4.7
1958,"Newcastle United",1,42,58,80,80,0,1.38095238095238,1.9047619047619,1.9047619047619,0,12,12,22,22,8,116,4,0.5
1958,"Newport County",3,46,60,69,68,1,1.30434782608696,1.5,1.47826086956522,0.0217391304347826,61,17,24,68,53,67,8,-2.9
1958,"Northampton Town",4,46,72,85,78,7,1.56521739130435,1.84782608695652,1.69565217391304,0.152173913043478,76,8,24,92,73,93,3,1.1
1958,"Norwich City",3,46,79,89,62,27,1.71739130434783,1.93478260869565,1.34782608695652,0.58695652173913,47,3,24,68,46,93,1,1.2
1958,"Nottingham Forest",1,42,57,71,74,-3,1.35714285714286,1.69047619047619,1.76190476190476,-0.0714285714285714,14,14,22,22,20,117,-6,-0.4
1958,"Notts County",3,46,37,55,96,-41,0.804347826086957,1.19565217391304,2.08695652173913,-0.891304347826087,67,23,24,68,70,120,-3,-2.1
1958,"Oldham Athletic",4,46,52,59,84,-25,1.1304347826087,1.28260869565217,1.82608695652174,-0.543478260869565,89,21,24,92,92,102,-3,2.1
1958,"Plymouth Argyle",3,46,85,89,59,30,1.84782608695652,1.93478260869565,1.28260869565217,0.652173913043478,46,2,24,68,40,93,6,-0.4
1958,"Port Vale",4,46,90,110,58,52,1.95652173913043,2.39130434782609,1.26086956521739,1.1304347826087,69,1,24,92,55,107,14,-1.2
1958,"Portsmouth",1,42,27,64,112,-48,0.642857142857143,1.52380952380952,2.66666666666667,-1.14285714285714,22,22,22,22,42,93,-20,-1.8
1958,"Preston North End",1,42,58,70,77,-7,1.38095238095238,1.66666666666667,1.83333333333333,-0.166666666666667,13,13,22,22,10,121,3,-2.3
1958,"Queens Park Rangers",3,46,65,74,77,-3,1.41304347826087,1.60869565217391,1.67391304347826,-0.0652173913043478,56,12,24,68,52,93,4,3.4
1958,"Reading",3,46,71,78,63,15,1.54347826086957,1.69565217391304,1.3695652173913,0.326086956521739,51,7,24,68,60,93,-9,-1
1958,"Rochdale",3,46,36,37,79,-42,0.782608695652174,0.804347826086957,1.71739130434783,-0.91304347826087,68,24,24,68,80,92,-12,-0.4
1958,"Rotherham United",2,42,39,42,82,-40,0.928571428571429,1,1.95238095238095,-0.952380952380952,42,20,22,44,31,88,11,-1.4
1958,"Scunthorpe United",2,42,45,55,84,-29,1.07142857142857,1.30952380952381,2,-0.69047619047619,40,18,22,44,38,70,2,-4.2
1958,"Sheffield United",2,42,76,82,48,34,1.80952380952381,1.95238095238095,1.14285714285714,0.80952380952381,26,4,22,44,26,117,0,-0.5
1958,"Sheffield Wednesday",2,42,90,106,48,58,2.14285714285714,2.52380952380952,1.14285714285714,1.38095238095238,23,1,22,44,5,117,18,0.8
1958,"Shrewsbury Town",4,46,82,101,63,38,1.78260869565217,2.19565217391304,1.3695652173913,0.826086956521739,71,3,24,92,51,69,20,1.1
1958,"Southampton",3,46,62,88,80,8,1.34782608695652,1.91304347826087,1.73913043478261,0.173913043478261,58,14,24,68,45,93,13,5.2
1958,"Southend United",3,46,71,85,80,5,1.54347826086957,1.84782608695652,1.73913043478261,0.108695652173913,52,8,24,68,56,93,-4,-2.2
1958,"Southport",4,46,33,41,86,-45,0.717391304347826,0.891304347826087,1.8695652173913,-0.978260869565217,92,24,24,92,90,50,2,4
1958,"Stockport County",3,46,49,65,78,-13,1.06521739130435,1.41304347826087,1.69565217391304,-0.282608695652174,65,21,24,68,78,99,-13,1.1
1958,"Stoke City",2,42,70,72,58,14,1.66666666666667,1.71428571428571,1.38095238095238,0.333333333333333,27,5,22,44,39,113,-12,0.8
1958,"Sunderland",2,42,56,64,75,-11,1.33333333333333,1.52380952380952,1.78571428571429,-0.261904761904762,37,15,22,44,41,119,-4,2.1
1958,"Swansea City",2,42,57,79,81,-2,1.35714285714286,1.88095238095238,1.92857142857143,-0.0476190476190476,34,12,22,44,35,93,-1,-4.3
1958,"Swindon Town",3,46,61,59,57,2,1.32608695652174,1.28260869565217,1.23913043478261,0.0434782608695652,60,16,24,68,57,93,3,1.5
1958,"Torquay United",4,46,60,78,77,1,1.30434782608696,1.69565217391304,1.67391304347826,0.0217391304347826,82,14,24,92,71,78,11,3.1
1958,"Tottenham Hotspur",1,42,49,85,95,-10,1.16666666666667,2.02380952380952,2.26190476190476,-0.238095238095238,18,18,22,22,3,101,15,1
1958,"Tranmere Rovers",3,46,71,82,67,15,1.54347826086957,1.78260869565217,1.45652173913043,0.326086956521739,53,9,24,68,64,89,-11,0.4
1958,"Walsall",4,46,73,95,64,31,1.58695652173913,2.06521739130435,1.39130434782609,0.673913043478261,74,6,24,92,69,100,5,1.2
1958,"Watford",4,46,58,81,79,2,1.26086956521739,1.76086956521739,1.71739130434783,0.0434782608695652,83,15,24,92,72,93,11,3.7
1958,"West Bromwich Albion",1,42,67,88,68,20,1.5952380952381,2.0952380952381,1.61904761904762,0.476190476190476,7,7,22,22,6,121,1,-0.2
1958,"West Ham United",1,42,69,85,70,15,1.64285714285714,2.02380952380952,1.66666666666667,0.357142857142857,5,5,22,22,14,94,-9,-0.6
1958,"Wolverhampton Wanderers",1,42,89,110,49,61,2.11904761904762,2.61904761904762,1.16666666666667,1.45238095238095,1,1,22,22,2,121,-1,-1.6
1958,"Workington",4,46,53,63,78,-15,1.15217391304348,1.3695652173913,1.69565217391304,-0.326086956521739,88,20,24,92,87,26,1,0.5
1958,"Wrexham",3,46,56,63,77,-14,1.21739130434783,1.3695652173913,1.67391304347826,-0.304347826086957,63,19,24,68,67,80,-4,-1.5
1958,"York City",4,46,81,73,52,21,1.76086956521739,1.58695652173913,1.1304347826087,0.456521739130435,72,4,24,92,66,72,6,-1.7
1959,"Accrington Stanley",3,46,38,57,123,-66,0.826086956521739,1.23913043478261,2.67391304347826,-1.43478260869565,68,24,24,68,86,34,-18,NA
1959,"AFC Bournemouth",3,46,64,72,72,0,1.39130434782609,1.56521739130435,1.56521739130435,0,58,14,24,68,62,90,-4,-0.8
1959,"Aldershot",4,46,63,77,74,3,1.3695652173913,1.67391304347826,1.60869565217391,0.0652173913043478,81,13,24,92,80,57,1,0.6
1959,"Arsenal",1,42,54,68,80,-12,1.28571428571429,1.61904761904762,1.9047619047619,-0.285714285714286,12,12,22,22,11,116,1,0
1959,"Aston Villa",2,42,84,89,43,46,2,2.11904761904762,1.02380952380952,1.0952380952381,23,1,22,44,8,121,15,-2
1959,"Barnsley",3,46,59,65,66,-1,1.28260869565217,1.41304347826087,1.43478260869565,-0.0217391304347826,62,18,24,68,50,111,12,1
1959,"Barrow",4,46,56,77,87,-10,1.21739130434783,1.67391304347826,1.89130434782609,-0.217391304347826,85,17,24,92,90,44,-5,1.8
1959,"Birmingham City",1,42,49,63,80,-17,1.16666666666667,1.5,1.9047619047619,-0.404761904761905,19,19,22,22,18,117,1,-2.1
1959,"Blackburn Rovers",1,42,53,60,70,-10,1.26190476190476,1.42857142857143,1.66666666666667,-0.238095238095238,15,15,22,22,10,121,5,-1.3
1959,"Blackpool",1,42,55,59,71,-12,1.30952380952381,1.4047619047619,1.69047619047619,-0.285714285714286,11,11,22,22,20,112,-9,-1.3
1959,"Bolton Wanderers",1,42,68,59,51,8,1.61904761904762,1.4047619047619,1.21428571428571,0.19047619047619,4,4,22,22,19,121,-15,-3.4
1959,"Bradford City",3,46,57,66,74,-8,1.23913043478261,1.43478260869565,1.60869565217391,-0.173913043478261,63,19,24,68,66,106,-3,0.9
1959,"Bradford Park Avenue",4,46,66,70,68,2,1.43478260869565,1.52173913043478,1.47826086956522,0.0434782608695652,79,11,24,92,71,51,8,-1.3
1959,"Brentford",3,46,72,78,61,17,1.56521739130435,1.69565217391304,1.32608695652174,0.369565217391304,48,4,24,68,61,93,-13,-2.5
1959,"Brighton & Hove Albion",2,42,51,67,76,-9,1.21428571428571,1.5952380952381,1.80952380952381,-0.214285714285714,36,14,22,44,38,93,-2,-1.1
1959,"Bristol City",2,42,38,60,97,-37,0.904761904761905,1.42857142857143,2.30952380952381,-0.880952380952381,44,22,22,44,56,108,-12,0.8
1959,"Bristol Rovers",2,42,65,72,78,-6,1.54761904761905,1.71428571428571,1.85714285714286,-0.142857142857143,29,7,22,44,36,92,-7,-1.9
1959,"Burnley",1,42,79,85,61,24,1.88095238095238,2.02380952380952,1.45238095238095,0.571428571428571,1,1,22,22,4,121,-3,-1.3
1959,"Bury",3,46,72,64,51,13,1.56521739130435,1.39130434782609,1.10869565217391,0.282608695652174,49,5,24,68,45,114,4,-1.4
1959,"Cardiff City",2,42,81,90,62,28,1.92857142857143,2.14285714285714,1.47619047619048,0.666666666666667,24,2,22,44,14,93,10,-0.5
1959,"Carlisle United",4,46,56,51,66,-15,1.21739130434783,1.10869565217391,1.43478260869565,-0.326086956521739,86,18,24,92,88,84,-2,5.1
1959,"Charlton Athletic",2,42,64,90,87,3,1.52380952380952,2.14285714285714,2.07142857142857,0.0714285714285714,30,8,22,44,31,92,-1,-1.2
1959,"Chelsea",1,42,51,76,91,-15,1.21428571428571,1.80952380952381,2.16666666666667,-0.357142857142857,17,17,22,22,12,104,5,1.4
1959,"Chester",4,46,54,59,77,-18,1.17391304347826,1.28260869565217,1.67391304347826,-0.391304347826087,88,20,24,92,92,67,-4,1.2
1959,"Chesterfield",3,46,61,71,84,-13,1.32608695652174,1.54347826086957,1.82608695652174,-0.282608695652174,61,17,24,68,68,100,-7,-0.8
1959,"Colchester United",3,46,65,83,74,9,1.41304347826087,1.80434782608696,1.60869565217391,0.195652173913043,54,10,24,68,67,68,-13,-2.4
1959,"Coventry City",3,46,73,78,63,15,1.58695652173913,1.69565217391304,1.3695652173913,0.326086956521739,47,3,24,68,58,94,-11,4.1
1959,"Crewe Alexandra",4,46,63,79,88,-9,1.3695652173913,1.71739130434783,1.91304347826087,-0.195652173913043,82,14,24,92,76,96,6,0
1959,"Crystal Palace",4,46,69,84,64,20,1.5,1.82608695652174,1.39130434782609,0.434782608695652,76,8,24,92,70,93,6,5.6
1959,"Darlington",4,46,60,63,73,-10,1.30434782608696,1.3695652173913,1.58695652173913,-0.217391304347826,83,15,24,92,77,81,6,-0.7
1959,"Derby County",2,42,49,61,77,-16,1.16666666666667,1.45238095238095,1.83333333333333,-0.380952380952381,37,15,22,44,34,121,3,3.3
1959,"Doncaster Rovers",4,46,58,69,76,-7,1.26086956521739,1.5,1.65217391304348,-0.152173913043478,84,16,24,92,78,88,6,2.9
1959,"Everton",1,42,50,73,78,-5,1.19047619047619,1.73809523809524,1.85714285714286,-0.119047619047619,18,18,22,22,5,121,13,1.7
1959,"Exeter City",4,46,68,80,70,10,1.47826086956522,1.73913043478261,1.52173913043478,0.217391304347826,77,9,24,92,89,88,-12,-0.9
1959,"Fulham",1,42,61,73,80,-7,1.45238095238095,1.73809523809524,1.9047619047619,-0.166666666666667,9,9,22,22,15,102,-6,-4
1959,"Gateshead",4,46,45,58,86,-28,0.978260869565217,1.26086956521739,1.8695652173913,-0.608695652173913,89,21,24,92,NA,23,NA,NA
1959,"Gillingham",4,46,73,74,69,5,1.58695652173913,1.60869565217391,1.5,0.108695652173913,74,6,24,92,85,88,-11,1
1959,"Grimsby Town",3,46,70,87,70,17,1.52173913043478,1.89130434782609,1.52173913043478,0.369565217391304,50,6,24,68,51,110,-1,-3.4
1959,"Halifax Town",3,46,64,70,72,-2,1.39130434782609,1.52173913043478,1.56521739130435,-0.0434782608695652,59,15,24,68,53,69,6,-0.2
1959,"Hartlepool United",4,46,37,59,109,-50,0.804347826086957,1.28260869565217,2.3695652173913,-1.08695652173913,91,23,24,92,91,89,0,0
1959,"Huddersfield Town",2,42,66,73,52,21,1.57142857142857,1.73809523809524,1.23809523809524,0.5,28,6,22,44,41,99,-13,0.5
1959,"Hull City",2,42,40,48,76,-28,0.952380952380952,1.14285714285714,1.80952380952381,-0.666666666666667,43,21,22,44,54,104,-11,0.9
1959,"Ipswich Town",2,42,63,78,68,10,1.5,1.85714285714286,1.61904761904762,0.238095238095238,32,10,22,44,23,75,9,1.4
1959,"Leeds United",1,42,46,65,92,-27,1.0952380952381,1.54761904761905,2.19047619047619,-0.642857142857143,21,21,22,22,37,93,-16,1.9
1959,"Leicester City",1,42,52,66,75,-9,1.23809523809524,1.57142857142857,1.78571428571429,-0.214285714285714,16,16,22,22,6,115,10,-1
1959,"Leyton Orient",2,42,59,76,61,15,1.4047619047619,1.80952380952381,1.45238095238095,0.357142857142857,33,11,22,44,39,102,-6,-1.2
1959,"Lincoln City",2,42,55,75,78,-3,1.30952380952381,1.78571428571429,1.85714285714286,-0.0714285714285714,34,12,22,44,44,107,-10,-4.3
1959,"Liverpool",2,42,70,90,66,24,1.66666666666667,2.14285714285714,1.57142857142857,0.571428571428571,25,3,22,44,25,116,0,2
1959,"Luton Town",1,42,39,50,73,-23,0.928571428571429,1.19047619047619,1.73809523809524,-0.547619047619048,22,22,22,22,35,91,-13,-2.4
1959,"Manchester City",1,42,54,78,84,-6,1.28571428571429,1.85714285714286,2,-0.142857142857143,13,13,22,22,16,117,-3,0.3
1959,"Manchester United",1,42,64,102,80,22,1.52380952380952,2.42857142857143,1.9047619047619,0.523809523809524,7,7,22,22,7,117,0,-0.4
1959,"Mansfield Town",3,46,51,81,112,-31,1.10869565217391,1.76086956521739,2.43478260869565,-0.673913043478261,65,21,24,68,87,77,-22,1.5
1959,"Middlesbrough",2,42,67,90,64,26,1.5952380952381,2.14285714285714,1.52380952380952,0.619047619047619,27,5,22,44,27,110,0,0
1959,"Millwall",4,46,71,84,61,23,1.54347826086957,1.82608695652174,1.32608695652174,0.5,75,7,24,92,74,93,1,4.3
1959,"Newcastle United",1,42,62,82,78,4,1.47619047619048,1.95238095238095,1.85714285714286,0.0952380952380952,8,8,22,22,21,116,-13,0.1
1959,"Newport County",3,46,66,80,79,1,1.43478260869565,1.73913043478261,1.71739130434783,0.0217391304347826,53,9,24,68,55,67,-2,-3.5
1959,"Northampton Town",4,46,75,85,63,22,1.6304347826087,1.84782608695652,1.3695652173913,0.478260869565217,73,5,24,92,72,93,1,-1
1959,"Norwich City",3,46,83,82,54,28,1.80434782608696,1.78260869565217,1.17391304347826,0.608695652173913,46,2,24,68,26,93,20,1.3
1959,"Nottingham Forest",1,42,48,50,74,-24,1.14285714285714,1.19047619047619,1.76190476190476,-0.571428571428571,20,20,22,22,13,117,7,0.4
1959,"Notts County",4,46,86,107,69,38,1.8695652173913,2.32608695652174,1.5,0.826086956521739,70,2,24,92,48,120,22,-0.4
1959,"Oldham Athletic",4,46,36,41,83,-42,0.782608695652174,0.891304347826087,1.80434782608696,-0.91304347826087,92,24,24,92,79,102,13,0.5
1959,"Plymouth Argyle",2,42,48,61,89,-28,1.14285714285714,1.45238095238095,2.11904761904762,-0.666666666666667,40,18,22,44,32,93,8,-1.7
1959,"Port Vale",3,46,65,80,79,1,1.41304347826087,1.73913043478261,1.71739130434783,0.0217391304347826,55,11,24,68,52,107,3,-1.7
1959,"Portsmouth",2,42,42,59,77,-18,1,1.4047619047619,1.83333333333333,-0.428571428571429,42,20,22,44,43,93,-1,0.3
1959,"Preston North End",1,42,60,79,76,3,1.42857142857143,1.88095238095238,1.80952380952381,0.0714285714285714,10,10,22,22,22,121,-12,-3.4
1959,"Queens Park Rangers",3,46,67,73,54,19,1.45652173913043,1.58695652173913,1.17391304347826,0.41304347826087,52,8,24,68,47,93,5,2.1
1959,"Reading",3,46,64,84,77,7,1.39130434782609,1.82608695652174,1.67391304347826,0.152173913043478,60,16,24,68,63,93,-3,0.9
1959,"Rochdale",4,46,64,65,60,5,1.39130434782609,1.41304347826087,1.30434782608696,0.108695652173913,80,12,24,92,83,92,-3,2.7
1959,"Rotherham United",2,42,64,61,60,1,1.52380952380952,1.45238095238095,1.42857142857143,0.0238095238095238,31,9,22,44,40,88,-9,-2.7
1959,"Scunthorpe United",2,42,49,57,71,-14,1.16666666666667,1.35714285714286,1.69047619047619,-0.333333333333333,38,16,22,44,33,70,5,-4.2
1959,"Sheffield United",2,42,69,68,51,17,1.64285714285714,1.61904761904762,1.21428571428571,0.404761904761905,26,4,22,44,24,117,2,0.1
1959,"Sheffield Wednesday",1,42,68,80,59,21,1.61904761904762,1.9047619047619,1.4047619047619,0.5,5,5,22,22,3,117,2,-1.6
1959,"Shrewsbury Town",3,46,70,97,75,22,1.52173913043478,2.10869565217391,1.6304347826087,0.478260869565217,51,7,24,68,57,69,-6,-1.1
1959,"Southampton",3,46,87,106,75,31,1.89130434782609,2.30434782608696,1.6304347826087,0.673913043478261,45,1,24,68,30,93,15,2.6
1959,"Southend United",3,46,65,76,74,2,1.41304347826087,1.65217391304348,1.60869565217391,0.0434782608695652,56,12,24,68,64,93,-8,-2.9
1959,"Southport",4,46,44,48,92,-44,0.956521739130435,1.04347826086957,2,-0.956521739130435,90,22,24,92,81,50,9,2.5
1959,"Stockport County",4,46,68,58,54,4,1.47826086956522,1.26086956521739,1.17391304347826,0.0869565217391304,78,10,24,92,82,99,-4,1
1959,"Stoke City",2,42,49,66,83,-17,1.16666666666667,1.57142857142857,1.97619047619048,-0.404761904761905,39,17,22,44,42,113,-3,3.1
1959,"Sunderland",2,42,48,52,65,-13,1.14285714285714,1.23809523809524,1.54761904761905,-0.30952380952381,41,19,22,44,29,119,12,1.9
1959,"Swansea City",2,42,55,82,84,-2,1.30952380952381,1.95238095238095,2,-0.0476190476190476,35,13,22,44,28,93,7,-3.6
1959,"Swindon Town",3,46,65,69,78,-9,1.41304347826087,1.5,1.69565217391304,-0.195652173913043,57,13,24,68,60,93,-3,2.7
1959,"Torquay United",4,46,86,84,58,26,1.8695652173913,1.82608695652174,1.26086956521739,0.565217391304348,71,3,24,92,59,78,12,1.2
1959,"Tottenham Hotspur",1,42,74,86,50,36,1.76190476190476,2.04761904761905,1.19047619047619,0.857142857142857,3,3,22,22,1,101,2,-0.6
1959,"Tranmere Rovers",3,46,55,72,75,-3,1.19565217391304,1.56521739130435,1.6304347826087,-0.0652173913043478,64,20,24,68,65,89,-1,0.4
1959,"Walsall",4,46,93,102,60,42,2.02173913043478,2.21739130434783,1.30434782608696,0.91304347826087,69,1,24,92,46,100,23,1.3
1959,"Watford",4,46,81,92,67,25,1.76086956521739,2,1.45652173913043,0.543478260869565,72,4,24,92,49,93,23,3.1
1959,"West Bromwich Albion",1,42,68,83,57,26,1.61904761904762,1.97619047619048,1.35714285714286,0.619047619047619,6,6,22,22,9,121,-3,-0.9
1959,"West Ham United",1,42,54,75,91,-16,1.28571428571429,1.78571428571429,2.16666666666667,-0.380952380952381,14,14,22,22,17,94,-3,-0.3
1959,"Wolverhampton Wanderers",1,42,78,106,67,39,1.85714285714286,2.52380952380952,1.5952380952381,0.928571428571429,2,2,22,22,2,121,0,-1.1
1959,"Workington",4,46,56,68,60,8,1.21739130434783,1.47826086956522,1.30434782608696,0.173913043478261,87,19,24,92,75,26,12,-0.2
1959,"Wrexham",3,46,50,68,101,-33,1.08695652173913,1.47826086956522,2.19565217391304,-0.717391304347826,67,23,24,68,84,80,-17,-0.3
1959,"York City",3,46,51,57,73,-16,1.10869565217391,1.23913043478261,1.58695652173913,-0.347826086956522,66,22,24,68,73,72,-7,-1.5
1960,"Accrington Stanley",4,46,56,74,88,-14,1.21739130434783,1.60869565217391,1.91304347826087,-0.304347826086957,86,18,24,92,92,34,-6,NA
1960,"AFC Bournemouth",3,46,55,58,76,-18,1.19565217391304,1.26086956521739,1.65217391304348,-0.391304347826087,62,18,24,68,49,90,13,-0.8
1960,"Aldershot",4,46,63,79,69,10,1.3695652173913,1.71739130434783,1.5,0.217391304347826,80,12,24,92,73,57,7,-0.5
1960,"Arsenal",1,42,56,77,85,-8,1.33333333333333,1.83333333333333,2.02380952380952,-0.19047619047619,11,11,22,22,9,116,2,1
1960,"Aston Villa",1,42,60,78,77,1,1.42857142857143,1.85714285714286,1.83333333333333,0.0238095238095238,8,8,22,22,7,121,1,-4
1960,"Barnsley",3,46,70,83,80,3,1.52173913043478,1.80434782608696,1.73913043478261,0.0652173913043478,50,6,24,68,63,111,-13,-0.5
1960,"Barrow",4,46,50,52,79,-27,1.08695652173913,1.1304347826087,1.71739130434783,-0.58695652173913,90,22,24,92,78,44,12,-0.2
1960,"Birmingham City",1,42,48,62,84,-22,1.14285714285714,1.47619047619048,2,-0.523809523809524,18,18,22,22,17,117,1,-1.3
1960,"Blackburn Rovers",1,42,58,77,76,1,1.38095238095238,1.83333333333333,1.80952380952381,0.0238095238095238,10,10,22,22,16,121,-6,-3.3
1960,"Blackpool",1,42,45,68,73,-5,1.07142857142857,1.61904761904762,1.73809523809524,-0.119047619047619,20,20,22,22,14,112,6,-0.2
1960,"Bolton Wanderers",1,42,47,58,73,-15,1.11904761904762,1.38095238095238,1.73809523809524,-0.357142857142857,19,19,22,22,10,121,9,-2.5
1960,"Bradford City",3,46,47,65,87,-22,1.02173913043478,1.41304347826087,1.89130434782609,-0.478260869565217,66,22,24,68,74,106,-8,0.4
1960,"Bradford Park Avenue",4,46,86,84,74,10,1.8695652173913,1.82608695652174,1.60869565217391,0.217391304347826,71,3,24,92,54,51,17,NA
1960,"Brentford",3,46,56,56,70,-14,1.21739130434783,1.21739130434783,1.52173913043478,-0.304347826086957,61,17,24,68,66,93,-5,-1.8
1960,"Brighton & Hove Albion",2,42,51,61,75,-14,1.21428571428571,1.45238095238095,1.78571428571429,-0.333333333333333,38,16,22,44,44,93,-6,-2
1960,"Bristol City",3,46,61,70,68,2,1.32608695652174,1.52173913043478,1.47826086956522,0.0434782608695652,56,12,24,68,50,108,6,1.5
1960,"Bristol Rovers",2,42,52,73,92,-19,1.23809523809524,1.73809523809524,2.19047619047619,-0.452380952380952,36,14,22,44,43,92,-7,-1.3
1960,"Burnley",1,42,73,102,77,25,1.73809523809524,2.42857142857143,1.83333333333333,0.595238095238095,4,4,22,22,2,121,2,-1.7
1960,"Bury",3,46,98,108,45,63,2.1304347826087,2.34782608695652,0.978260869565217,1.3695652173913,45,1,24,68,32,114,13,-2.1
1960,"Cardiff City",1,42,50,60,85,-25,1.19047619047619,1.42857142857143,2.02380952380952,-0.595238095238095,14,14,22,22,21,93,-7,-1.1
1960,"Carlisle United",4,46,52,61,79,-18,1.1304347826087,1.32608695652174,1.71739130434783,-0.391304347826087,88,20,24,92,72,84,16,6.2
1960,"Charlton Athletic",2,42,59,97,91,6,1.4047619047619,2.30952380952381,2.16666666666667,0.142857142857143,31,9,22,44,36,92,-5,-1.1
1960,"Chelsea",1,42,52,98,100,-2,1.23809523809524,2.33333333333333,2.38095238095238,-0.0476190476190476,12,12,22,22,22,104,-10,0.7
1960,"Chester",4,46,42,61,104,-43,0.91304347826087,1.32608695652174,2.26086956521739,-0.934782608695652,92,24,24,92,90,67,2,2
1960,"Chesterfield",3,46,42,67,87,-20,0.91304347826087,1.45652173913043,1.89130434782609,-0.434782608695652,68,24,24,68,88,100,-20,1.7
1960,"Colchester United",3,46,44,68,101,-33,0.956521739130435,1.47826086956522,2.19565217391304,-0.717391304347826,67,23,24,68,69,68,-2,-0.7
1960,"Coventry City",3,46,60,80,83,-3,1.30434782608696,1.73913043478261,1.80434782608696,-0.0652173913043478,58,14,24,68,58,94,0,4.9
1960,"Crewe Alexandra",4,46,69,61,67,-6,1.5,1.32608695652174,1.45652173913043,-0.130434782608696,76,8,24,92,79,96,-3,-0.4
1960,"Crystal Palace",4,46,93,110,69,41,2.02173913043478,2.39130434782609,1.5,0.891304347826087,70,2,24,92,59,93,11,5.4
1960,"Darlington",4,46,67,78,70,8,1.45652173913043,1.69565217391304,1.52173913043478,0.173913043478261,77,9,24,92,83,81,-6,-0.4
1960,"Derby County",2,42,55,80,80,0,1.30952380952381,1.9047619047619,1.9047619047619,0,34,12,22,44,38,121,-4,2.4
1960,"Doncaster Rovers",4,46,64,76,78,-2,1.39130434782609,1.65217391304348,1.69565217391304,-0.0434782608695652,78,10,24,92,89,88,-11,1.1
1960,"Everton",1,42,72,87,69,18,1.71428571428571,2.07142857142857,1.64285714285714,0.428571428571429,5,5,22,22,4,121,1,-0.9
1960,"Exeter City",4,46,52,66,94,-28,1.1304347826087,1.43478260869565,2.04347826086957,-0.608695652173913,89,21,24,92,86,88,3,1.1
1960,"Fulham",1,42,50,72,95,-23,1.19047619047619,1.71428571428571,2.26190476190476,-0.547619047619048,15,15,22,22,20,102,-5,-3
1960,"Gillingham",4,46,58,64,66,-2,1.26086956521739,1.39130434782609,1.43478260869565,-0.0434782608695652,85,17,24,92,87,88,-2,1.7
1960,"Grimsby Town",3,46,70,77,69,8,1.52173913043478,1.67391304347826,1.5,0.173913043478261,51,7,24,68,46,110,5,-3.2
1960,"Halifax Town",3,46,65,71,78,-7,1.41304347826087,1.54347826086957,1.69565217391304,-0.152173913043478,53,9,24,68,60,69,-7,0.6
1960,"Hartlepool United",4,46,44,71,103,-32,0.956521739130435,1.54347826086957,2.23913043478261,-0.695652173913043,91,23,24,92,91,89,0,0
1960,"Huddersfield Town",2,42,48,62,71,-9,1.14285714285714,1.47619047619048,1.69047619047619,-0.214285714285714,41,19,22,44,29,99,12,2.4
1960,"Hull City",3,46,63,73,73,0,1.3695652173913,1.58695652173913,1.58695652173913,0,54,10,24,68,53,104,1,2.7
1960,"Ipswich Town",2,42,85,100,55,45,2.02380952380952,2.38095238095238,1.30952380952381,1.07142857142857,23,1,22,44,1,75,22,0.5
1960,"Leeds United",2,42,52,75,83,-8,1.23809523809524,1.78571428571429,1.97619047619048,-0.19047619047619,37,15,22,44,41,93,-4,3.5
1960,"Leicester City",1,42,63,87,70,17,1.5,2.07142857142857,1.66666666666667,0.404761904761905,6,6,22,22,13,115,-7,-1.7
1960,"Leyton Orient",2,42,50,55,78,-23,1.19047619047619,1.30952380952381,1.85714285714286,-0.547619047619048,39,17,22,44,24,102,15,0
1960,"Lincoln City",2,42,32,48,95,-47,0.761904761904762,1.14285714285714,2.26190476190476,-1.11904761904762,44,22,22,44,67,107,-23,-4.5
1960,"Liverpool",2,42,73,87,58,29,1.73809523809524,2.07142857142857,1.38095238095238,0.69047619047619,25,3,22,44,23,116,2,1.9
1960,"Luton Town",2,42,54,71,79,-8,1.28571428571429,1.69047619047619,1.88095238095238,-0.19047619047619,35,13,22,44,33,91,2,0.7
1960,"Manchester City",1,42,50,79,90,-11,1.19047619047619,1.88095238095238,2.14285714285714,-0.261904761904762,16,16,22,22,11,117,5,0.4
1960,"Manchester United",1,42,63,88,76,12,1.5,2.0952380952381,1.80952380952381,0.285714285714286,7,7,22,22,15,117,-8,-0.1
1960,"Mansfield Town",4,46,54,71,78,-7,1.17391304347826,1.54347826086957,1.69565217391304,-0.152173913043478,87,19,24,92,84,77,3,3.7
1960,"Middlesbrough",2,42,66,83,74,9,1.57142857142857,1.97619047619048,1.76190476190476,0.214285714285714,27,5,22,44,34,110,-7,-0.3
1960,"Millwall",4,46,71,97,86,11,1.54347826086957,2.10869565217391,1.8695652173913,0.239130434782609,74,6,24,92,70,93,4,4.5
1960,"Newcastle United",1,42,43,86,109,-23,1.02380952380952,2.04761904761905,2.5952380952381,-0.547619047619048,21,21,22,22,37,116,-16,1
1960,"Newport County",3,46,62,81,90,-9,1.34782608695652,1.76086956521739,1.95652173913043,-0.195652173913043,55,11,24,68,68,67,-13,-3.5
1960,"Northampton Town",4,46,85,90,62,28,1.84782608695652,1.95652173913043,1.34782608695652,0.608695652173913,72,4,24,92,52,93,20,-0.3
1960,"Norwich City",2,42,69,70,53,17,1.64285714285714,1.66666666666667,1.26190476190476,0.404761904761905,26,4,22,44,39,93,-13,-0.6
1960,"Nottingham Forest",1,42,51,62,78,-16,1.21428571428571,1.47619047619048,1.85714285714286,-0.380952380952381,13,13,22,22,18,117,-5,0
1960,"Notts County",3,46,72,82,77,5,1.56521739130435,1.78260869565217,1.67391304347826,0.108695652173913,48,4,24,68,57,120,-9,-2.1
1960,"Oldham Athletic",4,46,64,79,88,-9,1.39130434782609,1.71739130434783,1.91304347826087,-0.195652173913043,79,11,24,92,81,102,-2,0.8
1960,"Peterborough United",4,46,94,134,65,69,2.04347826086957,2.91304347826087,1.41304347826087,1.5,69,1,24,92,47,60,22,-1.5
1960,"Plymouth Argyle",2,42,59,81,82,-1,1.4047619047619,1.92857142857143,1.95238095238095,-0.0238095238095238,32,10,22,44,27,93,5,-2.9
1960,"Port Vale",3,46,66,96,79,17,1.43478260869565,2.08695652173913,1.71739130434783,0.369565217391304,52,8,24,68,56,107,-4,-0.7
1960,"Portsmouth",2,42,44,64,91,-27,1.04761904761905,1.52380952380952,2.16666666666667,-0.642857142857143,43,21,22,44,45,93,-2,0.5
1960,"Preston North End",1,42,40,43,71,-28,0.952380952380952,1.02380952380952,1.69047619047619,-0.666666666666667,22,22,22,22,35,121,-13,-2.4
1960,"Queens Park Rangers",3,46,85,93,60,33,1.84782608695652,2.02173913043478,1.30434782608696,0.717391304347826,47,3,24,68,48,93,-1,1.4
1960,"Reading",3,46,54,72,83,-11,1.17391304347826,1.56521739130435,1.80434782608696,-0.239130434782609,63,19,24,68,51,93,12,0
1960,"Rochdale",4,46,59,60,66,-6,1.28260869565217,1.30434782608696,1.43478260869565,-0.130434782608696,83,15,24,92,77,92,6,2.3
1960,"Rotherham United",2,42,49,65,64,1,1.16666666666667,1.54761904761905,1.52380952380952,0.0238095238095238,40,18,22,44,31,88,9,-1.3
1960,"Scunthorpe United",2,42,57,69,64,5,1.35714285714286,1.64285714285714,1.52380952380952,0.119047619047619,33,11,22,44,26,70,7,-5.4
1960,"Sheffield United",2,42,84,81,51,30,2,1.92857142857143,1.21428571428571,0.714285714285714,24,2,22,44,5,117,19,0
1960,"Sheffield Wednesday",1,42,81,78,47,31,1.92857142857143,1.85714285714286,1.11904761904762,0.738095238095238,3,3,22,22,6,117,-3,-3.4
1960,"Shrewsbury Town",3,46,61,83,75,8,1.32608695652174,1.80434782608696,1.6304347826087,0.173913043478261,57,13,24,68,64,69,-7,0.1
1960,"Southampton",2,42,62,84,81,3,1.47619047619048,2,1.92857142857143,0.0714285714285714,30,8,22,44,28,93,2,2.3
1960,"Southend United",3,46,53,60,76,-16,1.15217391304348,1.30434782608696,1.65217391304348,-0.347826086956522,64,20,24,68,61,93,3,-2.4
1960,"Southport",4,46,63,69,67,2,1.3695652173913,1.5,1.45652173913043,0.0434782608695652,81,13,24,92,85,50,-4,0.5
1960,"Stockport County",4,46,63,57,66,-9,1.3695652173913,1.23913043478261,1.43478260869565,-0.195652173913043,82,14,24,92,82,99,0,0
1960,"Stoke City",2,42,48,51,59,-8,1.14285714285714,1.21428571428571,1.4047619047619,-0.19047619047619,42,20,22,44,30,113,12,2.7
1960,"Sunderland",2,42,64,75,60,15,1.52380952380952,1.78571428571429,1.42857142857143,0.357142857142857,29,7,22,44,25,119,4,-0.5
1960,"Swansea City",2,42,65,77,73,4,1.54761904761905,1.83333333333333,1.73809523809524,0.0952380952380952,28,6,22,44,42,93,-14,-2.9
1960,"Swindon Town",3,46,57,62,55,7,1.23913043478261,1.34782608695652,1.19565217391304,0.152173913043478,60,16,24,68,55,93,5,2.5
1960,"Torquay United",3,46,59,75,83,-8,1.28260869565217,1.6304347826087,1.80434782608696,-0.173913043478261,59,15,24,68,65,78,-6,0.7
1960,"Tottenham Hotspur",1,42,97,115,55,60,2.30952380952381,2.73809523809524,1.30952380952381,1.42857142857143,1,1,22,22,3,101,-2,-0.3
1960,"Tranmere Rovers",3,46,53,79,115,-36,1.15217391304348,1.71739130434783,2.5,-0.782608695652174,65,21,24,68,80,89,-15,0
1960,"Walsall",3,46,90,98,60,38,1.95652173913043,2.1304347826087,1.30434782608696,0.826086956521739,46,2,24,68,40,100,6,-1.8
1960,"Watford",3,46,72,85,72,13,1.56521739130435,1.84782608695652,1.56521739130435,0.282608695652174,49,5,24,68,62,93,-13,0.9
1960,"West Bromwich Albion",1,42,59,67,71,-4,1.4047619047619,1.5952380952381,1.69047619047619,-0.0952380952380952,9,9,22,22,12,121,-3,-1
1960,"West Ham United",1,42,49,77,88,-11,1.16666666666667,1.83333333333333,2.0952380952381,-0.261904761904762,17,17,22,22,8,94,9,-0.3
1960,"Wolverhampton Wanderers",1,42,82,103,75,28,1.95238095238095,2.45238095238095,1.78571428571429,0.666666666666667,2,2,22,22,19,121,-17,-0.1
1960,"Workington",4,46,70,74,76,-2,1.52173913043478,1.60869565217391,1.65217391304348,-0.0434782608695652,75,7,24,92,76,26,-1,-0.2
1960,"Wrexham",4,46,59,62,56,6,1.28260869565217,1.34782608695652,1.21739130434783,0.130434782608696,84,16,24,92,71,80,13,3
1960,"York City",4,46,72,80,60,20,1.56521739130435,1.73913043478261,1.30434782608696,0.434782608695652,73,5,24,92,75,72,-2,0
1961,"Accrington Stanley",4,33,23,19,60,-41,0.696969696969697,0.575757575757576,1.81818181818182,-1.24242424242424,92,24,24,92,NA,34,NA,NA
1961,"AFC Bournemouth",3,46,80,69,45,24,1.73913043478261,1.5,0.978260869565217,0.521739130434783,49,5,24,68,50,90,-1,0.1
1961,"Aldershot",4,46,75,85,62,23,1.6304347826087,1.84782608695652,1.34782608695652,0.5,73,5,24,92,80,57,-7,-1.5
1961,"Arsenal",1,42,59,71,72,-1,1.4047619047619,1.69047619047619,1.71428571428571,-0.0238095238095238,9,9,22,22,7,116,2,0.4
1961,"Aston Villa",1,42,62,65,56,9,1.47619047619048,1.54761904761905,1.33333333333333,0.214285714285714,7,7,22,22,14,121,-7,-3.8
1961,"Barnsley",3,46,51,71,95,-24,1.10869565217391,1.54347826086957,2.06521739130435,-0.521739130434783,63,19,24,68,62,111,1,-0.2
1961,"Barrow",4,46,69,79,61,18,1.5,1.71739130434783,1.32608695652174,0.391304347826087,78,10,24,92,77,44,1,-0.9
1961,"Birmingham City",1,42,52,65,81,-16,1.23809523809524,1.54761904761905,1.92857142857143,-0.380952380952381,17,17,22,22,20,117,-3,-0.7
1961,"Blackburn Rovers",1,42,53,50,58,-8,1.26190476190476,1.19047619047619,1.38095238095238,-0.19047619047619,16,16,22,22,11,121,5,-3.7
1961,"Blackpool",1,42,56,70,75,-5,1.33333333333333,1.66666666666667,1.78571428571429,-0.119047619047619,14,14,22,22,15,112,-1,-1.3
1961,"Bolton Wanderers",1,42,58,62,66,-4,1.38095238095238,1.47619047619048,1.57142857142857,-0.0952380952380952,10,10,22,22,17,121,-7,-4.2
1961,"Bradford City",4,46,75,96,87,9,1.6304347826087,2.08695652173913,1.89130434782609,0.195652173913043,74,6,24,92,91,106,-17,0.7
1961,"Bradford Park Avenue",3,46,67,80,78,2,1.45652173913043,1.73913043478261,1.69565217391304,0.0434782608695652,54,10,24,68,65,51,-11,NA
1961,"Brentford",3,46,47,53,93,-40,1.02173913043478,1.15217391304348,2.02173913043478,-0.869565217391304,66,22,24,68,69,93,-3,-0.5
1961,"Brighton & Hove Albion",2,42,41,42,86,-44,0.976190476190476,1,2.04761904761905,-1.04761904761905,44,22,22,44,66,93,-22,-0.2
1961,"Bristol City",3,46,77,94,72,22,1.67391304347826,2.04347826086957,1.56521739130435,0.478260869565217,50,6,24,68,58,108,-8,1.9
1961,"Bristol Rovers",2,42,46,53,81,-28,1.0952380952381,1.26190476190476,1.92857142857143,-0.666666666666667,43,21,22,44,63,92,-20,-0.6
1961,"Burnley",1,42,74,101,67,34,1.76190476190476,2.4047619047619,1.5952380952381,0.80952380952381,2,2,22,22,3,121,-1,-2.7
1961,"Bury",2,42,56,52,76,-24,1.33333333333333,1.23809523809524,1.80952380952381,-0.571428571428571,32,10,22,44,28,114,4,-4.2
1961,"Cardiff City",1,42,41,50,81,-31,0.976190476190476,1.19047619047619,1.92857142857143,-0.738095238095238,21,21,22,22,31,93,-10,-2.2
1961,"Carlisle United",4,46,77,66,64,2,1.67391304347826,1.43478260869565,1.39130434782609,0.0434782608695652,72,4,24,92,67,84,5,4
1961,"Charlton Athletic",2,42,54,69,75,-6,1.28571428571429,1.64285714285714,1.78571428571429,-0.142857142857143,36,14,22,44,42,92,-6,-0.6
1961,"Chelsea",1,42,37,63,94,-31,0.880952380952381,1.5,2.23809523809524,-0.738095238095238,22,22,22,22,23,104,-1,1.4
1961,"Chester",4,46,37,55,96,-41,0.804347826086957,1.19565217391304,2.08695652173913,-0.891304347826087,90,22,24,92,87,67,3,0
1961,"Chesterfield",4,45,52,70,87,-17,1.15555555555556,1.55555555555556,1.93333333333333,-0.377777777777778,88,20,24,92,86,100,2,3.3
1961,"Colchester United",4,46,84,111,73,38,1.82608695652174,2.41304347826087,1.58695652173913,0.826086956521739,69,1,24,92,55,68,14,-0.7
1961,"Coventry City",3,46,59,64,71,-7,1.28260869565217,1.39130434782609,1.54347826086957,-0.152173913043478,58,14,24,68,48,94,10,3.9
1961,"Crewe Alexandra",4,46,69,83,71,12,1.5,1.80434782608696,1.54347826086957,0.260869565217391,79,11,24,92,70,96,9,-1.3
1961,"Crystal Palace",3,46,56,83,80,3,1.21739130434783,1.80434782608696,1.73913043478261,0.0652173913043478,59,15,24,68,56,93,3,3.9
1961,"Darlington",4,46,64,63,77,-14,1.39130434782609,1.3695652173913,1.67391304347826,-0.304347826086957,83,15,24,92,79,81,4,-0.3
1961,"Derby County",2,42,53,68,75,-7,1.26190476190476,1.61904761904762,1.78571428571429,-0.166666666666667,38,16,22,44,40,121,-2,3.7
1961,"Doncaster Rovers",4,45,41,61,86,-25,0.911111111111111,1.35555555555556,1.91111111111111,-0.555555555555556,89,21,24,92,84,88,5,0.9
1961,"Everton",1,42,71,88,54,34,1.69047619047619,2.0952380952381,1.28571428571429,0.80952380952381,4,4,22,22,1,121,3,-1.2
1961,"Exeter City",4,45,53,65,77,-12,1.17777777777778,1.44444444444444,1.71111111111111,-0.266666666666667,86,18,24,92,83,88,3,0.3
1961,"Fulham",1,42,46,66,74,-8,1.0952380952381,1.57142857142857,1.76190476190476,-0.19047619047619,20,20,22,22,16,102,4,-2.1
1961,"Gillingham",4,45,53,78,95,-17,1.17777777777778,1.73333333333333,2.11111111111111,-0.377777777777778,87,19,24,92,73,88,14,0.5
1961,"Grimsby Town",3,46,90,80,56,24,1.95652173913043,1.73913043478261,1.21739130434783,0.521739130434783,46,2,24,68,41,110,5,-2.3
1961,"Halifax Town",3,46,55,62,84,-22,1.19565217391304,1.34782608695652,1.82608695652174,-0.478260869565217,60,16,24,68,68,69,-8,-0.1
1961,"Hartlepool United",4,44,35,52,101,-49,0.795454545454545,1.18181818181818,2.29545454545455,-1.11363636363636,91,23,24,92,92,89,-1,0.6
1961,"Huddersfield Town",2,42,60,67,59,8,1.42857142857143,1.5952380952381,1.4047619047619,0.19047619047619,29,7,22,44,29,99,0,0.7
1961,"Hull City",3,46,68,67,54,13,1.47826086956522,1.45652173913043,1.17391304347826,0.282608695652174,53,9,24,68,54,104,-1,1.9
1961,"Ipswich Town",1,42,80,93,67,26,1.9047619047619,2.21428571428571,1.5952380952381,0.619047619047619,1,1,22,22,18,75,-17,-1.2
1961,"Leeds United",2,42,48,50,61,-11,1.14285714285714,1.19047619047619,1.45238095238095,-0.261904761904762,41,19,22,44,27,93,14,3.9
1961,"Leicester City",1,42,57,72,71,1,1.35714285714286,1.71428571428571,1.69047619047619,0.0238095238095238,13,13,22,22,4,115,9,0.1
1961,"Leyton Orient",2,42,76,69,40,29,1.80952380952381,1.64285714285714,0.952380952380952,0.69047619047619,24,2,22,44,22,102,2,-1.1
1961,"Lincoln City",3,46,44,57,87,-30,0.956521739130435,1.23913043478261,1.89130434782609,-0.652173913043478,67,23,24,68,90,107,-23,-0.6
1961,"Liverpool",2,42,89,99,43,56,2.11904761904762,2.35714285714286,1.02380952380952,1.33333333333333,23,1,22,44,8,116,15,2
1961,"Luton Town",2,42,56,69,71,-2,1.33333333333333,1.64285714285714,1.69047619047619,-0.0476190476190476,33,11,22,44,44,91,-11,-0.6
1961,"Manchester City",1,42,58,78,81,-3,1.38095238095238,1.85714285714286,1.92857142857143,-0.0714285714285714,11,11,22,22,21,117,-10,0.7
1961,"Manchester United",1,42,54,72,75,-3,1.28571428571429,1.71428571428571,1.78571428571429,-0.0714285714285714,15,15,22,22,19,117,-4,0.8
1961,"Mansfield Town",4,45,64,77,66,11,1.42222222222222,1.71111111111111,1.46666666666667,0.244444444444444,84,16,24,92,72,77,12,1.8
1961,"Middlesbrough",2,42,55,76,72,4,1.30952380952381,1.80952380952381,1.71428571428571,0.0952380952380952,34,12,22,44,26,110,8,0.4
1961,"Millwall",4,45,82,89,62,27,1.82222222222222,1.97777777777778,1.37777777777778,0.6,70,2,24,92,61,93,9,4.5
1961,"Newcastle United",2,42,54,64,58,6,1.28571428571429,1.52380952380952,1.38095238095238,0.142857142857143,37,15,22,44,30,116,7,2.6
1961,"Newport County",3,46,29,46,102,-56,0.630434782608696,1,2.21739130434783,-1.21739130434783,68,24,24,68,89,67,-21,-1.3
1961,"Northampton Town",3,46,71,85,57,28,1.54347826086957,1.84782608695652,1.23913043478261,0.608695652173913,52,8,24,68,45,93,7,-3.7
1961,"Norwich City",2,42,53,61,70,-9,1.26190476190476,1.45238095238095,1.66666666666667,-0.214285714285714,39,17,22,44,33,93,6,1.6
1961,"Nottingham Forest",1,42,49,63,79,-16,1.16666666666667,1.5,1.88095238095238,-0.380952380952381,18,18,22,22,9,117,9,-0.3
1961,"Notts County",3,46,60,67,74,-7,1.30434782608696,1.45652173913043,1.60869565217391,-0.152173913043478,57,13,24,68,51,120,6,1
1961,"Oldham Athletic",4,46,66,82,71,11,1.43478260869565,1.78260869565217,1.54347826086957,0.239130434782609,81,13,24,92,71,102,10,2.5
1961,"Peterborough United",3,46,84,107,82,25,1.82608695652174,2.32608695652174,1.78260869565217,0.543478260869565,47,3,24,68,49,60,-2,-3
1961,"Plymouth Argyle",2,42,65,75,75,0,1.54761904761905,1.78571428571429,1.78571428571429,0,27,5,22,44,35,93,-8,-2.4
1961,"Port Vale",3,46,62,65,58,7,1.34782608695652,1.41304347826087,1.26086956521739,0.152173913043478,56,12,24,68,47,107,9,-0.4
1961,"Portsmouth",3,46,92,87,47,40,2,1.89130434782609,1.02173913043478,0.869565217391304,45,1,24,68,38,93,7,0.7
1961,"Preston North End",2,42,55,55,57,-2,1.30952380952381,1.30952380952381,1.35714285714286,-0.0476190476190476,35,13,22,44,39,121,-4,-0.5
1961,"Queens Park Rangers",3,46,83,111,73,38,1.80434782608696,2.41304347826087,1.58695652173913,0.826086956521739,48,4,24,68,57,93,-9,2.2
1961,"Reading",3,46,75,77,66,11,1.6304347826087,1.67391304347826,1.43478260869565,0.239130434782609,51,7,24,68,64,93,-13,-3.3
1961,"Rochdale",4,46,70,74,71,3,1.52173913043478,1.60869565217391,1.54347826086957,0.0652173913043478,77,9,24,92,75,92,2,1.5
1961,"Rotherham United",2,42,57,70,76,-6,1.35714285714286,1.66666666666667,1.80952380952381,-0.142857142857143,31,9,22,44,36,88,-5,-1.9
1961,"Scunthorpe United",2,42,70,86,71,15,1.66666666666667,2.04761904761905,1.69047619047619,0.357142857142857,26,4,22,44,32,70,-6,-4.6
1961,"Sheffield United",1,42,66,61,69,-8,1.57142857142857,1.45238095238095,1.64285714285714,-0.19047619047619,5,5,22,22,10,117,-5,-0.5
1961,"Sheffield Wednesday",1,42,66,72,58,14,1.57142857142857,1.71428571428571,1.38095238095238,0.333333333333333,6,6,22,22,6,117,0,-3
1961,"Shrewsbury Town",3,46,51,73,84,-11,1.10869565217391,1.58695652173913,1.82608695652174,-0.239130434782609,64,20,24,68,59,69,5,0.7
1961,"Southampton",2,42,63,77,62,15,1.5,1.83333333333333,1.47619047619048,0.357142857142857,28,6,22,44,34,93,-6,1
1961,"Southend United",3,46,55,57,69,-12,1.19565217391304,1.23913043478261,1.5,-0.260869565217391,61,17,24,68,52,93,9,-0.9
1961,"Southport",4,44,60,61,71,-10,1.36363636363636,1.38636363636364,1.61363636363636,-0.227272727272727,85,17,24,92,81,50,4,1
1961,"Stockport County",4,46,66,74,70,4,1.43478260869565,1.60869565217391,1.52173913043478,0.0869565217391304,82,14,24,92,85,99,-3,-0.9
1961,"Stoke City",2,42,59,55,57,-2,1.4047619047619,1.30952380952381,1.35714285714286,-0.0476190476190476,30,8,22,44,24,113,6,1.3
1961,"Sunderland",2,42,75,85,50,35,1.78571428571429,2.02380952380952,1.19047619047619,0.833333333333333,25,3,22,44,25,119,0,-0.3
1961,"Swansea City",2,42,48,61,83,-22,1.14285714285714,1.45238095238095,1.97619047619048,-0.523809523809524,42,20,22,44,37,93,5,-1.6
1961,"Swindon Town",3,46,66,78,71,7,1.43478260869565,1.69565217391304,1.54347826086957,0.152173913043478,55,11,24,68,46,93,9,2.2
1961,"Torquay United",3,46,51,76,100,-24,1.10869565217391,1.65217391304348,2.17391304347826,-0.521739130434783,65,21,24,68,74,78,-9,-0.3
1961,"Tottenham Hotspur",1,42,73,88,69,19,1.73809523809524,2.0952380952381,1.64285714285714,0.452380952380952,3,3,22,22,2,101,1,-0.3
1961,"Tranmere Rovers",4,46,68,73,82,-9,1.47826086956522,1.58695652173913,1.78260869565217,-0.195652173913043,80,12,24,92,76,89,4,1.6
1961,"Walsall",2,42,53,70,75,-5,1.26190476190476,1.66666666666667,1.78571428571429,-0.119047619047619,40,18,22,44,43,100,-3,-1.4
1961,"Watford",3,46,55,63,74,-11,1.19565217391304,1.3695652173913,1.60869565217391,-0.239130434782609,62,18,24,68,60,93,2,1.8
1961,"West Bromwich Albion",1,42,58,83,67,16,1.38095238095238,1.97619047619048,1.5952380952381,0.380952380952381,12,12,22,22,12,121,0,-0.3
1961,"West Ham United",1,42,61,76,82,-6,1.45238095238095,1.80952380952381,1.95238095238095,-0.142857142857143,8,8,22,22,13,94,-5,-0.6
1961,"Wolverhampton Wanderers",1,42,49,73,86,-13,1.16666666666667,1.73809523809524,2.04761904761905,-0.30952380952381,19,19,22,22,5,121,14,1
1961,"Workington",4,45,71,73,70,3,1.57777777777778,1.62222222222222,1.55555555555556,0.0666666666666667,76,8,24,92,78,26,-2,-0.2
1961,"Wrexham",4,45,78,98,56,42,1.73333333333333,2.17777777777778,1.24444444444444,0.933333333333333,71,3,24,92,53,80,18,1.2
1961,"York City",4,45,73,85,53,32,1.62222222222222,1.88888888888889,1.17777777777778,0.711111111111111,75,7,24,92,82,72,-7,1.2
1962,"AFC Bournemouth",3,46,70,63,46,17,1.52173913043478,1.3695652173913,1,0.369565217391304,50,6,24,68,48,90,2,-0.3
1962,"Aldershot",4,46,62,73,69,4,1.34782608695652,1.58695652173913,1.5,0.0869565217391304,80,12,24,92,77,57,3,0.9
1962,"Arsenal",1,42,64,86,77,9,1.52380952380952,2.04761904761905,1.83333333333333,0.214285714285714,7,7,22,22,8,116,-1,0.5
1962,"Aston Villa",1,42,53,62,68,-6,1.26190476190476,1.47619047619048,1.61904761904762,-0.142857142857143,14,14,22,22,19,121,-5,-1.1
1962,"Barnsley",3,46,56,63,74,-11,1.21739130434783,1.3695652173913,1.60869565217391,-0.239130434782609,62,18,24,68,65,111,-3,-2.1
1962,"Barrow",4,46,69,82,80,2,1.5,1.78260869565217,1.73913043478261,0.0434782608695652,77,9,24,92,92,44,-15,NA
1962,"Birmingham City",1,42,43,63,90,-27,1.02380952380952,1.5,2.14285714285714,-0.642857142857143,20,20,22,22,20,117,0,1
1962,"Blackburn Rovers",1,42,57,79,71,8,1.35714285714286,1.88095238095238,1.69047619047619,0.19047619047619,11,11,22,22,7,121,4,-3.6
1962,"Blackpool",1,42,53,58,64,-6,1.26190476190476,1.38095238095238,1.52380952380952,-0.142857142857143,15,15,22,22,18,112,-3,-1.1
1962,"Bolton Wanderers",1,42,50,55,75,-20,1.19047619047619,1.30952380952381,1.78571428571429,-0.476190476190476,17,17,22,22,21,121,-4,-2.8
1962,"Bradford City",4,46,43,64,93,-29,0.934782608695652,1.39130434782609,2.02173913043478,-0.630434782608696,91,23,24,92,72,106,19,0.9
1962,"Bradford Park Avenue",3,46,54,79,97,-18,1.17391304347826,1.71739130434783,2.10869565217391,-0.391304347826087,65,21,24,68,81,51,-16,NA
1962,"Brentford",4,46,89,98,64,34,1.93478260869565,2.1304347826087,1.39130434782609,0.739130434782609,69,1,24,92,60,93,9,0.3
1962,"Brighton & Hove Albion",3,46,48,58,84,-26,1.04347826086957,1.26086956521739,1.82608695652174,-0.565217391304348,66,22,24,68,76,93,-10,2.2
1962,"Bristol City",3,46,61,100,92,8,1.32608695652174,2.17391304347826,2,0.173913043478261,58,14,24,68,49,108,9,2.9
1962,"Bristol Rovers",3,46,56,70,88,-18,1.21739130434783,1.52173913043478,1.91304347826087,-0.391304347826087,63,19,24,68,53,92,10,1.4
1962,"Burnley",1,42,76,78,57,21,1.80952380952381,1.85714285714286,1.35714285714286,0.5,3,3,22,22,9,121,-6,-2
1962,"Bury",2,42,65,51,47,4,1.54761904761905,1.21428571428571,1.11904761904762,0.0952380952380952,28,6,22,44,39,114,-11,-5.3
1962,"Cardiff City",2,42,61,83,73,10,1.45238095238095,1.97619047619048,1.73809523809524,0.238095238095238,31,9,22,44,36,93,-5,-1.1
1962,"Carlisle United",3,46,48,61,89,-28,1.04347826086957,1.32608695652174,1.93478260869565,-0.608695652173913,67,23,24,68,69,84,-2,2.7
1962,"Charlton Athletic",2,42,44,62,94,-32,1.04761904761905,1.47619047619048,2.23809523809524,-0.761904761904762,42,20,22,44,26,92,16,-1.2
1962,"Chelsea",2,42,76,81,42,39,1.80952380952381,1.92857142857143,1,0.928571428571429,23,1,22,44,5,104,18,1
1962,"Chester",4,46,54,51,66,-15,1.17391304347826,1.10869565217391,1.43478260869565,-0.326086956521739,87,19,24,92,79,67,8,0.3
1962,"Chesterfield",4,46,55,70,64,6,1.19565217391304,1.52173913043478,1.39130434782609,0.130434782608696,86,18,24,92,83,100,3,2.8
1962,"Colchester United",3,46,65,73,93,-20,1.41304347826087,1.58695652173913,2.02173913043478,-0.434782608695652,55,11,24,68,62,68,-7,-3.5
1962,"Coventry City",3,46,71,83,69,14,1.54347826086957,1.80434782608696,1.5,0.304347826086957,48,4,24,68,46,94,2,3
1962,"Crewe Alexandra",4,46,83,86,58,28,1.80434782608696,1.8695652173913,1.26086956521739,0.608695652173913,70,2,24,92,66,96,4,-1.9
1962,"Crystal Palace",3,46,64,68,58,10,1.39130434782609,1.47826086956522,1.26086956521739,0.217391304347826,56,12,24,68,45,93,11,3.5
1962,"Darlington",4,46,63,72,87,-15,1.3695652173913,1.56521739130435,1.89130434782609,-0.326086956521739,79,11,24,92,87,81,-8,-1.3
1962,"Derby County",2,42,48,61,72,-11,1.14285714285714,1.45238095238095,1.71428571428571,-0.261904761904762,40,18,22,44,35,121,5,3.6
1962,"Doncaster Rovers",4,46,56,64,77,-13,1.21739130434783,1.39130434782609,1.67391304347826,-0.282608695652174,84,16,24,92,84,88,0,-0.1
1962,"Everton",1,42,86,84,42,42,2.04761904761905,2,1,1,1,1,22,22,3,121,-2,-1.5
1962,"Exeter City",4,46,58,57,77,-20,1.26086956521739,1.23913043478261,1.67391304347826,-0.434782608695652,83,15,24,92,73,88,10,0.7
1962,"Fulham",1,42,52,50,71,-21,1.23809523809524,1.19047619047619,1.69047619047619,-0.5,16,16,22,22,15,102,1,-1.6
1962,"Gillingham",4,46,79,71,49,22,1.71739130434783,1.54347826086957,1.06521739130435,0.478260869565217,73,5,24,92,70,88,3,-0.4
1962,"Grimsby Town",2,42,46,55,66,-11,1.0952380952381,1.30952380952381,1.57142857142857,-0.261904761904762,41,19,22,44,42,110,-1,-1.1
1962,"Halifax Town",3,46,39,64,106,-42,0.847826086956522,1.39130434782609,2.30434782608696,-0.91304347826087,68,24,24,68,80,69,-12,0.5
1962,"Hartlepool United",4,46,32,56,104,-48,0.695652173913043,1.21739130434783,2.26086956521739,-1.04347826086957,92,24,24,92,91,89,1,0.5
1962,"Huddersfield Town",2,42,65,63,50,13,1.54761904761905,1.5,1.19047619047619,0.30952380952381,29,7,22,44,34,99,-5,-1.4
1962,"Hull City",3,46,67,74,69,5,1.45652173913043,1.60869565217391,1.5,0.108695652173913,54,10,24,68,54,104,0,1.9
1962,"Ipswich Town",1,42,47,59,78,-19,1.11904761904762,1.4047619047619,1.85714285714286,-0.452380952380952,18,18,22,22,22,75,-4,1.3
1962,"Leeds United",2,42,67,79,53,26,1.5952380952381,1.88095238095238,1.26190476190476,0.619047619047619,27,5,22,44,23,93,4,2.4
1962,"Leicester City",1,42,72,79,53,26,1.71428571428571,1.88095238095238,1.26190476190476,0.619047619047619,4,4,22,22,10,115,-6,-1.5
1962,"Leyton Orient",1,42,27,37,81,-44,0.642857142857143,0.880952380952381,1.92857142857143,-1.04761904761905,22,22,22,22,38,102,-16,-1.5
1962,"Lincoln City",4,46,48,68,89,-21,1.04347826086957,1.47826086956522,1.93478260869565,-0.456521739130435,90,22,24,92,78,107,12,1.1
1962,"Liverpool",1,42,61,71,59,12,1.45238095238095,1.69047619047619,1.4047619047619,0.285714285714286,8,8,22,22,1,116,7,0.7
1962,"Luton Town",2,42,40,61,84,-23,0.952380952380952,1.45238095238095,2,-0.547619047619048,44,22,22,44,61,91,-17,1
1962,"Manchester City",1,42,41,58,102,-44,0.976190476190476,1.38095238095238,2.42857142857143,-1.04761904761905,21,21,22,22,29,117,-8,1
1962,"Manchester United",1,42,46,67,81,-14,1.0952380952381,1.5952380952381,1.92857142857143,-0.333333333333333,19,19,22,22,2,117,17,0.2
1962,"Mansfield Town",4,46,81,108,69,39,1.76086956521739,2.34782608695652,1.5,0.847826086956522,72,4,24,92,51,77,21,-0.2
1962,"Middlesbrough",2,42,69,86,85,1,1.64285714285714,2.04761904761905,2.02380952380952,0.0238095238095238,26,4,22,44,33,110,-7,-0.1
1962,"Millwall",3,46,58,82,87,-5,1.26086956521739,1.78260869565217,1.89130434782609,-0.108695652173913,61,17,24,68,64,93,-3,2.8
1962,"Newcastle United",2,42,65,79,59,20,1.54761904761905,1.88095238095238,1.4047619047619,0.476190476190476,30,8,22,44,28,116,2,2.2
1962,"Newport County",4,46,53,76,90,-14,1.15217391304348,1.65217391304348,1.95652173913043,-0.304347826086957,89,21,24,92,82,67,7,1.7
1962,"Northampton Town",3,46,88,109,60,49,1.91304347826087,2.3695652173913,1.30434782608696,1.06521739130435,45,1,24,68,32,93,13,-4.6
1962,"Norwich City",2,42,59,80,79,1,1.4047619047619,1.9047619047619,1.88095238095238,0.0238095238095238,33,11,22,44,40,93,-7,1.3
1962,"Nottingham Forest",1,42,61,67,69,-2,1.45238095238095,1.5952380952381,1.64285714285714,-0.0476190476190476,9,9,22,22,13,117,-4,-2.7
1962,"Notts County",3,46,70,73,74,-1,1.52173913043478,1.58695652173913,1.60869565217391,-0.0217391304347826,51,7,24,68,68,120,-17,0.5
1962,"Oldham Athletic",4,46,83,95,60,35,1.80434782608696,2.06521739130435,1.30434782608696,0.760869565217391,71,3,24,92,52,102,19,2.1
1962,"Oxford United",4,46,54,70,71,-1,1.17391304347826,1.52173913043478,1.54347826086957,-0.0217391304347826,88,20,24,92,86,54,2,6
1962,"Peterborough United",3,46,71,93,75,18,1.54347826086957,2.02173913043478,1.6304347826087,0.391304347826087,49,5,24,68,55,60,-6,-3.7
1962,"Plymouth Argyle",2,42,57,76,73,3,1.35714285714286,1.80952380952381,1.73809523809524,0.0714285714285714,35,13,22,44,43,93,-8,-1.6
1962,"Port Vale",3,46,77,72,58,14,1.67391304347826,1.56521739130435,1.26086956521739,0.304347826086957,47,3,24,68,58,107,-11,-0.1
1962,"Portsmouth",2,42,50,63,79,-16,1.19047619047619,1.5,1.88095238095238,-0.380952380952381,38,16,22,44,31,93,7,0
1962,"Preston North End",2,42,50,59,74,-15,1.19047619047619,1.4047619047619,1.76190476190476,-0.357142857142857,39,17,22,44,25,121,14,-0.2
1962,"Queens Park Rangers",3,46,62,85,76,9,1.34782608695652,1.84782608695652,1.65217391304348,0.195652173913043,57,13,24,68,57,93,0,3.3
1962,"Reading",3,46,56,74,78,-4,1.21739130434783,1.60869565217391,1.69565217391304,-0.0869565217391304,64,20,24,68,50,93,14,-1.1
1962,"Rochdale",4,46,71,67,59,8,1.54347826086957,1.45652173913043,1.28260869565217,0.173913043478261,75,7,24,92,89,92,-14,1.6
1962,"Rotherham United",2,42,57,67,74,-7,1.35714285714286,1.5952380952381,1.76190476190476,-0.166666666666667,36,14,22,44,30,88,6,-2.6
1962,"Scunthorpe United",2,42,60,57,59,-2,1.42857142857143,1.35714285714286,1.4047619047619,-0.0476190476190476,32,10,22,44,44,70,-12,-3.6
1962,"Sheffield United",1,42,60,58,60,-2,1.42857142857143,1.38095238095238,1.42857142857143,-0.0476190476190476,10,10,22,22,11,117,-1,-0.2
1962,"Sheffield Wednesday",1,42,67,77,63,14,1.5952380952381,1.83333333333333,1.5,0.333333333333333,6,6,22,22,6,117,0,-2.5
1962,"Shrewsbury Town",3,46,60,83,81,2,1.30434782608696,1.80434782608696,1.76086956521739,0.0434782608695652,59,15,24,68,56,69,3,-0.1
1962,"Southampton",2,42,59,72,67,5,1.4047619047619,1.71428571428571,1.5952380952381,0.119047619047619,34,12,22,44,27,93,7,1.9
1962,"Southend United",3,46,69,75,77,-2,1.5,1.6304347826087,1.67391304347826,-0.0434782608695652,52,8,24,68,59,93,-7,-0.3
1962,"Southport",4,46,59,72,106,-34,1.28260869565217,1.56521739130435,2.30434782608696,-0.739130434782609,81,13,24,92,88,50,-7,1.2
1962,"Stockport County",4,46,56,56,70,-14,1.21739130434783,1.21739130434783,1.52173913043478,-0.304347826086957,85,17,24,92,85,99,0,0.7
1962,"Stoke City",2,42,73,73,50,23,1.73809523809524,1.73809523809524,1.19047619047619,0.547619047619048,24,2,22,44,16,113,8,1
1962,"Sunderland",2,42,72,84,55,29,1.71428571428571,2,1.30952380952381,0.69047619047619,25,3,22,44,24,119,1,-0.5
1962,"Swansea City",2,42,54,51,72,-21,1.28571428571429,1.21428571428571,1.71428571428571,-0.5,37,15,22,44,41,93,-4,-3
1962,"Swindon Town",3,46,80,87,56,31,1.73913043478261,1.89130434782609,1.21739130434783,0.673913043478261,46,2,24,68,37,93,9,0.7
1962,"Torquay United",4,46,76,75,56,19,1.65217391304348,1.6304347826087,1.21739130434783,0.41304347826087,74,6,24,92,74,78,0,-1.4
1962,"Tottenham Hotspur",1,42,78,111,62,49,1.85714285714286,2.64285714285714,1.47619047619048,1.16666666666667,2,2,22,22,4,101,-2,-0.7
1962,"Tranmere Rovers",4,46,70,81,67,14,1.52173913043478,1.76086956521739,1.45652173913043,0.304347826086957,76,8,24,92,75,89,1,2
1962,"Walsall",2,42,42,53,89,-36,1,1.26190476190476,2.11904761904762,-0.857142857142857,43,21,22,44,63,100,-20,-1.4
1962,"Watford",3,46,59,82,85,-3,1.28260869565217,1.78260869565217,1.84782608695652,-0.0652173913043478,60,16,24,68,47,93,13,-0.5
1962,"West Bromwich Albion",1,42,55,71,79,-8,1.30952380952381,1.69047619047619,1.88095238095238,-0.19047619047619,12,12,22,22,12,121,0,-1
1962,"West Ham United",1,42,54,73,69,4,1.28571428571429,1.73809523809524,1.64285714285714,0.0952380952380952,13,13,22,22,14,94,-1,0.6
1962,"Wolverhampton Wanderers",1,42,70,93,65,28,1.66666666666667,2.21428571428571,1.54761904761905,0.666666666666667,5,5,22,22,17,121,-12,-0.1
1962,"Workington",4,46,64,76,68,8,1.39130434782609,1.65217391304348,1.47826086956522,0.173913043478261,78,10,24,92,71,26,7,-0.2
1962,"Wrexham",3,46,69,84,83,1,1.5,1.82608695652174,1.80434782608696,0.0217391304347826,53,9,24,68,67,80,-14,-0.8
1962,"York City",4,46,59,67,62,5,1.28260869565217,1.45652173913043,1.34782608695652,0.108695652173913,82,14,24,92,90,72,-8,1.8
1963,"AFC Bournemouth",3,46,80,79,58,21,1.73913043478261,1.71739130434783,1.26086956521739,0.456521739130435,48,4,24,68,54,90,-6,-0.8
1963,"Aldershot",4,46,67,83,78,5,1.45652173913043,1.80434782608696,1.69565217391304,0.108695652173913,77,9,24,92,86,57,-9,2.5
1963,"Arsenal",1,42,62,90,82,8,1.47619047619048,2.14285714285714,1.95238095238095,0.19047619047619,8,8,22,22,10,116,-2,0
1963,"Aston Villa",1,42,45,62,71,-9,1.07142857142857,1.47619047619048,1.69047619047619,-0.214285714285714,19,19,22,22,14,121,5,-1.7
1963,"Barnsley",3,46,51,68,94,-26,1.10869565217391,1.47826086956522,2.04347826086957,-0.565217391304348,65,21,24,68,68,111,-3,-1.4
1963,"Barrow",4,46,36,51,93,-42,0.782608695652174,1.10869565217391,2.02173913043478,-0.91304347826087,92,24,24,92,88,44,4,NA
1963,"Birmingham City",1,42,40,54,92,-38,0.952380952380952,1.28571428571429,2.19047619047619,-0.904761904761905,20,20,22,22,22,117,-2,0.3
1963,"Blackburn Rovers",1,42,64,89,65,24,1.52380952380952,2.11904761904762,1.54761904761905,0.571428571428571,7,7,22,22,11,121,-4,-4.7
1963,"Blackpool",1,42,48,52,73,-21,1.14285714285714,1.23809523809524,1.73809523809524,-0.5,18,18,22,22,17,112,1,-0.9
1963,"Bolton Wanderers",1,42,38,48,80,-32,0.904761904761905,1.14285714285714,1.9047619047619,-0.761904761904762,21,21,22,22,25,121,-4,-1.2
1963,"Bradford City",4,46,81,76,62,14,1.76086956521739,1.65217391304348,1.34782608695652,0.304347826086957,72,4,24,92,87,106,-15,-0.4
1963,"Bradford Park Avenue",4,46,63,75,81,-6,1.3695652173913,1.6304347826087,1.76086956521739,-0.130434782608696,81,13,24,92,76,51,5,NA
1963,"Brentford",3,46,59,87,80,7,1.28260869565217,1.89130434782609,1.73913043478261,0.152173913043478,60,16,24,68,48,93,12,-2.7
1963,"Brighton & Hove Albion",4,46,69,71,52,19,1.5,1.54347826086957,1.1304347826087,0.41304347826087,76,8,24,92,70,93,6,1.4
1963,"Bristol City",3,46,75,84,64,20,1.6304347826087,1.82608695652174,1.39130434782609,0.434782608695652,49,5,24,68,46,108,3,1.1
1963,"Bristol Rovers",3,46,65,91,79,12,1.41304347826087,1.97826086956522,1.71739130434783,0.260869565217391,53,9,24,68,51,92,2,0.7
1963,"Burnley",1,42,61,71,64,7,1.45238095238095,1.69047619047619,1.52380952380952,0.166666666666667,9,9,22,22,12,121,-3,0.4
1963,"Bury",2,42,48,57,73,-16,1.14285714285714,1.35714285714286,1.73809523809524,-0.380952380952381,39,17,22,44,38,114,1,-3.3
1963,"Cardiff City",2,42,52,56,81,-25,1.23809523809524,1.33333333333333,1.92857142857143,-0.595238095238095,36,14,22,44,37,93,-1,-0.4
1963,"Carlisle United",4,46,85,113,58,55,1.84782608695652,2.45652173913043,1.26086956521739,1.19565217391304,69,1,24,92,45,84,24,4.5
1963,"Charlton Athletic",2,42,67,76,70,6,1.5952380952381,1.80952380952381,1.66666666666667,0.142857142857143,26,4,22,44,39,92,-13,-2.7
1963,"Chelsea",1,42,70,72,56,16,1.66666666666667,1.71428571428571,1.33333333333333,0.380952380952381,5,5,22,22,3,104,2,-1.3
1963,"Chester",4,46,65,65,60,5,1.41304347826087,1.41304347826087,1.30434782608696,0.108695652173913,79,11,24,92,74,67,5,0.4
1963,"Chesterfield",4,46,57,57,71,-14,1.23913043478261,1.23913043478261,1.54347826086957,-0.304347826086957,83,15,24,92,79,100,4,3.4
1963,"Colchester United",3,46,55,70,68,2,1.19565217391304,1.52173913043478,1.47826086956522,0.0434782608695652,62,18,24,68,67,68,-5,-0.9
1963,"Coventry City",3,46,82,98,61,37,1.78260869565217,2.1304347826087,1.32608695652174,0.804347826086957,46,2,24,68,31,94,15,3.1
1963,"Crewe Alexandra",3,46,45,50,77,-27,0.978260869565217,1.08695652173913,1.67391304347826,-0.58695652173913,66,22,24,68,80,96,-14,-2.2
1963,"Crystal Palace",3,46,83,73,51,22,1.80434782608696,1.58695652173913,1.10869565217391,0.478260869565217,45,1,24,68,29,93,16,0.3
1963,"Darlington",4,46,54,66,93,-27,1.17391304347826,1.43478260869565,2.02173913043478,-0.58695652173913,87,19,24,92,81,81,6,-0.2
1963,"Derby County",2,42,53,56,67,-11,1.26190476190476,1.33333333333333,1.5952380952381,-0.261904761904762,35,13,22,44,32,121,3,3.2
1963,"Doncaster Rovers",4,46,57,70,75,-5,1.23913043478261,1.52173913043478,1.6304347826087,-0.108695652173913,84,16,24,92,77,88,7,-0.6
1963,"Everton",1,42,73,84,64,20,1.73809523809524,2,1.52380952380952,0.476190476190476,3,3,22,22,4,121,-1,-0.4
1963,"Exeter City",4,46,78,62,37,25,1.69565217391304,1.34782608695652,0.804347826086957,0.543478260869565,73,5,24,92,62,88,11,-0.4
1963,"Fulham",1,42,52,58,65,-7,1.23809523809524,1.38095238095238,1.54761904761905,-0.166666666666667,15,15,22,22,20,102,-5,-1.5
1963,"Gillingham",4,46,83,59,30,29,1.80434782608696,1.28260869565217,0.652173913043478,0.630434782608696,70,2,24,92,50,88,20,0
1963,"Grimsby Town",2,42,41,47,75,-28,0.976190476190476,1.11904761904762,1.78571428571429,-0.666666666666667,42,20,22,44,55,110,-13,-0.8
1963,"Halifax Town",4,46,65,77,77,0,1.41304347826087,1.67391304347826,1.67391304347826,0,80,12,24,92,90,69,-10,2.3
1963,"Hartlepool United",4,46,45,54,93,-39,0.978260869565217,1.17391304347826,2.02173913043478,-0.847826086956522,91,23,24,92,85,89,6,1.1
1963,"Huddersfield Town",2,42,55,57,64,-7,1.30952380952381,1.35714285714286,1.52380952380952,-0.166666666666667,34,12,22,44,30,99,4,-2.1
1963,"Hull City",3,46,65,73,68,5,1.41304347826087,1.58695652173913,1.47826086956522,0.108695652173913,54,10,24,68,49,104,5,2
1963,"Ipswich Town",1,42,34,56,121,-65,0.80952380952381,1.33333333333333,2.88095238095238,-1.54761904761905,22,22,22,22,28,75,-6,1.8
1963,"Leeds United",2,42,87,71,34,37,2.07142857142857,1.69047619047619,0.80952380952381,0.880952380952381,23,1,22,44,1,93,22,2.2
1963,"Leicester City",1,42,59,61,58,3,1.4047619047619,1.45238095238095,1.38095238095238,0.0714285714285714,10,10,22,22,19,115,-9,-0.1
1963,"Leyton Orient",2,42,49,54,72,-18,1.16666666666667,1.28571428571429,1.71428571428571,-0.428571428571429,38,16,22,44,41,102,-3,1
1963,"Lincoln City",4,46,66,67,75,-8,1.43478260869565,1.45652173913043,1.6304347826087,-0.173913043478261,78,10,24,92,91,107,-13,-0.3
1963,"Liverpool",1,42,83,92,45,47,1.97619047619048,2.19047619047619,1.07142857142857,1.11904761904762,1,1,22,22,7,116,-6,-0.1
1963,"Luton Town",3,46,58,64,80,-16,1.26086956521739,1.39130434782609,1.73913043478261,-0.347826086956522,61,17,24,68,65,91,-4,3.6
1963,"Manchester City",2,42,64,84,66,18,1.52380952380952,2,1.57142857142857,0.428571428571429,29,7,22,44,33,117,-4,1.7
1963,"Manchester United",1,42,76,90,62,28,1.80952380952381,2.14285714285714,1.47619047619048,0.666666666666667,2,2,22,22,2,117,0,-1.9
1963,"Mansfield Town",3,46,71,76,62,14,1.54347826086957,1.65217391304348,1.34782608695652,0.304347826086957,51,7,24,68,47,77,4,-3.3
1963,"Middlesbrough",2,42,56,67,52,15,1.33333333333333,1.5952380952381,1.23809523809524,0.357142857142857,33,11,22,44,40,110,-7,1
1963,"Millwall",3,46,52,53,67,-14,1.1304347826087,1.15217391304348,1.45652173913043,-0.304347826086957,64,20,24,68,72,93,-8,2.9
1963,"Newcastle United",2,42,65,74,69,5,1.54761904761905,1.76190476190476,1.64285714285714,0.119047619047619,28,6,22,44,23,116,5,1.2
1963,"Newport County",4,46,59,64,73,-9,1.28260869565217,1.39130434782609,1.58695652173913,-0.195652173913043,82,14,24,92,83,67,-1,0.4
1963,"Northampton Town",2,42,57,58,60,-2,1.35714285714286,1.38095238095238,1.42857142857143,-0.0476190476190476,32,10,22,44,24,93,8,-4.1
1963,"Norwich City",2,42,46,64,80,-16,1.0952380952381,1.52380952380952,1.9047619047619,-0.380952380952381,40,18,22,44,26,93,14,1.8
1963,"Nottingham Forest",1,42,57,64,68,-4,1.35714285714286,1.52380952380952,1.61904761904762,-0.0952380952380952,13,13,22,22,5,117,8,-1.6
1963,"Notts County",3,46,36,45,92,-47,0.782608695652174,0.978260869565217,2,-1.02173913043478,68,24,24,68,84,120,-16,3.7
1963,"Oldham Athletic",3,46,68,73,70,3,1.47826086956522,1.58695652173913,1.52173913043478,0.0652173913043478,52,8,24,68,64,102,-12,0.7
1963,"Oxford United",4,46,55,59,63,-4,1.19565217391304,1.28260869565217,1.3695652173913,-0.0869565217391304,86,18,24,92,73,54,13,4.5
1963,"Peterborough United",3,46,65,75,70,5,1.41304347826087,1.6304347826087,1.52173913043478,0.108695652173913,55,11,24,68,52,60,3,-1.4
1963,"Plymouth Argyle",2,42,40,45,67,-22,0.952380952380952,1.07142857142857,1.5952380952381,-0.523809523809524,43,21,22,44,34,93,9,-1.6
1963,"Port Vale",3,46,62,53,49,4,1.34782608695652,1.15217391304348,1.06521739130435,0.0869565217391304,58,14,24,68,66,107,-8,-0.6
1963,"Portsmouth",2,42,59,79,70,9,1.4047619047619,1.88095238095238,1.66666666666667,0.214285714285714,31,9,22,44,43,93,-12,-0.6
1963,"Preston North End",2,42,79,79,54,25,1.88095238095238,1.88095238095238,1.28571428571429,0.595238095238095,25,3,22,44,35,121,-10,-1.8
1963,"Queens Park Rangers",3,46,63,76,78,-2,1.3695652173913,1.65217391304348,1.69565217391304,-0.0434782608695652,57,13,24,68,57,93,0,4.8
1963,"Reading",3,46,73,79,62,17,1.58695652173913,1.71739130434783,1.34782608695652,0.369565217391304,50,6,24,68,59,93,-9,-2.4
1963,"Rochdale",4,46,51,56,59,-3,1.10869565217391,1.21739130434783,1.28260869565217,-0.0652173913043478,89,21,24,92,75,92,14,2.1
1963,"Rotherham United",2,42,64,90,78,12,1.52380952380952,2.14285714285714,1.85714285714286,0.285714285714286,30,8,22,44,36,88,-6,-5.3
1963,"Scunthorpe United",2,42,40,52,82,-30,0.952380952380952,1.23809523809524,1.95238095238095,-0.714285714285714,44,22,22,44,61,70,-17,-4.2
1963,"Sheffield United",1,42,59,61,64,-3,1.4047619047619,1.45238095238095,1.52380952380952,-0.0714285714285714,11,11,22,22,18,117,-7,-0.2
1963,"Sheffield Wednesday",1,42,68,84,67,17,1.61904761904762,2,1.5952380952381,0.404761904761905,6,6,22,22,9,117,-3,-3.3
1963,"Shrewsbury Town",3,46,65,73,80,-7,1.41304347826087,1.58695652173913,1.73913043478261,-0.152173913043478,56,12,24,68,60,69,-4,-1
1963,"Southampton",2,42,66,100,73,27,1.57142857142857,2.38095238095238,1.73809523809524,0.642857142857143,27,5,22,44,27,93,0,0.7
1963,"Southend United",3,46,60,77,78,-1,1.30434782608696,1.67391304347826,1.69565217391304,-0.0217391304347826,59,15,24,68,56,93,3,0.1
1963,"Southport",4,46,54,63,88,-25,1.17391304347826,1.3695652173913,1.91304347826087,-0.543478260869565,88,20,24,92,89,50,-1,2.1
1963,"Stockport County",4,46,57,50,68,-18,1.23913043478261,1.08695652173913,1.47826086956522,-0.391304347826087,85,17,24,92,92,99,-7,-0.7
1963,"Stoke City",1,42,52,77,78,-1,1.23809523809524,1.83333333333333,1.85714285714286,-0.0238095238095238,16,16,22,22,13,113,3,1
1963,"Sunderland",2,42,86,81,37,44,2.04761904761905,1.92857142857143,0.880952380952381,1.04761904761905,24,2,22,44,16,119,8,-0.2
1963,"Swansea City",2,42,45,63,74,-11,1.07142857142857,1.5,1.76190476190476,-0.261904761904762,41,19,22,44,44,93,-3,-4.1
1963,"Swindon Town",2,42,52,57,69,-12,1.23809523809524,1.35714285714286,1.64285714285714,-0.285714285714286,37,15,22,44,42,93,-5,-0.7
1963,"Torquay United",4,46,71,80,54,26,1.54347826086957,1.73913043478261,1.17391304347826,0.565217391304348,74,6,24,92,78,78,-4,-1.1
1963,"Tottenham Hotspur",1,42,73,97,81,16,1.73809523809524,2.30952380952381,1.92857142857143,0.380952380952381,4,4,22,22,6,101,-2,-0.6
1963,"Tranmere Rovers",4,46,71,85,73,12,1.54347826086957,1.84782608695652,1.58695652173913,0.260869565217391,75,7,24,92,71,89,4,1.4
1963,"Walsall",3,46,53,59,76,-17,1.15217391304348,1.28260869565217,1.65217391304348,-0.369565217391304,63,19,24,68,63,100,0,0.3
1963,"Watford",3,46,81,79,59,20,1.76086956521739,1.71739130434783,1.28260869565217,0.434782608695652,47,3,24,68,53,93,-6,-0.4
1963,"West Bromwich Albion",1,42,59,70,61,9,1.4047619047619,1.66666666666667,1.45238095238095,0.214285714285714,12,12,22,22,15,121,-3,-2
1963,"West Ham United",1,42,54,69,74,-5,1.28571428571429,1.64285714285714,1.76190476190476,-0.119047619047619,14,14,22,22,8,94,6,-0.5
1963,"Wolverhampton Wanderers",1,42,51,70,80,-10,1.21428571428571,1.66666666666667,1.9047619047619,-0.238095238095238,17,17,22,22,21,121,-4,0.3
1963,"Workington",4,46,83,76,52,24,1.80434782608696,1.65217391304348,1.1304347826087,0.521739130434783,71,3,24,92,58,26,13,-2
1963,"Wrexham",3,46,45,75,107,-32,0.978260869565217,1.6304347826087,2.32608695652174,-0.695652173913043,67,23,24,68,82,80,-15,1.9
1963,"York City",4,46,49,52,66,-14,1.06521739130435,1.1304347826087,1.43478260869565,-0.304347826086957,90,22,24,92,69,72,21,4.3
1964,"AFC Bournemouth",3,46,65,72,63,9,1.41304347826087,1.56521739130435,1.3695652173913,0.195652173913043,54,10,24,68,64,90,-10,-1.1
1964,"Aldershot",4,46,52,64,84,-20,1.1304347826087,1.39130434782609,1.82608695652174,-0.434782608695652,86,18,24,92,85,57,1,2.2
1964,"Arsenal",1,42,58,69,75,-6,1.38095238095238,1.64285714285714,1.78571428571429,-0.142857142857143,10,10,22,22,19,116,-9,-0.7
1964,"Aston Villa",1,42,53,57,82,-25,1.26190476190476,1.35714285714286,1.95238095238095,-0.595238095238095,14,14,22,22,13,121,1,-1
1964,"Barnsley",3,46,38,54,90,-36,0.826086956521739,1.17391304347826,1.95652173913043,-0.782608695652174,68,24,24,68,86,111,-18,-1.4
1964,"Barrow",4,46,42,59,105,-46,0.91304347826087,1.28260869565217,2.28260869565217,-1,88,20,24,92,80,44,8,NA
1964,"Birmingham City",1,42,35,64,96,-32,0.833333333333333,1.52380952380952,2.28571428571429,-0.761904761904762,22,22,22,22,31,117,-9,0.7
1964,"Blackburn Rovers",1,42,58,83,79,4,1.38095238095238,1.97619047619048,1.88095238095238,0.0952380952380952,11,11,22,22,22,121,-11,-3.5
1964,"Blackpool",1,42,47,67,78,-11,1.11904761904762,1.5952380952381,1.85714285714286,-0.261904761904762,17,17,22,22,14,112,3,-1.2
1964,"Bolton Wanderers",2,42,70,80,58,22,1.66666666666667,1.9047619047619,1.38095238095238,0.523809523809524,25,3,22,44,32,121,-7,-0.6
1964,"Bradford City",4,46,44,70,88,-18,0.956521739130435,1.52173913043478,1.91304347826087,-0.391304347826087,87,19,24,92,91,106,-4,0.8
1964,"Bradford Park Avenue",4,46,77,86,62,24,1.67391304347826,1.8695652173913,1.34782608695652,0.521739130434783,76,8,24,92,77,51,-1,NA
1964,"Brentford",3,46,81,83,55,28,1.76086956521739,1.80434782608696,1.19565217391304,0.608695652173913,48,4,24,68,67,93,-19,-2.9
1964,"Brighton & Hove Albion",4,46,89,102,57,45,1.93478260869565,2.21739130434783,1.23913043478261,0.978260869565217,70,2,24,92,59,93,11,1
1964,"Bristol City",3,46,83,92,55,37,1.80434782608696,2,1.19565217391304,0.804347826086957,46,2,24,68,28,108,18,2
1964,"Bristol Rovers",3,46,75,82,58,24,1.6304347826087,1.78260869565217,1.26086956521739,0.521739130434783,51,7,24,68,60,92,-9,1.1
1964,"Burnley",1,42,58,70,70,0,1.38095238095238,1.66666666666667,1.66666666666667,0,12,12,22,22,2,121,10,0.3
1964,"Bury",2,42,52,60,66,-6,1.23809523809524,1.42857142857143,1.57142857142857,-0.142857142857143,38,16,22,44,39,114,-1,-1.9
1964,"Cardiff City",2,42,53,64,57,7,1.26190476190476,1.52380952380952,1.35714285714286,0.166666666666667,37,15,22,44,42,93,-5,-0.6
1964,"Carlisle United",3,46,85,76,53,23,1.84782608695652,1.65217391304348,1.15217391304348,0.5,45,1,24,68,33,84,12,2.3
1964,"Charlton Athletic",2,42,48,64,75,-11,1.14285714285714,1.52380952380952,1.78571428571429,-0.261904761904762,39,17,22,44,38,92,1,-0.8
1964,"Chelsea",1,42,80,89,54,35,1.9047619047619,2.11904761904762,1.28571428571429,0.833333333333333,3,3,22,22,4,104,-1,-1.8
1964,"Chester",4,46,81,119,81,38,1.76086956521739,2.58695652173913,1.76086956521739,0.826086956521739,74,6,24,92,75,67,-1,0.2
1964,"Chesterfield",4,46,68,58,70,-12,1.47826086956522,1.26086956521739,1.52173913043478,-0.260869565217391,79,11,24,92,89,100,-10,2.1
1964,"Colchester United",3,46,40,50,89,-39,0.869565217391304,1.08695652173913,1.93478260869565,-0.847826086956522,67,23,24,68,74,68,-7,1.2
1964,"Coventry City",2,42,60,72,70,2,1.42857142857143,1.71428571428571,1.66666666666667,0.0476190476190476,31,9,22,44,25,94,6,1.5
1964,"Crewe Alexandra",4,46,67,90,81,9,1.45652173913043,1.95652173913043,1.76086956521739,0.195652173913043,80,12,24,92,82,96,-2,-0.7
1964,"Crystal Palace",2,42,61,55,51,4,1.45238095238095,1.30952380952381,1.21428571428571,0.0952380952380952,29,7,22,44,35,93,-6,-2
1964,"Darlington",4,46,60,84,87,-3,1.30434782608696,1.82608695652174,1.89130434782609,-0.0652173913043478,81,13,24,92,69,81,12,-0.9
1964,"Derby County",2,42,59,84,79,5,1.4047619047619,2,1.88095238095238,0.119047619047619,32,10,22,44,30,121,2,3.1
1964,"Doncaster Rovers",4,46,71,84,72,12,1.54347826086957,1.82608695652174,1.56521739130435,0.260869565217391,77,9,24,92,70,88,7,-0.8
1964,"Everton",1,42,66,69,60,9,1.57142857142857,1.64285714285714,1.42857142857143,0.214285714285714,4,4,22,22,11,121,-7,-0.1
1964,"Exeter City",3,46,53,51,52,-1,1.15217391304348,1.10869565217391,1.1304347826087,-0.0217391304347826,62,18,24,68,66,88,-4,-1.4
1964,"Fulham",1,42,45,60,78,-18,1.07142857142857,1.42857142857143,1.85714285714286,-0.428571428571429,20,20,22,22,20,102,0,-1.4
1964,"Gillingham",3,46,78,70,50,20,1.69565217391304,1.52173913043478,1.08695652173913,0.434782608695652,50,6,24,68,48,88,2,-0.4
1964,"Grimsby Town",3,46,65,68,67,1,1.41304347826087,1.47826086956522,1.45652173913043,0.0217391304347826,55,11,24,68,56,110,-1,-0.6
1964,"Halifax Town",4,46,39,54,103,-49,0.847826086956522,1.17391304347826,2.23913043478261,-1.06521739130435,90,22,24,92,83,69,7,2.8
1964,"Hartlepool United",4,46,58,61,85,-24,1.26086956521739,1.32608695652174,1.84782608695652,-0.521739130434783,85,17,24,92,84,89,1,0.4
1964,"Huddersfield Town",2,42,61,53,51,2,1.45238095238095,1.26190476190476,1.21428571428571,0.0476190476190476,30,8,22,44,26,99,4,-3.8
1964,"Hull City",3,46,81,91,57,34,1.76086956521739,1.97826086956522,1.23913043478261,0.739130434782609,49,5,24,68,45,104,4,1.9
1964,"Ipswich Town",2,42,62,74,67,7,1.47619047619048,1.76190476190476,1.5952380952381,0.166666666666667,28,6,22,44,36,75,-8,2.6
1964,"Leeds United",1,42,87,83,52,31,2.07142857142857,1.97619047619048,1.23809523809524,0.738095238095238,1,1,22,22,3,93,-2,-0.9
1964,"Leicester City",1,42,46,69,85,-16,1.0952380952381,1.64285714285714,2.02380952380952,-0.380952380952381,19,19,22,22,5,115,14,0.1
1964,"Leyton Orient",2,42,47,50,72,-22,1.11904761904762,1.19047619047619,1.71428571428571,-0.523809523809524,41,19,22,44,44,102,-3,0.6
1964,"Lincoln City",4,46,39,58,99,-41,0.847826086956522,1.26086956521739,2.15217391304348,-0.891304347826087,91,23,24,92,90,107,1,1.8
1964,"Liverpool",1,42,61,67,73,-6,1.45238095238095,1.5952380952381,1.73809523809524,-0.142857142857143,7,7,22,22,1,116,6,0.4
1964,"Luton Town",3,46,44,51,94,-43,0.956521739130435,1.10869565217391,2.04347826086957,-0.934782608695652,65,21,24,68,72,91,-7,4.5
1964,"Manchester City",2,42,57,63,62,1,1.35714285714286,1.5,1.47619047619048,0.0238095238095238,33,11,22,44,23,117,10,2.5
1964,"Manchester United",1,42,87,89,39,50,2.07142857142857,2.11904761904762,0.928571428571429,1.19047619047619,2,2,22,22,6,117,-4,-2.1
1964,"Mansfield Town",3,46,83,95,61,34,1.80434782608696,2.06521739130435,1.32608695652174,0.739130434782609,47,3,24,68,62,77,-15,-2.2
1964,"Middlesbrough",2,42,48,70,76,-6,1.14285714285714,1.66666666666667,1.80952380952381,-0.142857142857143,40,18,22,44,43,110,-3,3.4
1964,"Millwall",4,46,85,78,45,33,1.84782608695652,1.69565217391304,0.978260869565217,0.717391304347826,72,4,24,92,46,93,26,3
1964,"Newcastle United",2,42,81,81,45,36,1.92857142857143,1.92857142857143,1.07142857142857,0.857142857142857,23,1,22,44,15,116,8,1.1
1964,"Newport County",4,46,59,85,81,4,1.28260869565217,1.84782608695652,1.76086956521739,0.0869565217391304,83,15,24,92,78,67,5,0.5
1964,"Northampton Town",2,42,76,66,50,16,1.80952380952381,1.57142857142857,1.19047619047619,0.380952380952381,24,2,22,44,21,93,3,-5.9
1964,"Norwich City",2,42,67,61,57,4,1.5952380952381,1.45238095238095,1.35714285714286,0.0952380952380952,26,4,22,44,37,93,-11,0.1
1964,"Nottingham Forest",1,42,64,71,67,4,1.52380952380952,1.69047619047619,1.5952380952381,0.0952380952380952,5,5,22,22,16,117,-11,-3.3
1964,"Notts County",4,46,59,61,73,-12,1.28260869565217,1.32608695652174,1.58695652173913,-0.260869565217391,84,16,24,92,76,120,8,4.8
1964,"Oldham Athletic",3,46,49,61,83,-22,1.06521739130435,1.32608695652174,1.80434782608696,-0.478260869565217,64,20,24,68,65,102,-1,2.3
1964,"Oxford United",4,46,84,87,44,43,1.82608695652174,1.89130434782609,0.956521739130435,0.934782608695652,73,5,24,92,55,54,18,4.1
1964,"Peterborough United",3,46,73,85,74,11,1.58695652173913,1.84782608695652,1.60869565217391,0.239130434782609,52,8,24,68,58,60,-6,0.2
1964,"Plymouth Argyle",2,42,56,63,79,-16,1.33333333333333,1.5,1.88095238095238,-0.380952380952381,34,12,22,44,40,93,-6,-1.1
1964,"Port Vale",3,46,41,41,76,-35,0.891304347826087,0.891304347826087,1.65217391304348,-0.760869565217391,66,22,24,68,87,107,-21,1.5
1964,"Portsmouth",2,42,46,56,77,-21,1.0952380952381,1.33333333333333,1.83333333333333,-0.5,43,21,22,44,34,93,9,0.4
1964,"Preston North End",2,42,55,76,81,-5,1.30952380952381,1.80952380952381,1.92857142857143,-0.119047619047619,35,13,22,44,41,121,-6,-1.7
1964,"Queens Park Rangers",3,46,63,72,80,-8,1.3695652173913,1.56521739130435,1.73913043478261,-0.173913043478261,57,13,24,68,47,93,10,4.6
1964,"Reading",3,46,62,70,70,0,1.34782608695652,1.52173913043478,1.52173913043478,0,59,15,24,68,51,93,8,-1.6
1964,"Rochdale",4,46,80,74,53,21,1.73913043478261,1.60869565217391,1.15217391304348,0.456521739130435,75,7,24,92,88,92,-13,-1.1
1964,"Rotherham United",2,42,54,70,69,1,1.28571428571429,1.66666666666667,1.64285714285714,0.0238095238095238,36,14,22,44,29,88,7,-3.5
1964,"Scunthorpe United",3,46,54,65,72,-7,1.17391304347826,1.41304347826087,1.56521739130435,-0.152173913043478,61,17,24,68,49,70,12,-3.1
1964,"Sheffield United",1,42,47,50,64,-14,1.11904761904762,1.19047619047619,1.52380952380952,-0.333333333333333,18,18,22,22,9,117,9,1.4
1964,"Sheffield Wednesday",1,42,59,57,55,2,1.4047619047619,1.35714285714286,1.30952380952381,0.0476190476190476,9,9,22,22,17,117,-8,-3.5
1964,"Shrewsbury Town",3,46,57,76,84,-8,1.23913043478261,1.65217391304348,1.82608695652174,-0.173913043478261,60,16,24,68,54,69,6,-1
1964,"Southampton",2,42,65,83,63,20,1.54761904761905,1.97619047619048,1.5,0.476190476190476,27,5,22,44,24,93,3,-0.6
1964,"Southend United",3,46,65,78,71,7,1.41304347826087,1.69565217391304,1.54347826086957,0.152173913043478,56,12,24,68,63,93,-7,-0.7
1964,"Southport",4,46,40,58,89,-31,0.869565217391304,1.26086956521739,1.93478260869565,-0.673913043478261,89,21,24,92,79,50,10,0.9
1964,"Stockport County",4,46,37,44,87,-43,0.804347826086957,0.956521739130435,1.89130434782609,-0.934782608695652,92,24,24,92,81,99,11,0.3
1964,"Stoke City",1,42,58,67,66,1,1.38095238095238,1.5952380952381,1.57142857142857,0.0238095238095238,13,13,22,22,10,113,3,0.6
1964,"Sunderland",1,42,51,64,74,-10,1.21428571428571,1.52380952380952,1.76190476190476,-0.238095238095238,16,16,22,22,18,119,-2,-1.1
1964,"Swansea City",2,42,43,62,84,-22,1.02380952380952,1.47619047619048,2,-0.523809523809524,44,22,22,44,61,93,-17,-4.4
1964,"Swindon Town",2,42,47,63,81,-18,1.11904761904762,1.5,1.92857142857143,-0.428571428571429,42,20,22,44,52,93,-10,-0.6
1964,"Torquay United",4,46,70,70,70,0,1.52173913043478,1.52173913043478,1.52173913043478,0,78,10,24,92,71,78,7,-0.6
1964,"Tottenham Hotspur",1,42,64,87,71,16,1.52380952380952,2.07142857142857,1.69047619047619,0.380952380952381,6,6,22,22,8,101,-2,-1.3
1964,"Tranmere Rovers",4,46,87,99,56,43,1.89130434782609,2.15217391304348,1.21739130434783,0.934782608695652,71,3,24,92,73,89,-2,0.5
1964,"Walsall",3,46,52,55,80,-25,1.1304347826087,1.19565217391304,1.73913043478261,-0.543478260869565,63,19,24,68,53,100,10,1
1964,"Watford",3,46,67,71,64,7,1.45652173913043,1.54347826086957,1.39130434782609,0.152173913043478,53,9,24,68,57,93,-4,-1.4
1964,"West Bromwich Albion",1,42,52,70,65,5,1.23809523809524,1.66666666666667,1.54761904761905,0.119047619047619,15,15,22,22,7,121,8,-1.3
1964,"West Ham United",1,42,61,82,71,11,1.45238095238095,1.95238095238095,1.69047619047619,0.261904761904762,8,8,22,22,12,94,-4,-0.6
1964,"Wolverhampton Wanderers",1,42,43,59,89,-30,1.02380952380952,1.4047619047619,2.11904761904762,-0.714285714285714,21,21,22,22,27,121,-6,0.8
1964,"Workington",3,46,63,58,69,-11,1.3695652173913,1.26086956521739,1.5,-0.239130434782609,58,14,24,68,50,26,8,-3.3
1964,"Wrexham",4,46,60,84,92,-8,1.30434782608696,1.82608695652174,2,-0.173913043478261,82,14,24,92,92,80,-10,2.3
1964,"York City",4,46,90,91,56,35,1.95652173913043,1.97826086956522,1.21739130434783,0.760869565217391,69,1,24,92,68,72,1,3.2
1965,"AFC Bournemouth",3,46,51,38,56,-18,1.10869565217391,0.826086956521739,1.21739130434783,-0.391304347826087,64,20,24,68,64,90,0,-1
1965,"Aldershot",4,46,55,75,84,-9,1.19565217391304,1.6304347826087,1.82608695652174,-0.195652173913043,85,17,24,92,79,57,6,2.1
1965,"Arsenal",1,42,49,62,75,-13,1.16666666666667,1.47619047619048,1.78571428571429,-0.30952380952381,19,19,22,22,7,116,12,0.2
1965,"Aston Villa",1,42,51,69,80,-11,1.21428571428571,1.64285714285714,1.9047619047619,-0.261904761904762,13,13,22,22,21,121,-8,-0.3
1965,"Barnsley",4,46,55,74,78,-4,1.19565217391304,1.60869565217391,1.69565217391304,-0.0869565217391304,86,18,24,92,86,111,0,0.6
1965,"Barrow",4,46,63,72,76,-4,1.3695652173913,1.56521739130435,1.65217391304348,-0.0869565217391304,80,12,24,92,70,44,10,NA
1965,"Birmingham City",2,42,57,70,75,-5,1.35714285714286,1.66666666666667,1.78571428571429,-0.119047619047619,31,9,22,44,31,117,0,1.2
1965,"Blackburn Rovers",1,42,28,57,88,-31,0.666666666666667,1.35714285714286,2.0952380952381,-0.738095238095238,22,22,22,22,26,121,-4,-1.7
1965,"Blackpool",1,42,51,55,65,-10,1.21428571428571,1.30952380952381,1.54761904761905,-0.238095238095238,14,14,22,22,22,112,-8,-1.8
1965,"Bolton Wanderers",2,42,57,62,59,3,1.35714285714286,1.47619047619048,1.4047619047619,0.0714285714285714,32,10,22,44,32,121,0,0.7
1965,"Bradford City",4,46,49,63,94,-31,1.06521739130435,1.3695652173913,2.04347826086957,-0.673913043478261,91,23,24,92,77,106,14,0.5
1965,"Bradford Park Avenue",4,46,68,102,92,10,1.47826086956522,2.21739130434783,2,0.217391304347826,77,9,24,92,91,51,-14,NA
1965,"Brentford",3,46,42,48,69,-21,0.91304347826087,1.04347826086957,1.5,-0.456521739130435,67,23,24,68,78,93,-11,-1.6
1965,"Brighton & Hove Albion",3,46,59,67,65,2,1.28260869565217,1.45652173913043,1.41304347826087,0.0434782608695652,59,15,24,68,63,93,-4,1.1
1965,"Bristol City",2,42,68,63,48,15,1.61904761904762,1.5,1.14285714285714,0.357142857142857,28,6,22,44,38,108,-10,0.2
1965,"Bristol Rovers",3,46,56,64,64,0,1.21739130434783,1.39130434782609,1.39130434782609,0,60,16,24,68,49,92,11,2
1965,"Burnley",1,42,79,79,47,32,1.88095238095238,1.88095238095238,1.11904761904762,0.761904761904762,2,2,22,22,14,121,-12,-1.9
1965,"Bury",2,42,49,62,76,-14,1.16666666666667,1.47619047619048,1.80952380952381,-0.333333333333333,39,17,22,44,44,114,-5,-1.9
1965,"Cardiff City",2,42,46,71,91,-20,1.0952380952381,1.69047619047619,2.16666666666667,-0.476190476190476,42,20,22,44,42,93,0,-0.4
1965,"Carlisle United",2,42,56,60,63,-3,1.33333333333333,1.42857142857143,1.5,-0.0714285714285714,33,11,22,44,25,84,8,-0.8
1965,"Charlton Athletic",2,42,50,61,70,-9,1.19047619047619,1.45238095238095,1.66666666666667,-0.214285714285714,38,16,22,44,40,92,-2,0.7
1965,"Chelsea",1,42,73,65,53,12,1.73809523809524,1.54761904761905,1.26190476190476,0.285714285714286,4,4,22,22,9,104,-5,-3.2
1965,"Chester",4,46,72,79,70,9,1.56521739130435,1.71739130434783,1.52173913043478,0.195652173913043,75,7,24,92,85,67,-10,1.6
1965,"Chesterfield",4,46,52,62,78,-16,1.1304347826087,1.34782608695652,1.69565217391304,-0.347826086956522,89,21,24,92,80,100,9,3.2
1965,"Colchester United",4,46,79,70,47,23,1.71739130434783,1.52173913043478,1.02173913043478,0.5,74,6,24,92,56,68,18,0.8
1965,"Coventry City",2,42,73,73,53,20,1.73809523809524,1.73809523809524,1.26190476190476,0.476190476190476,25,3,22,44,24,94,1,1
1965,"Crewe Alexandra",4,46,57,61,63,-2,1.23913043478261,1.32608695652174,1.3695652173913,-0.0434782608695652,82,14,24,92,73,96,9,-0.2
1965,"Crystal Palace",2,42,55,47,52,-5,1.30952380952381,1.11904761904762,1.23809523809524,-0.119047619047619,35,13,22,44,28,93,7,-1.5
1965,"Darlington",4,46,84,72,53,19,1.82608695652174,1.56521739130435,1.15217391304348,0.41304347826087,69,1,24,92,66,81,3,-1.8
1965,"Derby County",2,42,59,71,68,3,1.4047619047619,1.69047619047619,1.61904761904762,0.0714285714285714,30,8,22,44,41,121,-11,2.6
1965,"Doncaster Rovers",4,46,83,85,54,31,1.80434782608696,1.84782608695652,1.17391304347826,0.673913043478261,70,2,24,92,67,88,3,-0.6
1965,"Everton",1,42,56,56,62,-6,1.33333333333333,1.33333333333333,1.47619047619048,-0.142857142857143,11,11,22,22,6,121,5,0.1
1965,"Exeter City",3,46,47,53,79,-26,1.02173913043478,1.15217391304348,1.71739130434783,-0.565217391304348,66,22,24,68,82,88,-16,-1.1
1965,"Fulham",1,42,49,67,85,-18,1.16666666666667,1.5952380952381,2.02380952380952,-0.428571428571429,20,20,22,22,19,102,1,-1.3
1965,"Gillingham",3,46,74,62,54,8,1.60869565217391,1.34782608695652,1.17391304347826,0.173913043478261,48,4,24,68,57,88,-9,-1.4
1965,"Grimsby Town",3,46,64,68,62,6,1.39130434782609,1.47826086956522,1.34782608695652,0.130434782608696,56,12,24,68,58,110,-2,-0.7
1965,"Halifax Town",4,46,56,67,75,-8,1.21739130434783,1.45652173913043,1.6304347826087,-0.173913043478261,83,15,24,92,81,69,2,1.5
1965,"Hartlepool United",4,46,56,63,75,-12,1.21739130434783,1.3695652173913,1.6304347826087,-0.260869565217391,84,16,24,92,75,89,9,0.3
1965,"Huddersfield Town",2,42,70,62,36,26,1.66666666666667,1.47619047619048,0.857142857142857,0.619047619047619,26,4,22,44,27,99,-1,-4.7
1965,"Hull City",3,46,100,109,62,47,2.17391304347826,2.3695652173913,1.34782608695652,1.02173913043478,45,1,24,68,33,104,12,1.1
1965,"Ipswich Town",2,42,54,58,66,-8,1.28571428571429,1.38095238095238,1.57142857142857,-0.19047619047619,36,14,22,44,29,75,7,3
1965,"Leeds United",1,42,78,79,38,41,1.85714285714286,1.88095238095238,0.904761904761905,0.976190476190476,3,3,22,22,4,93,-1,-0.2
1965,"Leicester City",1,42,70,80,65,15,1.66666666666667,1.9047619047619,1.54761904761905,0.357142857142857,5,5,22,22,8,115,-3,-0.3
1965,"Leyton Orient",2,42,28,38,80,-42,0.666666666666667,0.904761904761905,1.9047619047619,-1,44,22,22,44,61,102,-17,0.9
1965,"Lincoln City",4,46,50,57,82,-25,1.08695652173913,1.23913043478261,1.78260869565217,-0.543478260869565,90,22,24,92,92,107,-2,2.1
1965,"Liverpool",1,42,87,79,34,45,2.07142857142857,1.88095238095238,0.80952380952381,1.07142857142857,1,1,22,22,5,116,-4,0
1965,"Luton Town",4,46,80,90,70,20,1.73913043478261,1.95652173913043,1.52173913043478,0.434782608695652,72,4,24,92,83,91,-11,4.3
1965,"Manchester City",2,42,81,76,44,32,1.92857142857143,1.80952380952381,1.04761904761905,0.761904761904762,23,1,22,44,15,117,8,1.6
1965,"Manchester United",1,42,69,84,59,25,1.64285714285714,2,1.4047619047619,0.595238095238095,6,6,22,22,1,117,5,0.3
1965,"Mansfield Town",3,46,53,59,89,-30,1.15217391304348,1.28260869565217,1.93478260869565,-0.652173913043478,62,18,24,68,53,77,9,0.8
1965,"Middlesbrough",2,42,43,58,86,-28,1.02380952380952,1.38095238095238,2.04761904761905,-0.666666666666667,43,21,22,44,46,110,-3,3
1965,"Millwall",3,46,92,76,43,33,2,1.65217391304348,0.934782608695652,0.717391304347826,46,2,24,68,30,93,16,-0.1
1965,"Newcastle United",1,42,51,50,63,-13,1.21428571428571,1.19047619047619,1.5,-0.30952380952381,15,15,22,22,20,116,-5,0.1
1965,"Newport County",4,46,66,75,75,0,1.43478260869565,1.6304347826087,1.6304347826087,0,78,10,24,92,87,67,-9,-1.2
1965,"Northampton Town",1,42,43,55,92,-37,1.02380952380952,1.30952380952381,2.19047619047619,-0.880952380952381,21,21,22,22,43,93,-22,-4.9
1965,"Norwich City",2,42,51,52,52,0,1.21428571428571,1.23809523809524,1.23809523809524,0,37,15,22,44,35,93,2,2.8
1965,"Nottingham Forest",1,42,50,56,72,-16,1.19047619047619,1.33333333333333,1.71428571428571,-0.380952380952381,16,16,22,22,3,117,13,-1.4
1965,"Notts County",4,46,69,61,53,8,1.5,1.32608695652174,1.15217391304348,0.173913043478261,76,8,24,92,88,120,-12,4.8
1965,"Oldham Athletic",3,46,49,55,81,-26,1.06521739130435,1.19565217391304,1.76086956521739,-0.565217391304348,65,21,24,68,54,102,11,2.8
1965,"Oxford United",3,46,65,70,74,-4,1.41304347826087,1.52173913043478,1.60869565217391,-0.0869565217391304,55,11,24,68,60,54,-5,1.3
1965,"Peterborough United",3,46,63,80,66,14,1.3695652173913,1.73913043478261,1.43478260869565,0.304347826086957,58,14,24,68,62,60,-4,0.3
1965,"Plymouth Argyle",2,42,49,54,63,-9,1.16666666666667,1.28571428571429,1.5,-0.214285714285714,40,18,22,44,37,93,3,0.2
1965,"Port Vale",4,46,54,48,59,-11,1.17391304347826,1.04347826086957,1.28260869565217,-0.239130434782609,87,19,24,92,84,107,3,3.1
1965,"Portsmouth",2,42,56,74,78,-4,1.33333333333333,1.76190476190476,1.85714285714286,-0.0952380952380952,34,12,22,44,36,93,-2,-1
1965,"Preston North End",2,42,48,62,70,-8,1.14285714285714,1.47619047619048,1.66666666666667,-0.19047619047619,41,19,22,44,34,121,7,-1.1
1965,"Queens Park Rangers",3,46,81,95,65,30,1.76086956521739,2.06521739130435,1.41304347826087,0.652173913043478,47,3,24,68,45,93,2,4.5
1965,"Reading",3,46,70,70,63,7,1.52173913043478,1.52173913043478,1.3695652173913,0.152173913043478,51,7,24,68,47,93,4,-2
1965,"Rochdale",4,46,53,71,87,-16,1.15217391304348,1.54347826086957,1.89130434782609,-0.347826086956522,88,20,24,92,89,92,-1,0.3
1965,"Rotherham United",2,42,62,75,74,1,1.47619047619048,1.78571428571429,1.76190476190476,0.0238095238095238,29,7,22,44,39,88,-10,-3.1
1965,"Scunthorpe United",3,46,74,80,67,13,1.60869565217391,1.73913043478261,1.45652173913043,0.282608695652174,49,5,24,68,59,70,-10,-3.9
1965,"Sheffield United",1,42,59,56,59,-3,1.4047619047619,1.33333333333333,1.4047619047619,-0.0714285714285714,9,9,22,22,10,117,-1,-1.3
1965,"Sheffield Wednesday",1,42,50,56,66,-10,1.19047619047619,1.33333333333333,1.57142857142857,-0.238095238095238,17,17,22,22,12,117,5,-4.8
1965,"Shrewsbury Town",3,46,68,73,64,9,1.47826086956522,1.58695652173913,1.39130434782609,0.195652173913043,54,10,24,68,50,69,4,0.1
1965,"Southampton",2,42,76,85,56,29,1.80952380952381,2.02380952380952,1.33333333333333,0.69047619047619,24,2,22,44,18,93,6,-0.3
1965,"Southend United",3,46,52,54,83,-29,1.1304347826087,1.17391304347826,1.80434782608696,-0.630434782608696,63,19,24,68,74,93,-11,-0.4
1965,"Southport",4,46,66,68,69,-1,1.43478260869565,1.47826086956522,1.5,-0.0217391304347826,79,11,24,92,71,50,8,-1.2
1965,"Stockport County",4,46,60,71,70,1,1.30434782608696,1.54347826086957,1.52173913043478,0.0217391304347826,81,13,24,92,69,99,12,-0.8
1965,"Stoke City",1,42,57,65,64,1,1.35714285714286,1.54761904761905,1.52380952380952,0.0238095238095238,10,10,22,22,11,113,-1,-0.2
1965,"Sunderland",1,42,50,51,72,-21,1.19047619047619,1.21428571428571,1.71428571428571,-0.5,18,18,22,22,16,119,2,-0.5
1965,"Swansea City",3,46,56,81,96,-15,1.21739130434783,1.76086956521739,2.08695652173913,-0.326086956521739,61,17,24,68,65,93,-4,-1.8
1965,"Swindon Town",3,46,70,74,48,26,1.52173913043478,1.60869565217391,1.04347826086957,0.565217391304348,52,8,24,68,52,93,0,-0.9
1965,"Torquay United",4,46,82,72,49,23,1.78260869565217,1.56521739130435,1.06521739130435,0.5,71,3,24,92,51,78,20,-0.7
1965,"Tottenham Hotspur",1,42,60,75,66,9,1.42857142857143,1.78571428571429,1.57142857142857,0.214285714285714,8,8,22,22,2,101,6,-0.3
1965,"Tranmere Rovers",4,46,80,93,66,27,1.73913043478261,2.02173913043478,1.43478260869565,0.58695652173913,73,5,24,92,72,89,1,0.1
1965,"Walsall",3,46,70,77,64,13,1.52173913043478,1.67391304347826,1.39130434782609,0.282608695652174,53,9,24,68,55,100,-2,0.2
1965,"Watford",3,46,64,55,51,4,1.39130434782609,1.19565217391304,1.10869565217391,0.0869565217391304,57,13,24,68,48,93,9,-1.8
1965,"West Bromwich Albion",1,42,69,91,69,22,1.64285714285714,2.16666666666667,1.64285714285714,0.523809523809524,7,7,22,22,13,121,-6,-1.7
1965,"West Ham United",1,42,54,70,83,-13,1.28571428571429,1.66666666666667,1.97619047619048,-0.30952380952381,12,12,22,22,17,94,-5,-0.6
1965,"Wolverhampton Wanderers",2,42,70,87,61,26,1.66666666666667,2.07142857142857,1.45238095238095,0.619047619047619,27,5,22,44,23,121,4,0.7
1965,"Workington",3,46,71,67,57,10,1.54347826086957,1.45652173913043,1.23913043478261,0.217391304347826,50,6,24,68,68,26,-18,-4.2
1965,"Wrexham",4,46,48,72,104,-32,1.04347826086957,1.56521739130435,2.26086956521739,-0.695652173913043,92,24,24,92,76,80,16,4.3
1965,"York City",3,46,36,53,106,-53,0.782608695652174,1.15217391304348,2.30434782608696,-1.15217391304348,68,24,24,68,90,72,-22,2.5
1966,"AFC Bournemouth",3,46,53,39,57,-18,1.15217391304348,0.847826086956522,1.23913043478261,-0.391304347826087,64,20,24,68,58,90,6,-1.7
1966,"Aldershot",4,46,66,72,57,15,1.43478260869565,1.56521739130435,1.23913043478261,0.326086956521739,79,11,24,92,77,57,2,-0.5
1966,"Arsenal",1,42,62,58,47,11,1.47619047619048,1.38095238095238,1.11904761904762,0.261904761904762,7,7,22,22,9,116,-2,-0.1
1966,"Aston Villa",1,42,40,54,85,-31,0.952380952380952,1.28571428571429,2.02380952380952,-0.738095238095238,21,21,22,22,34,121,-13,1.7
1966,"Barnsley",4,46,54,60,64,-4,1.17391304347826,1.30434782608696,1.39130434782609,-0.0869565217391304,86,18,24,92,70,111,16,1.2
1966,"Barrow",4,46,83,76,54,22,1.80434782608696,1.65217391304348,1.17391304347826,0.478260869565217,70,2,24,92,50,44,20,NA
1966,"Birmingham City",2,42,56,70,66,4,1.33333333333333,1.66666666666667,1.57142857142857,0.0952380952380952,31,9,22,44,26,117,5,1.8
1966,"Blackburn Rovers",2,42,70,56,46,10,1.66666666666667,1.33333333333333,1.0952380952381,0.238095238095238,26,4,22,44,29,121,-3,-0.7
1966,"Blackpool",1,42,27,41,76,-35,0.642857142857143,0.976190476190476,1.80952380952381,-0.833333333333333,22,22,22,22,24,112,-2,-0.6
1966,"Bolton Wanderers",2,42,56,64,58,6,1.33333333333333,1.52380952380952,1.38095238095238,0.142857142857143,32,10,22,44,35,121,-3,0.6
1966,"Bradford City",4,46,67,74,62,12,1.45652173913043,1.60869565217391,1.34782608695652,0.260869565217391,77,9,24,92,72,106,5,0.4
1966,"Bradford Park Avenue",4,46,46,52,79,-27,1,1.1304347826087,1.71739130434783,-0.58695652173913,91,23,24,92,92,51,-1,NA
1966,"Brentford",4,46,67,58,56,2,1.45652173913043,1.26086956521739,1.21739130434783,0.0434782608695652,78,10,24,92,79,93,-1,-0.4
1966,"Brighton & Hove Albion",3,46,54,61,71,-10,1.17391304347826,1.32608695652174,1.54347826086957,-0.217391304347826,63,19,24,68,57,93,6,1.7
1966,"Bristol City",2,42,50,56,62,-6,1.19047619047619,1.33333333333333,1.47619047619048,-0.142857142857143,38,16,22,44,38,108,0,2.1
1966,"Bristol Rovers",3,46,73,76,67,9,1.58695652173913,1.65217391304348,1.45652173913043,0.195652173913043,49,5,24,68,61,92,-12,1.3
1966,"Burnley",1,42,54,66,76,-10,1.28571428571429,1.57142857142857,1.80952380952381,-0.238095238095238,14,14,22,22,12,121,2,-2.3
1966,"Bury",2,42,39,49,83,-34,0.928571428571429,1.16666666666667,1.97619047619048,-0.80952380952381,44,22,22,44,45,114,-1,-0.6
1966,"Cardiff City",2,42,45,61,87,-26,1.07142857142857,1.45238095238095,2.07142857142857,-0.619047619047619,42,20,22,44,36,93,6,0.3
1966,"Carlisle United",2,42,75,71,54,17,1.78571428571429,1.69047619047619,1.28571428571429,0.404761904761905,25,3,22,44,32,84,-7,-1.6
1966,"Charlton Athletic",2,42,48,49,53,-4,1.14285714285714,1.16666666666667,1.26190476190476,-0.0952380952380952,40,18,22,44,39,92,1,1
1966,"Chelsea",1,42,59,67,62,5,1.4047619047619,1.5952380952381,1.47619047619048,0.119047619047619,9,9,22,22,6,104,3,-1.5
1966,"Chester",4,46,55,54,78,-24,1.19565217391304,1.17391304347826,1.69565217391304,-0.521739130434783,85,17,24,92,90,67,-5,3
1966,"Chesterfield",4,46,59,60,63,-3,1.28260869565217,1.30434782608696,1.3695652173913,-0.0652173913043478,80,12,24,92,74,100,6,1.9
1966,"Colchester United",3,46,61,76,73,3,1.32608695652174,1.65217391304348,1.58695652173913,0.0652173913043478,56,12,24,68,67,68,-11,-1.5
1966,"Coventry City",2,42,82,74,43,31,1.95238095238095,1.76190476190476,1.02380952380952,0.738095238095238,24,2,22,44,21,94,3,0.5
1966,"Crewe Alexandra",4,46,75,70,55,15,1.6304347826087,1.52173913043478,1.19565217391304,0.326086956521739,73,5,24,92,73,96,0,-0.5
1966,"Crystal Palace",2,42,67,61,55,6,1.5952380952381,1.45238095238095,1.30952380952381,0.142857142857143,28,6,22,44,33,93,-5,-1.9
1966,"Darlington",3,46,50,47,81,-34,1.08695652173913,1.02173913043478,1.76086956521739,-0.739130434782609,66,22,24,68,85,81,-19,-1.3
1966,"Derby County",2,42,48,68,72,-4,1.14285714285714,1.61904761904762,1.71428571428571,-0.0952380952380952,41,19,22,44,40,121,1,2.3
1966,"Doncaster Rovers",3,46,44,58,117,-59,0.956521739130435,1.26086956521739,2.54347826086957,-1.28260869565217,67,23,24,68,78,88,-11,-0.8
1966,"Everton",1,42,67,65,46,19,1.5952380952381,1.54761904761905,1.0952380952381,0.452380952380952,6,6,22,22,4,121,2,-0.4
1966,"Exeter City",4,46,57,50,60,-10,1.23913043478261,1.08695652173913,1.30434782608696,-0.217391304347826,82,14,24,92,88,88,-6,1.2
1966,"Fulham",1,42,45,71,83,-12,1.07142857142857,1.69047619047619,1.97619047619048,-0.285714285714286,19,19,22,22,22,102,-3,-2.1
1966,"Gillingham",3,46,61,58,62,-4,1.32608695652174,1.26086956521739,1.34782608695652,-0.0869565217391304,57,13,24,68,54,88,3,0.1
1966,"Grimsby Town",3,46,60,61,68,-7,1.30434782608696,1.32608695652174,1.47826086956522,-0.152173913043478,58,14,24,68,65,110,-7,-0.9
1966,"Halifax Town",4,46,59,59,68,-9,1.28260869565217,1.28260869565217,1.47826086956522,-0.195652173913043,81,13,24,92,80,69,1,-0.8
1966,"Hartlepool United",4,46,73,66,64,2,1.58695652173913,1.43478260869565,1.39130434782609,0.0434782608695652,75,7,24,92,71,89,4,-1.5
1966,"Huddersfield Town",2,42,69,58,46,12,1.64285714285714,1.38095238095238,1.0952380952381,0.285714285714286,27,5,22,44,37,99,-10,-4.9
1966,"Hull City",2,42,55,77,72,5,1.30952380952381,1.83333333333333,1.71428571428571,0.119047619047619,33,11,22,44,41,104,-8,-0.5
1966,"Ipswich Town",2,42,67,70,54,16,1.5952380952381,1.66666666666667,1.28571428571429,0.380952380952381,29,7,22,44,25,75,4,2.6
1966,"Leeds United",1,42,77,62,42,20,1.83333333333333,1.47619047619048,1,0.476190476190476,4,4,22,22,5,93,-1,-0.5
1966,"Leicester City",1,42,62,78,71,7,1.47619047619048,1.85714285714286,1.69047619047619,0.166666666666667,8,8,22,22,14,115,-6,-0.4
1966,"Leyton Orient",3,46,57,58,68,-10,1.23913043478261,1.26086956521739,1.47826086956522,-0.217391304347826,61,17,24,68,64,102,-3,1.9
1966,"Lincoln City",4,46,40,58,82,-24,0.869565217391304,1.26086956521739,1.78260869565217,-0.521739130434783,92,24,24,92,82,107,10,3.9
1966,"Liverpool",1,42,70,64,47,17,1.66666666666667,1.52380952380952,1.11904761904762,0.404761904761905,5,5,22,22,3,116,2,0.4
1966,"Luton Town",4,46,57,59,73,-14,1.23913043478261,1.28260869565217,1.58695652173913,-0.304347826086957,83,15,24,92,69,91,14,5.6
1966,"Manchester City",1,42,51,43,52,-9,1.21428571428571,1.02380952380952,1.23809523809524,-0.214285714285714,15,15,22,22,1,117,14,1.3
1966,"Manchester United",1,42,84,84,45,39,2,2,1.07142857142857,0.928571428571429,1,1,22,22,2,117,-1,-0.5
1966,"Mansfield Town",3,46,69,84,79,5,1.5,1.82608695652174,1.71739130434783,0.108695652173913,53,9,24,68,66,77,-13,0.8
1966,"Middlesbrough",3,46,78,87,64,23,1.69565217391304,1.89130434782609,1.39130434782609,0.5,46,2,24,68,28,110,18,3.5
1966,"Millwall",2,42,63,49,58,-9,1.5,1.16666666666667,1.38095238095238,-0.214285714285714,30,8,22,44,30,93,0,-0.2
1966,"Newcastle United",1,42,45,39,81,-42,1.07142857142857,0.928571428571429,1.92857142857143,-1,20,20,22,22,10,116,10,1.5
1966,"Newport County",4,46,52,56,63,-7,1.1304347826087,1.21739130434783,1.3695652173913,-0.152173913043478,87,19,24,92,81,67,6,0.1
1966,"Northampton Town",2,42,42,47,84,-37,1,1.11904761904762,2,-0.880952380952381,43,21,22,44,62,93,-19,-2.2
1966,"Norwich City",2,42,53,49,55,-6,1.26190476190476,1.16666666666667,1.30952380952381,-0.142857142857143,35,13,22,44,31,93,4,2.1
1966,"Nottingham Forest",1,42,79,64,41,23,1.88095238095238,1.52380952380952,0.976190476190476,0.547619047619048,3,3,22,22,11,117,-8,-2.2
1966,"Notts County",4,46,50,53,72,-19,1.08695652173913,1.15217391304348,1.56521739130435,-0.41304347826087,88,20,24,92,84,120,4,5.9
1966,"Oldham Athletic",3,46,67,80,63,17,1.45652173913043,1.73913043478261,1.3695652173913,0.369565217391304,54,10,24,68,60,102,-6,1.9
1966,"Oxford United",3,46,58,61,66,-5,1.26086956521739,1.32608695652174,1.43478260869565,-0.108695652173913,60,16,24,68,46,54,14,-0.2
1966,"Peterborough United",3,46,57,66,71,-5,1.23913043478261,1.43478260869565,1.54347826086957,-0.108695652173913,62,18,24,68,52,60,10,0.3
1966,"Plymouth Argyle",2,42,51,59,58,1,1.21428571428571,1.4047619047619,1.38095238095238,0.0238095238095238,37,15,22,44,44,93,-7,-0.6
1966,"Port Vale",4,46,57,55,58,-3,1.23913043478261,1.19565217391304,1.26086956521739,-0.0652173913043478,84,16,24,92,86,107,-2,2.1
1966,"Portsmouth",2,42,52,59,70,-11,1.23809523809524,1.4047619047619,1.66666666666667,-0.261904761904762,36,14,22,44,27,93,9,-3
1966,"Preston North End",2,42,55,65,67,-2,1.30952380952381,1.54761904761905,1.5952380952381,-0.0476190476190476,34,12,22,44,42,121,-8,-1.7
1966,"Queens Park Rangers",3,46,93,103,38,65,2.02173913043478,2.23913043478261,0.826086956521739,1.41304347826087,45,1,24,68,23,93,22,3
1966,"Reading",3,46,75,76,57,19,1.6304347826087,1.65217391304348,1.23913043478261,0.41304347826087,47,3,24,68,49,93,-2,-1.7
1966,"Rochdale",4,46,50,53,75,-22,1.08695652173913,1.15217391304348,1.6304347826087,-0.478260869565217,89,21,24,92,87,92,2,0.2
1966,"Rotherham United",2,42,49,61,70,-9,1.16666666666667,1.45238095238095,1.66666666666667,-0.214285714285714,39,17,22,44,43,88,-4,-1
1966,"Scunthorpe United",3,46,59,58,73,-15,1.28260869565217,1.26086956521739,1.58695652173913,-0.326086956521739,59,15,24,68,68,70,-9,-2.9
1966,"Sheffield United",1,42,58,52,59,-7,1.38095238095238,1.23809523809524,1.4047619047619,-0.166666666666667,10,10,22,22,20,117,-10,-2.4
1966,"Sheffield Wednesday",1,42,55,56,47,9,1.30952380952381,1.33333333333333,1.11904761904762,0.214285714285714,12,12,22,22,19,117,-7,-4
1966,"Shrewsbury Town",3,46,72,77,62,15,1.56521739130435,1.67391304347826,1.34782608695652,0.326086956521739,50,6,24,68,47,69,3,-0.4
1966,"Southampton",1,42,48,74,92,-18,1.14285714285714,1.76190476190476,2.19047619047619,-0.428571428571429,18,18,22,22,15,93,3,-1.3
1966,"Southend United",4,46,75,70,49,21,1.6304347826087,1.52173913043478,1.06521739130435,0.456521739130435,74,6,24,92,75,93,-1,-0.6
1966,"Southport",4,46,82,69,42,27,1.78260869565217,1.5,0.91304347826087,0.58695652173913,71,3,24,92,59,50,12,-2
1966,"Stockport County",4,46,90,69,42,27,1.95652173913043,1.5,0.91304347826087,0.58695652173913,69,1,24,92,55,99,14,-1.6
1966,"Stoke City",1,42,58,63,58,5,1.38095238095238,1.5,1.38095238095238,0.119047619047619,11,11,22,22,18,113,-7,-1.1
1966,"Sunderland",1,42,50,58,72,-14,1.19047619047619,1.38095238095238,1.71428571428571,-0.333333333333333,16,16,22,22,16,119,0,-0.4
1966,"Swansea City",3,46,51,85,89,-4,1.10869565217391,1.84782608695652,1.93478260869565,-0.0869565217391304,65,21,24,68,83,93,-18,-0.7
1966,"Swindon Town",3,46,70,81,59,22,1.52173913043478,1.76086956521739,1.28260869565217,0.478260869565217,52,8,24,68,56,93,-4,-0.5
1966,"Torquay United",3,46,72,73,54,19,1.56521739130435,1.58695652173913,1.17391304347826,0.41304347826087,51,7,24,68,48,78,3,-3.2
1966,"Tottenham Hotspur",1,42,80,71,48,23,1.9047619047619,1.69047619047619,1.14285714285714,0.547619047619048,2,2,22,22,7,101,-5,-1.9
1966,"Tranmere Rovers",4,46,80,66,43,23,1.73913043478261,1.43478260869565,0.934782608695652,0.5,72,4,24,92,63,89,9,1.4
1966,"Walsall",3,46,64,65,72,-7,1.39130434782609,1.41304347826087,1.56521739130435,-0.152173913043478,55,11,24,68,53,100,2,-0.5
1966,"Watford",3,46,74,61,46,15,1.60869565217391,1.32608695652174,1,0.326086956521739,48,4,24,68,51,93,-3,-2.9
1966,"West Bromwich Albion",1,42,55,77,73,4,1.30952380952381,1.83333333333333,1.73809523809524,0.0952380952380952,13,13,22,22,8,121,5,0.6
1966,"West Ham United",1,42,50,80,84,-4,1.19047619047619,1.9047619047619,2,-0.0952380952380952,17,17,22,22,13,94,4,0.1
1966,"Wolverhampton Wanderers",2,42,83,88,48,40,1.97619047619048,2.0952380952381,1.14285714285714,0.952380952380952,23,1,22,44,17,121,6,0
1966,"Workington",3,46,43,55,89,-34,0.934782608695652,1.19565217391304,1.93478260869565,-0.739130434782609,68,24,24,68,91,26,-23,-2.4
1966,"Wrexham",4,46,68,76,62,14,1.47826086956522,1.65217391304348,1.34782608695652,0.304347826086957,76,8,24,92,76,80,0,2.8
1966,"York City",4,46,47,65,79,-14,1.02173913043478,1.41304347826087,1.71739130434783,-0.304347826086957,90,22,24,92,89,72,1,2.2
1967,"AFC Bournemouth",3,46,63,56,51,5,1.3695652173913,1.21739130434783,1.10869565217391,0.108695652173913,58,14,24,68,48,90,10,-2.8
1967,"Aldershot",4,46,71,70,55,15,1.54347826086957,1.52173913043478,1.19565217391304,0.326086956521739,77,9,24,92,80,57,-3,0.3
1967,"Arsenal",1,42,61,60,56,4,1.45238095238095,1.42857142857143,1.33333333333333,0.0952380952380952,9,9,22,22,3,116,6,0.5
1967,"Aston Villa",2,42,52,54,64,-10,1.23809523809524,1.28571428571429,1.52380952380952,-0.238095238095238,34,12,22,44,37,121,-3,2.6
1967,"Barnsley",4,46,85,68,46,22,1.84782608695652,1.47826086956522,1,0.478260869565217,70,2,24,92,53,111,17,-0.5
1967,"Barrow",3,46,71,65,54,11,1.54347826086957,1.41304347826087,1.17391304347826,0.239130434782609,50,6,24,68,57,44,-7,NA
1967,"Birmingham City",2,42,71,83,51,32,1.69047619047619,1.97619047619048,1.21428571428571,0.761904761904762,26,4,22,44,29,117,-3,1.5
1967,"Blackburn Rovers",2,42,59,56,49,7,1.4047619047619,1.33333333333333,1.16666666666667,0.166666666666667,29,7,22,44,38,121,-9,0.2
1967,"Blackpool",2,42,82,71,43,28,1.95238095238095,1.69047619047619,1.02380952380952,0.666666666666667,24,2,22,44,33,112,-9,-1.6
1967,"Bolton Wanderers",2,42,52,60,63,-3,1.23809523809524,1.42857142857143,1.5,-0.0714285714285714,35,13,22,44,39,121,-4,1.2
1967,"Bradford City",4,46,80,72,51,21,1.73913043478261,1.56521739130435,1.10869565217391,0.456521739130435,72,4,24,92,71,106,1,0.7
1967,"Bradford Park Avenue",4,46,27,30,82,-52,0.58695652173913,0.652173913043478,1.78260869565217,-1.1304347826087,92,24,24,92,92,51,0,NA
1967,"Brentford",4,46,61,61,64,-3,1.32608695652174,1.32608695652174,1.39130434782609,-0.0652173913043478,79,11,24,92,79,93,0,0.7
1967,"Brighton & Hove Albion",3,46,64,57,55,2,1.39130434782609,1.23913043478261,1.19565217391304,0.0434782608695652,57,13,24,68,55,93,2,3.2
1967,"Bristol City",2,42,49,48,62,-14,1.16666666666667,1.14285714285714,1.47619047619048,-0.333333333333333,38,16,22,44,41,108,-3,2.1
1967,"Bristol Rovers",3,46,60,72,78,-6,1.30434782608696,1.56521739130435,1.69565217391304,-0.130434782608696,61,17,24,68,58,92,3,2.5
1967,"Burnley",1,42,52,64,71,-7,1.23809523809524,1.52380952380952,1.69047619047619,-0.166666666666667,12,12,22,22,14,121,-2,-1.9
1967,"Bury",3,46,80,91,66,25,1.73913043478261,1.97826086956522,1.43478260869565,0.543478260869565,45,1,24,68,43,114,2,-1.6
1967,"Cardiff City",2,42,51,60,66,-6,1.21428571428571,1.42857142857143,1.57142857142857,-0.142857142857143,36,14,22,44,27,93,9,-0.1
1967,"Carlisle United",2,42,55,58,52,6,1.30952380952381,1.38095238095238,1.23809523809524,0.142857142857143,32,10,22,44,32,84,0,-2.5
1967,"Charlton Athletic",2,42,49,63,68,-5,1.16666666666667,1.5,1.61904761904762,-0.119047619047619,39,17,22,44,25,92,14,0.1
1967,"Chelsea",1,42,66,62,68,-6,1.57142857142857,1.47619047619048,1.61904761904762,-0.142857142857143,6,6,22,22,5,104,1,-1
1967,"Chester",4,46,41,57,78,-21,0.891304347826087,1.23913043478261,1.69565217391304,-0.456521739130435,90,22,24,92,84,67,6,4
1967,"Chesterfield",4,46,74,71,50,21,1.60869565217391,1.54347826086957,1.08695652173913,0.456521739130435,74,6,24,92,87,100,-13,2.3
1967,"Colchester United",3,46,42,50,87,-37,0.91304347826087,1.08695652173913,1.89130434782609,-0.804347826086957,67,23,24,68,73,68,-6,1.3
1967,"Coventry City",1,42,42,51,71,-20,1,1.21428571428571,1.69047619047619,-0.476190476190476,21,21,22,22,20,94,1,1.4
1967,"Crewe Alexandra",4,46,78,74,49,25,1.69565217391304,1.60869565217391,1.06521739130435,0.543478260869565,73,5,24,92,67,96,6,-0.7
1967,"Crystal Palace",2,42,53,56,56,0,1.26190476190476,1.33333333333333,1.33333333333333,0,33,11,22,44,24,93,9,-0.1
1967,"Darlington",4,46,53,47,53,-6,1.15217391304348,1.02173913043478,1.15217391304348,-0.130434782608696,85,17,24,92,75,81,10,-0.2
1967,"Derby County",2,42,49,71,78,-7,1.16666666666667,1.69047619047619,1.85714285714286,-0.166666666666667,40,18,22,44,23,121,17,2.8
1967,"Doncaster Rovers",4,46,69,66,56,10,1.5,1.43478260869565,1.21739130434783,0.217391304347826,78,10,24,92,69,88,9,-0.3
1967,"Everton",1,42,75,67,40,27,1.78571428571429,1.5952380952381,0.952380952380952,0.642857142857143,4,4,22,22,4,121,0,0.1
1967,"Exeter City",4,46,49,45,65,-20,1.06521739130435,0.978260869565217,1.41304347826087,-0.434782608695652,88,20,24,92,85,88,3,2.8
1967,"Fulham",1,42,37,56,98,-42,0.880952380952381,1.33333333333333,2.33333333333333,-1,22,22,22,22,44,102,-22,-1
1967,"Gillingham",3,46,66,59,63,-4,1.43478260869565,1.28260869565217,1.3695652173913,-0.0869565217391304,54,10,24,68,64,88,-10,0.2
1967,"Grimsby Town",3,46,51,52,69,-17,1.10869565217391,1.1304347826087,1.5,-0.369565217391304,65,21,24,68,91,110,-26,-0.8
1967,"Halifax Town",4,46,61,52,49,3,1.32608695652174,1.1304347826087,1.06521739130435,0.0652173913043478,80,12,24,92,70,69,10,-0.9
1967,"Hartlepool United",4,46,85,60,46,14,1.84782608695652,1.30434782608696,1,0.304347826086957,71,3,24,92,66,89,5,-1.7
1967,"Huddersfield Town",2,42,51,46,61,-15,1.21428571428571,1.0952380952381,1.45238095238095,-0.357142857142857,37,15,22,44,28,99,9,-4.2
1967,"Hull City",2,42,49,58,73,-15,1.16666666666667,1.38095238095238,1.73809523809524,-0.357142857142857,41,19,22,44,34,104,7,-0.3
1967,"Ipswich Town",2,42,81,79,44,35,1.92857142857143,1.88095238095238,1.04761904761905,0.833333333333333,25,3,22,44,12,75,13,0.7
1967,"Leeds United",1,42,75,71,41,30,1.78571428571429,1.69047619047619,0.976190476190476,0.714285714285714,5,5,22,22,1,93,4,-0.4
1967,"Leicester City",1,42,51,64,69,-5,1.21428571428571,1.52380952380952,1.64285714285714,-0.119047619047619,14,14,22,22,21,115,-7,-0.8
1967,"Leyton Orient",3,46,53,46,62,-16,1.15217391304348,1,1.34782608695652,-0.347826086956522,64,20,24,68,63,102,1,2.2
1967,"Lincoln City",4,46,60,71,68,3,1.30434782608696,1.54347826086957,1.47826086956522,0.0652173913043478,82,14,24,92,76,107,6,2.3
1967,"Liverpool",1,42,77,71,40,31,1.83333333333333,1.69047619047619,0.952380952380952,0.738095238095238,3,3,22,22,2,116,1,0.1
1967,"Luton Town",4,46,93,87,44,43,2.02173913043478,1.89130434782609,0.956521739130435,0.934782608695652,69,1,24,92,47,91,22,3.4
1967,"Manchester City",1,42,84,86,43,43,2,2.04761904761905,1.02380952380952,1.02380952380952,1,1,22,22,13,117,-12,-0.4
1967,"Manchester United",1,42,80,89,55,34,1.9047619047619,2.11904761904762,1.30952380952381,0.80952380952381,2,2,22,22,10,117,-8,-0.8
1967,"Mansfield Town",3,46,49,51,67,-16,1.06521739130435,1.10869565217391,1.45652173913043,-0.347826086956522,66,22,24,68,59,77,7,2.3
1967,"Middlesbrough",2,42,63,60,54,6,1.5,1.42857142857143,1.28571428571429,0.142857142857143,28,6,22,44,26,110,2,1.5
1967,"Millwall",2,42,59,62,50,12,1.4047619047619,1.47619047619048,1.19047619047619,0.285714285714286,30,8,22,44,30,93,0,-0.9
1967,"Newcastle United",1,42,54,54,67,-13,1.28571428571429,1.28571428571429,1.5952380952381,-0.30952380952381,10,10,22,22,7,116,3,-1.1
1967,"Newport County",4,46,61,58,63,-5,1.32608695652174,1.26086956521739,1.3695652173913,-0.108695652173913,81,13,24,92,90,67,-9,-0.1
1967,"Northampton Town",3,46,55,58,72,-14,1.19565217391304,1.26086956521739,1.56521739130435,-0.304347826086957,62,18,24,68,65,93,-3,-1.5
1967,"Norwich City",2,42,59,60,65,-5,1.4047619047619,1.42857142857143,1.54761904761905,-0.119047619047619,31,9,22,44,35,93,-4,1.7
1967,"Nottingham Forest",1,42,53,52,64,-12,1.26190476190476,1.23809523809524,1.52380952380952,-0.285714285714286,11,11,22,22,18,117,-7,1
1967,"Notts County",4,46,56,53,79,-26,1.21739130434783,1.15217391304348,1.71739130434783,-0.565217391304348,84,16,24,92,88,120,-4,4.3
1967,"Oldham Athletic",3,46,61,60,65,-5,1.32608695652174,1.30434782608696,1.41304347826087,-0.108695652173913,60,16,24,68,68,102,-8,2.7
1967,"Oxford United",3,46,79,69,47,22,1.71739130434783,1.5,1.02173913043478,0.478260869565217,46,2,24,68,42,54,4,-1.6
1967,"Peterborough United",3,46,70,79,67,12,1.52173913043478,1.71739130434783,1.45652173913043,0.260869565217391,52,8,24,68,86,60,-34,0.5
1967,"Plymouth Argyle",2,42,36,38,72,-34,0.857142857142857,0.904761904761905,1.71428571428571,-0.80952380952381,44,22,22,44,50,93,-6,-2
1967,"Port Vale",4,46,51,61,72,-11,1.10869565217391,1.32608695652174,1.56521739130435,-0.239130434782609,86,18,24,92,81,107,5,2
1967,"Portsmouth",2,42,67,68,55,13,1.5952380952381,1.61904761904762,1.30952380952381,0.30952380952381,27,5,22,44,40,93,-13,-4.1
1967,"Preston North End",2,42,47,43,65,-22,1.11904761904762,1.02380952380952,1.54761904761905,-0.523809523809524,42,20,22,44,36,121,6,-0.6
1967,"Queens Park Rangers",2,42,83,67,36,31,1.97619047619048,1.5952380952381,0.857142857142857,0.738095238095238,23,1,22,44,22,93,1,0.3
1967,"Reading",3,46,72,70,60,10,1.56521739130435,1.52173913043478,1.30434782608696,0.217391304347826,49,5,24,68,61,93,-12,-2.7
1967,"Rochdale",4,46,50,51,72,-21,1.08695652173913,1.10869565217391,1.56521739130435,-0.456521739130435,87,19,24,92,72,92,15,-0.5
1967,"Rotherham United",2,42,41,42,76,-34,0.976190476190476,1,1.80952380952381,-0.80952380952381,43,21,22,44,56,88,-13,-2
1967,"Scunthorpe United",3,46,42,56,87,-31,0.91304347826087,1.21739130434783,1.89130434782609,-0.673913043478261,68,24,24,68,82,70,-14,-1.5
1967,"Sheffield United",1,42,43,49,70,-21,1.02380952380952,1.16666666666667,1.66666666666667,-0.5,20,20,22,22,31,117,-11,-1
1967,"Sheffield Wednesday",1,42,45,51,63,-12,1.07142857142857,1.21428571428571,1.5,-0.285714285714286,19,19,22,22,15,117,4,-3.9
1967,"Shrewsbury Town",3,46,75,61,49,12,1.6304347826087,1.32608695652174,1.06521739130435,0.260869565217391,47,3,24,68,60,69,-13,-0.8
1967,"Southampton",1,42,50,66,83,-17,1.19047619047619,1.57142857142857,1.97619047619048,-0.404761904761905,15,15,22,22,6,93,9,-0.9
1967,"Southend United",4,46,74,77,58,19,1.60869565217391,1.67391304347826,1.26086956521739,0.41304347826087,75,7,24,92,74,93,1,0.5
1967,"Southport",3,46,63,65,65,0,1.3695652173913,1.41304347826087,1.41304347826087,0,59,15,24,68,52,50,7,-3.2
1967,"Stockport County",3,46,66,70,75,-5,1.43478260869565,1.52173913043478,1.6304347826087,-0.108695652173913,55,11,24,68,54,99,1,-2.9
1967,"Stoke City",1,42,49,50,73,-23,1.16666666666667,1.19047619047619,1.73809523809524,-0.547619047619048,18,18,22,22,19,113,-1,-1
1967,"Sunderland",1,42,50,51,61,-10,1.19047619047619,1.21428571428571,1.45238095238095,-0.238095238095238,16,16,22,22,16,119,0,-1.3
1967,"Swansea City",4,46,58,63,77,-14,1.26086956521739,1.3695652173913,1.67391304347826,-0.304347826086957,83,15,24,92,77,93,6,1.2
1967,"Swindon Town",3,46,65,74,51,23,1.41304347826087,1.60869565217391,1.10869565217391,0.5,56,12,24,68,45,93,11,0.3
1967,"Torquay United",3,46,74,60,56,4,1.60869565217391,1.30434782608696,1.21739130434783,0.0869565217391304,48,4,24,68,51,78,-3,-3
1967,"Tottenham Hotspur",1,42,66,70,59,11,1.57142857142857,1.66666666666667,1.4047619047619,0.261904761904762,7,7,22,22,8,101,-1,-1.9
1967,"Tranmere Rovers",3,46,54,62,74,-12,1.17391304347826,1.34782608695652,1.60869565217391,-0.260869565217391,63,19,24,68,49,89,14,0.7
1967,"Walsall",3,46,69,74,61,13,1.5,1.60869565217391,1.32608695652174,0.282608695652174,53,9,24,68,62,100,-9,0.4
1967,"Watford",3,46,71,74,50,24,1.54347826086957,1.60869565217391,1.08695652173913,0.521739130434783,51,7,24,68,46,93,5,-1.8
1967,"West Bromwich Albion",1,42,63,75,62,13,1.5,1.78571428571429,1.47619047619048,0.30952380952381,8,8,22,22,9,121,-1,0.2
1967,"West Ham United",1,42,52,73,69,4,1.23809523809524,1.73809523809524,1.64285714285714,0.0952380952380952,13,13,22,22,11,94,2,-0.6
1967,"Wolverhampton Wanderers",1,42,50,66,75,-9,1.19047619047619,1.57142857142857,1.78571428571429,-0.214285714285714,17,17,22,22,17,121,0,0.2
1967,"Workington",4,46,41,54,87,-33,0.891304347826087,1.17391304347826,1.89130434782609,-0.717391304347826,91,23,24,92,83,26,8,NA
1967,"Wrexham",4,46,73,72,53,19,1.58695652173913,1.56521739130435,1.15217391304348,0.41304347826087,76,8,24,92,78,80,-2,3.1
1967,"York City",4,46,47,65,68,-3,1.02173913043478,1.41304347826087,1.47826086956522,-0.0652173913043478,89,21,24,92,89,72,0,-0.1
1968,"AFC Bournemouth",3,46,72,60,45,15,1.56521739130435,1.30434782608696,0.978260869565217,0.326086956521739,48,4,24,68,66,90,-18,-4
1968,"Aldershot",4,46,64,66,66,0,1.39130434782609,1.43478260869565,1.43478260869565,0,80,12,24,92,75,57,5,0.7
1968,"Arsenal",1,42,78,56,27,29,1.85714285714286,1.33333333333333,0.642857142857143,0.69047619047619,3,3,22,22,12,116,-9,-0.4
1968,"Aston Villa",2,42,50,37,48,-11,1.19047619047619,0.880952380952381,1.14285714285714,-0.261904761904762,37,15,22,44,43,121,-6,2.9
1968,"Barnsley",3,46,62,58,63,-5,1.34782608695652,1.26086956521739,1.3695652173913,-0.108695652173913,53,9,24,68,52,111,1,-1.9
1968,"Barrow",3,46,59,56,75,-19,1.28260869565217,1.21739130434783,1.6304347826087,-0.41304347826087,57,13,24,68,67,44,-10,NA
1968,"Birmingham City",2,42,62,73,59,14,1.47619047619048,1.73809523809524,1.4047619047619,0.333333333333333,29,7,22,44,40,117,-11,0.8
1968,"Blackburn Rovers",2,42,50,52,63,-11,1.19047619047619,1.23809523809524,1.5,-0.261904761904762,38,16,22,44,28,121,10,-0.6
1968,"Blackpool",2,42,57,51,41,10,1.35714285714286,1.21428571428571,0.976190476190476,0.238095238095238,33,11,22,44,24,112,9,-2.2
1968,"Bolton Wanderers",2,42,50,55,67,-12,1.19047619047619,1.30952380952381,1.5952380952381,-0.285714285714286,39,17,22,44,38,121,1,2.3
1968,"Bradford City",4,46,74,65,46,19,1.60869565217391,1.41304347826087,1,0.41304347826087,71,3,24,92,54,106,17,-1
1968,"Bradford Park Avenue",4,46,25,32,106,-74,0.543478260869565,0.695652173913043,2.30434782608696,-1.60869565217391,92,24,24,92,92,51,0,NA
1968,"Brentford",4,46,66,64,65,-1,1.43478260869565,1.39130434782609,1.41304347826087,-0.0217391304347826,79,11,24,92,73,93,6,2.6
1968,"Brighton & Hove Albion",3,46,61,72,65,7,1.32608695652174,1.56521739130435,1.41304347826087,0.152173913043478,55,11,24,68,47,93,8,3.2
1968,"Bristol City",2,42,49,46,53,-7,1.16666666666667,1.0952380952381,1.26190476190476,-0.166666666666667,41,19,22,44,36,108,5,3
1968,"Bristol Rovers",3,46,59,63,71,-8,1.28260869565217,1.3695652173913,1.54347826086957,-0.173913043478261,58,14,24,68,48,92,10,2.3
1968,"Burnley",1,42,54,55,82,-27,1.28571428571429,1.30952380952381,1.95238095238095,-0.642857142857143,14,14,22,22,14,121,0,-1.8
1968,"Bury",2,42,41,51,80,-29,0.976190476190476,1.21428571428571,1.9047619047619,-0.69047619047619,43,21,22,44,63,114,-20,-2
1968,"Cardiff City",2,42,67,67,54,13,1.5952380952381,1.5952380952381,1.28571428571429,0.30952380952381,27,5,22,44,29,93,-2,-0.2
1968,"Carlisle United",2,42,58,46,49,-3,1.38095238095238,1.0952380952381,1.16666666666667,-0.0714285714285714,32,10,22,44,35,84,-3,-2
1968,"Charlton Athletic",2,42,68,61,52,9,1.61904761904762,1.45238095238095,1.23809523809524,0.214285714285714,25,3,22,44,42,92,-17,-1.6
1968,"Chelsea",1,42,70,73,53,20,1.66666666666667,1.73809523809524,1.26190476190476,0.476190476190476,5,5,22,22,3,104,2,-1.7
1968,"Chester",4,46,61,76,66,10,1.32608695652174,1.65217391304348,1.43478260869565,0.217391304347826,84,16,24,92,76,67,8,2.4
1968,"Chesterfield",4,46,54,43,50,-7,1.17391304347826,0.934782608695652,1.08695652173913,-0.152173913043478,87,19,24,92,69,100,18,2.3
1968,"Colchester United",4,46,72,57,53,4,1.56521739130435,1.23913043478261,1.15217391304348,0.0869565217391304,73,5,24,92,78,68,-5,2.3
1968,"Coventry City",1,42,41,46,64,-18,0.976190476190476,1.0952380952381,1.52380952380952,-0.428571428571429,20,20,22,22,6,94,14,1
1968,"Crewe Alexandra",3,46,48,52,76,-24,1.04347826086957,1.1304347826087,1.65217391304348,-0.521739130434783,67,23,24,68,82,96,-15,-2.5
1968,"Crystal Palace",2,42,78,70,47,23,1.85714285714286,1.66666666666667,1.11904761904762,0.547619047619048,24,2,22,44,20,93,4,-0.1
1968,"Darlington",4,46,69,62,45,17,1.5,1.34782608695652,0.978260869565217,0.369565217391304,75,7,24,92,90,81,-15,-1.5
1968,"Derby County",2,42,89,65,32,33,2.11904761904762,1.54761904761905,0.761904761904762,0.785714285714286,23,1,22,44,4,121,19,0.4
1968,"Doncaster Rovers",4,46,80,65,38,27,1.73913043478261,1.41304347826087,0.826086956521739,0.58695652173913,69,1,24,92,55,88,14,-2
1968,"Everton",1,42,78,77,36,41,1.85714285714286,1.83333333333333,0.857142857142857,0.976190476190476,4,4,22,22,1,121,3,-0.1
1968,"Exeter City",4,46,59,66,65,1,1.28260869565217,1.43478260869565,1.41304347826087,0.0217391304347826,85,17,24,92,86,88,-1,3.1
1968,"Fulham",2,42,32,40,81,-41,0.761904761904762,0.952380952380952,1.92857142857143,-0.976190476190476,44,22,22,44,49,102,-5,1.1
1968,"Gillingham",3,46,54,54,63,-9,1.17391304347826,1.17391304347826,1.3695652173913,-0.195652173913043,64,20,24,68,64,88,0,1.5
1968,"Grimsby Town",4,46,42,47,69,-22,0.91304347826087,1.02173913043478,1.5,-0.478260869565217,91,23,24,92,84,110,7,2.1
1968,"Halifax Town",4,46,77,53,37,16,1.67391304347826,1.15217391304348,0.804347826086957,0.347826086956522,70,2,24,92,61,69,9,-2.1
1968,"Hartlepool United",3,46,49,40,70,-30,1.06521739130435,0.869565217391304,1.52173913043478,-0.652173913043478,66,22,24,68,91,89,-25,-1.7
1968,"Huddersfield Town",2,42,63,53,46,7,1.5,1.26190476190476,1.0952380952381,0.166666666666667,28,6,22,44,23,99,5,-4.9
1968,"Hull City",2,42,55,59,52,7,1.30952380952381,1.4047619047619,1.23809523809524,0.166666666666667,34,12,22,44,34,104,0,-1.7
1968,"Ipswich Town",1,42,56,59,60,-1,1.33333333333333,1.4047619047619,1.42857142857143,-0.0238095238095238,12,12,22,22,18,75,-6,0.8
1968,"Leeds United",1,42,94,66,26,40,2.23809523809524,1.57142857142857,0.619047619047619,0.952380952380952,1,1,22,22,2,93,-1,-0.5
1968,"Leicester City",1,42,39,39,68,-29,0.928571428571429,0.928571428571429,1.61904761904762,-0.69047619047619,21,21,22,22,26,115,-5,-1.9
1968,"Leyton Orient",3,46,56,51,58,-7,1.21739130434783,1.10869565217391,1.26086956521739,-0.152173913043478,63,19,24,68,45,102,18,3.2
1968,"Lincoln City",4,46,68,54,52,2,1.47826086956522,1.17391304347826,1.1304347826087,0.0434782608695652,76,8,24,92,77,107,-1,0.8
1968,"Liverpool",1,42,86,63,24,39,2.04761904761905,1.5,0.571428571428571,0.928571428571429,2,2,22,22,5,116,-3,0.1
1968,"Luton Town",3,46,86,74,38,36,1.8695652173913,1.60869565217391,0.826086956521739,0.782608695652174,47,3,24,68,46,91,1,0.8
1968,"Manchester City",1,42,55,64,55,9,1.30952380952381,1.52380952380952,1.30952380952381,0.214285714285714,13,13,22,22,10,117,3,-0.1
1968,"Manchester United",1,42,57,57,53,4,1.35714285714286,1.35714285714286,1.26190476190476,0.0952380952380952,10,10,22,22,11,117,-1,0.1
1968,"Mansfield Town",3,46,59,58,62,-4,1.28260869565217,1.26086956521739,1.34782608695652,-0.0869565217391304,59,15,24,68,50,77,9,-0.3
1968,"Middlesbrough",2,42,68,58,49,9,1.61904761904762,1.38095238095238,1.16666666666667,0.214285714285714,26,4,22,44,27,110,-1,1.4
1968,"Millwall",2,42,60,57,49,8,1.42857142857143,1.35714285714286,1.16666666666667,0.19047619047619,30,8,22,44,32,93,-2,-1.3
1968,"Newcastle United",1,42,59,61,55,6,1.4047619047619,1.45238095238095,1.30952380952381,0.142857142857143,7,7,22,22,7,116,0,-2.1
1968,"Newport County",4,46,47,49,74,-25,1.02173913043478,1.06521739130435,1.60869565217391,-0.543478260869565,90,22,24,92,88,67,2,1.5
1968,"Northampton Town",3,46,54,54,61,-7,1.17391304347826,1.17391304347826,1.32608695652174,-0.152173913043478,65,21,24,68,83,93,-18,-2
1968,"Norwich City",2,42,55,53,56,-3,1.30952380952381,1.26190476190476,1.33333333333333,-0.0714285714285714,35,13,22,44,33,93,2,1.7
1968,"Nottingham Forest",1,42,43,45,57,-12,1.02380952380952,1.07142857142857,1.35714285714286,-0.285714285714286,18,18,22,22,16,117,2,1.5
1968,"Notts County",4,46,54,48,57,-9,1.17391304347826,1.04347826086957,1.23913043478261,-0.195652173913043,88,20,24,92,74,120,14,5.8
1968,"Oldham Athletic",3,46,48,50,83,-33,1.04347826086957,1.08695652173913,1.80434782608696,-0.717391304347826,68,24,24,68,87,102,-19,3.1
1968,"Oxford United",2,42,45,34,55,-21,1.07142857142857,0.80952380952381,1.30952380952381,-0.5,42,20,22,44,37,54,5,-1.5
1968,"Peterborough United",4,46,55,60,57,3,1.19565217391304,1.30434782608696,1.23913043478261,0.0652173913043478,86,18,24,92,79,60,7,2.1
1968,"Plymouth Argyle",3,46,66,53,49,4,1.43478260869565,1.15217391304348,1.06521739130435,0.0869565217391304,50,6,24,68,57,93,-7,-0.9
1968,"Port Vale",4,46,62,46,46,0,1.34782608695652,1,1,0,81,13,24,92,72,107,9,-0.3
1968,"Portsmouth",2,42,50,58,58,0,1.19047619047619,1.38095238095238,1.38095238095238,0,40,18,22,44,39,93,1,-3.6
1968,"Preston North End",2,42,51,38,44,-6,1.21428571428571,0.904761904761905,1.04761904761905,-0.142857142857143,36,14,22,44,44,121,-8,0.2
1968,"Queens Park Rangers",1,42,22,39,95,-56,0.523809523809524,0.928571428571429,2.26190476190476,-1.33333333333333,22,22,22,22,31,93,-9,0.2
1968,"Reading",3,46,58,67,66,1,1.26086956521739,1.45652173913043,1.43478260869565,0.0217391304347826,61,17,24,68,51,93,10,-0.8
1968,"Rochdale",4,46,74,68,35,33,1.60869565217391,1.47826086956522,0.760869565217391,0.717391304347826,72,4,24,92,53,92,19,-1.4
1968,"Rotherham United",3,46,61,56,50,6,1.32608695652174,1.21739130434783,1.08695652173913,0.130434782608696,56,12,24,68,58,88,-2,0
1968,"Scunthorpe United",4,46,62,61,60,1,1.34782608695652,1.32608695652174,1.30434782608696,0.0217391304347826,82,14,24,92,80,70,2,0.2
1968,"Sheffield United",2,42,59,61,50,11,1.4047619047619,1.45238095238095,1.19047619047619,0.261904761904762,31,9,22,44,25,117,6,-1.1
1968,"Sheffield Wednesday",1,42,46,41,54,-13,1.0952380952381,0.976190476190476,1.28571428571429,-0.30952380952381,15,15,22,22,21,117,-6,-4.6
1968,"Shrewsbury Town",3,46,59,51,67,-16,1.28260869565217,1.10869565217391,1.45652173913043,-0.347826086956522,60,16,24,68,62,69,-2,1.3
1968,"Southampton",1,42,61,57,48,9,1.45238095238095,1.35714285714286,1.14285714285714,0.214285714285714,6,6,22,22,19,93,-13,-0.9
1968,"Southend United",4,46,70,78,61,17,1.52173913043478,1.69565217391304,1.32608695652174,0.369565217391304,74,6,24,92,85,93,-11,1.6
1968,"Southport",3,46,64,71,64,7,1.39130434782609,1.54347826086957,1.39130434782609,0.152173913043478,52,8,24,68,65,50,-13,NA
1968,"Stockport County",3,46,62,67,68,-1,1.34782608695652,1.45652173913043,1.47826086956522,-0.0217391304347826,54,10,24,68,68,99,-14,-3.3
1968,"Stoke City",1,42,42,40,63,-23,1,0.952380952380952,1.5,-0.547619047619048,19,19,22,22,8,113,11,-0.7
1968,"Sunderland",1,42,45,43,67,-24,1.07142857142857,1.02380952380952,1.5952380952381,-0.571428571428571,16,16,22,22,22,119,-6,-0.8
1968,"Swansea City",4,46,68,58,54,4,1.47826086956522,1.26086956521739,1.17391304347826,0.0869565217391304,77,9,24,92,71,93,6,3.2
1968,"Swindon Town",3,46,91,71,35,36,1.97826086956522,1.54347826086957,0.760869565217391,0.782608695652174,45,1,24,68,30,93,15,-0.3
1968,"Torquay United",3,46,66,54,46,8,1.43478260869565,1.17391304347826,1,0.173913043478261,51,7,24,68,59,78,-8,-2.7
1968,"Tottenham Hotspur",1,42,59,61,51,10,1.4047619047619,1.45238095238095,1.21428571428571,0.238095238095238,8,8,22,22,9,101,-1,-0.5
1968,"Tranmere Rovers",3,46,67,70,68,2,1.45652173913043,1.52173913043478,1.47826086956522,0.0434782608695652,49,5,24,68,60,89,-11,-1.8
1968,"Walsall",3,46,58,50,49,1,1.26086956521739,1.08695652173913,1.06521739130435,0.0217391304347826,62,18,24,68,56,100,6,-0.4
1968,"Watford",3,46,91,74,34,40,1.97826086956522,1.60869565217391,0.739130434782609,0.869565217391304,46,2,24,68,41,93,5,0
1968,"West Bromwich Albion",1,42,59,64,67,-3,1.4047619047619,1.52380952380952,1.5952380952381,-0.0714285714285714,9,9,22,22,15,121,-6,0.7
1968,"West Ham United",1,42,57,66,50,16,1.35714285714286,1.57142857142857,1.19047619047619,0.380952380952381,11,11,22,22,17,94,-6,-1.6
1968,"Wolverhampton Wanderers",1,42,45,41,58,-17,1.07142857142857,0.976190476190476,1.38095238095238,-0.404761904761905,17,17,22,22,13,121,4,0
1968,"Workington",4,46,62,40,43,-3,1.34782608695652,0.869565217391304,0.934782608695652,-0.0652173913043478,83,15,24,92,89,26,-6,NA
1968,"Wrexham",4,46,68,61,52,9,1.47826086956522,1.32608695652174,1.1304347826087,0.195652173913043,78,10,24,92,70,80,8,4
1968,"York City",4,46,53,53,75,-22,1.15217391304348,1.15217391304348,1.6304347826087,-0.478260869565217,89,21,24,92,81,72,8,1
1969,"AFC Bournemouth",3,46,51,48,71,-23,1.10869565217391,1.04347826086957,1.54347826086957,-0.5,66,22,24,68,70,90,-4,-1.5
1969,"Aldershot",4,46,73,78,65,13,1.58695652173913,1.69565217391304,1.41304347826087,0.282608695652174,75,7,24,92,85,57,-10,-0.3
1969,"Arsenal",1,42,54,51,49,2,1.28571428571429,1.21428571428571,1.16666666666667,0.0476190476190476,12,12,22,22,1,116,11,0.8
1969,"Aston Villa",2,42,37,36,62,-26,0.880952380952381,0.857142857142857,1.47619047619048,-0.619047619047619,43,21,22,44,48,121,-5,3.5
1969,"Barnsley",3,46,72,68,59,9,1.56521739130435,1.47826086956522,1.28260869565217,0.195652173913043,52,8,24,68,55,111,-3,-0.5
1969,"Barrow",3,46,38,46,81,-35,0.826086956521739,1,1.76086956521739,-0.760869565217391,67,23,24,68,92,44,-25,NA
1969,"Birmingham City",2,42,44,51,78,-27,1.04761904761905,1.21428571428571,1.85714285714286,-0.642857142857143,40,18,22,44,31,117,9,1.4
1969,"Blackburn Rovers",2,42,67,54,50,4,1.5952380952381,1.28571428571429,1.19047619047619,0.0952380952380952,28,6,22,44,43,121,-15,-1.8
1969,"Blackpool",2,42,73,56,45,11,1.73809523809524,1.33333333333333,1.07142857142857,0.261904761904762,24,2,22,44,22,112,2,-3.6
1969,"Bolton Wanderers",2,42,48,54,61,-7,1.14285714285714,1.28571428571429,1.45238095238095,-0.166666666666667,38,16,22,44,44,121,-6,1.6
1969,"Bradford City",3,46,63,57,50,7,1.3695652173913,1.23913043478261,1.08695652173913,0.152173913043478,54,10,24,68,62,106,-8,-1.8
1969,"Bradford Park Avenue",4,46,29,41,96,-55,0.630434782608696,0.891304347826087,2.08695652173913,-1.19565217391304,92,24,24,92,NA,51,NA,NA
1969,"Brentford",4,46,76,58,39,19,1.65217391304348,1.26086956521739,0.847826086956522,0.41304347826087,73,5,24,92,79,93,-6,1.2
1969,"Brighton & Hove Albion",3,46,78,57,43,14,1.69565217391304,1.23913043478261,0.934782608695652,0.304347826086957,47,3,24,68,58,93,-11,2.9
1969,"Bristol City",2,42,52,54,50,4,1.23809523809524,1.28571428571429,1.19047619047619,0.0952380952380952,36,14,22,44,41,108,-5,1.5
1969,"Bristol Rovers",3,46,76,80,59,21,1.65217391304348,1.73913043478261,1.28260869565217,0.456521739130435,48,4,24,68,49,92,-1,0.7
1969,"Burnley",1,42,51,56,61,-5,1.21428571428571,1.33333333333333,1.45238095238095,-0.119047619047619,14,14,22,22,21,121,-7,-2.9
1969,"Bury",3,46,56,75,80,-5,1.21739130434783,1.6304347826087,1.73913043478261,-0.108695652173913,63,19,24,68,66,114,-3,0
1969,"Cardiff City",2,42,67,61,41,20,1.5952380952381,1.45238095238095,0.976190476190476,0.476190476190476,29,7,22,44,25,93,4,-0.6
1969,"Carlisle United",2,42,55,58,56,2,1.30952380952381,1.38095238095238,1.33333333333333,0.0476190476190476,35,13,22,44,26,84,9,-1.6
1969,"Charlton Athletic",2,42,38,35,76,-41,0.904761904761905,0.833333333333333,1.80952380952381,-0.976190476190476,42,20,22,44,42,92,0,-0.2
1969,"Chelsea",1,42,76,70,50,20,1.80952380952381,1.66666666666667,1.19047619047619,0.476190476190476,3,3,22,22,5,104,-2,-2
1969,"Chester",4,46,69,58,66,-8,1.5,1.26086956521739,1.43478260869565,-0.173913043478261,76,8,24,92,72,67,4,2.3
1969,"Chesterfield",4,46,91,77,32,45,1.97826086956522,1.67391304347826,0.695652173913043,0.978260869565217,69,1,24,92,51,100,18,2.2
1969,"Colchester United",4,46,65,64,63,1,1.41304347826087,1.39130434782609,1.3695652173913,0.0217391304347826,78,10,24,92,74,68,4,2.9
1969,"Coventry City",1,42,68,58,48,10,1.61904761904762,1.38095238095238,1.14285714285714,0.238095238095238,6,6,22,22,9,94,-3,-0.4
1969,"Crewe Alexandra",4,46,60,51,51,0,1.30434782608696,1.10869565217391,1.10869565217391,0,82,14,24,92,80,96,2,-0.8
1969,"Crystal Palace",1,42,33,34,68,-34,0.785714285714286,0.80952380952381,1.61904761904762,-0.80952380952381,20,20,22,22,16,93,4,0.6
1969,"Darlington",4,46,49,53,73,-20,1.06521739130435,1.15217391304348,1.58695652173913,-0.434782608695652,90,22,24,92,81,81,9,-0.1
1969,"Derby County",1,42,75,64,37,27,1.78571428571429,1.52380952380952,0.880952380952381,0.642857142857143,4,4,22,22,10,121,-6,-1.6
1969,"Doncaster Rovers",3,46,63,52,54,-2,1.3695652173913,1.1304347826087,1.17391304347826,-0.0434782608695652,55,11,24,68,67,88,-12,-2.5
1969,"Everton",1,42,95,72,34,38,2.26190476190476,1.71428571428571,0.80952380952381,0.904761904761905,1,1,22,22,14,121,-13,-1.8
1969,"Exeter City",4,46,53,57,59,-2,1.15217391304348,1.23913043478261,1.28260869565217,-0.0434782608695652,86,18,24,92,78,88,8,3.6
1969,"Fulham",3,46,75,81,55,26,1.6304347826087,1.76086956521739,1.19565217391304,0.565217391304348,49,5,24,68,45,102,4,0.7
1969,"Gillingham",3,46,52,52,64,-12,1.1304347826087,1.1304347826087,1.39130434782609,-0.260869565217391,64,20,24,68,68,88,-4,0.2
1969,"Grimsby Town",4,46,57,54,58,-4,1.23913043478261,1.17391304347826,1.26086956521739,-0.0869565217391304,84,16,24,92,83,110,1,3.9
1969,"Halifax Town",3,46,57,47,63,-16,1.23913043478261,1.02173913043478,1.3695652173913,-0.347826086956522,61,17,24,68,47,69,14,-2.5
1969,"Hartlepool United",4,46,40,42,82,-40,0.869565217391304,0.91304347826087,1.78260869565217,-0.869565217391304,91,23,24,92,91,89,0,0.4
1969,"Huddersfield Town",2,42,84,68,37,31,2,1.61904761904762,0.880952380952381,0.738095238095238,23,1,22,44,17,99,6,-4.6
1969,"Hull City",2,42,56,72,70,2,1.33333333333333,1.71428571428571,1.66666666666667,0.0476190476190476,34,12,22,44,27,104,7,-3.1
1969,"Ipswich Town",1,42,41,40,63,-23,0.976190476190476,0.952380952380952,1.5,-0.547619047619048,18,18,22,22,18,75,0,1.5
1969,"Leeds United",1,42,78,84,49,35,1.85714285714286,2,1.16666666666667,0.833333333333333,2,2,22,22,2,93,0,-1
1969,"Leicester City",2,42,70,64,50,14,1.66666666666667,1.52380952380952,1.19047619047619,0.333333333333333,26,4,22,44,23,115,3,0.2
1969,"Leyton Orient",3,46,87,67,36,31,1.89130434782609,1.45652173913043,0.782608695652174,0.673913043478261,45,1,24,68,39,102,6,0.7
1969,"Lincoln City",4,46,67,66,52,14,1.45652173913043,1.43478260869565,1.1304347826087,0.304347826086957,77,9,24,92,89,107,-12,0.1
1969,"Liverpool",1,42,71,65,42,23,1.69047619047619,1.54761904761905,1,0.547619047619048,5,5,22,22,6,116,-1,0.4
1969,"Luton Town",3,46,83,77,43,34,1.80434782608696,1.67391304347826,0.934782608695652,0.739130434782609,46,2,24,68,28,91,18,1.7
1969,"Manchester City",1,42,59,55,48,7,1.4047619047619,1.30952380952381,1.14285714285714,0.166666666666667,10,10,22,22,12,117,-2,-0.6
1969,"Manchester United",1,42,59,66,61,5,1.4047619047619,1.57142857142857,1.45238095238095,0.119047619047619,11,11,22,22,8,117,3,0.9
1969,"Mansfield Town",3,46,74,70,49,21,1.60869565217391,1.52173913043478,1.06521739130435,0.456521739130435,50,6,24,68,50,77,0,-1.7
1969,"Middlesbrough",2,42,70,55,45,10,1.66666666666667,1.30952380952381,1.07142857142857,0.238095238095238,27,5,22,44,30,110,-3,1.8
1969,"Millwall",2,42,59,56,56,0,1.4047619047619,1.33333333333333,1.33333333333333,0,32,10,22,44,29,93,3,-2.6
1969,"Newcastle United",1,42,64,57,35,22,1.52380952380952,1.35714285714286,0.833333333333333,0.523809523809524,7,7,22,22,11,116,-4,-2.4
1969,"Newport County",4,46,50,53,74,-21,1.08695652173913,1.15217391304348,1.60869565217391,-0.456521739130435,88,20,24,92,90,67,-2,1.8
1969,"Northampton Town",4,46,60,64,55,9,1.30434782608696,1.39130434782609,1.19565217391304,0.195652173913043,83,15,24,92,75,93,8,0.4
1969,"Norwich City",2,42,59,49,46,3,1.4047619047619,1.16666666666667,1.0952380952381,0.0714285714285714,33,11,22,44,32,93,1,2
1969,"Nottingham Forest",1,42,48,50,71,-21,1.14285714285714,1.19047619047619,1.69047619047619,-0.5,16,16,22,22,13,117,3,1.1
1969,"Notts County",4,46,74,73,62,11,1.60869565217391,1.58695652173913,1.34782608695652,0.239130434782609,74,6,24,92,69,120,5,3.4
1969,"Oldham Athletic",4,46,52,60,65,-5,1.1304347826087,1.30434782608696,1.41304347826087,-0.108695652173913,87,19,24,92,71,102,16,5.5
1969,"Oxford United",2,42,51,35,42,-7,1.21428571428571,0.833333333333333,1,-0.166666666666667,37,15,22,44,36,54,1,-2.7
1969,"Peterborough United",4,46,65,77,69,8,1.41304347826087,1.67391304347826,1.5,0.173913043478261,79,11,24,92,84,60,-5,0.4
1969,"Plymouth Argyle",3,46,59,56,64,-8,1.28260869565217,1.21739130434783,1.39130434782609,-0.173913043478261,57,13,24,68,61,93,-4,-0.2
1969,"Port Vale",4,46,79,61,33,28,1.71739130434783,1.32608695652174,0.717391304347826,0.608695652173913,72,4,24,92,59,107,13,-1.6
1969,"Portsmouth",2,42,48,66,80,-14,1.14285714285714,1.57142857142857,1.9047619047619,-0.333333333333333,39,17,22,44,38,93,1,-3.4
1969,"Preston North End",2,42,36,43,63,-20,0.857142857142857,1.02380952380952,1.5,-0.476190476190476,44,22,22,44,46,121,-2,0.8
1969,"Queens Park Rangers",2,42,62,66,57,9,1.47619047619048,1.57142857142857,1.35714285714286,0.214285714285714,31,9,22,44,33,93,-2,0.4
1969,"Reading",3,46,74,87,77,10,1.60869565217391,1.89130434782609,1.67391304347826,0.217391304347826,51,7,24,68,63,93,-12,-0.3
1969,"Rochdale",3,46,64,69,60,9,1.39130434782609,1.5,1.30434782608696,0.195652173913043,53,9,24,68,60,92,-7,-3.9
1969,"Rotherham United",3,46,59,62,54,8,1.28260869565217,1.34782608695652,1.17391304347826,0.173913043478261,58,14,24,68,53,88,5,0.3
1969,"Scunthorpe United",4,46,64,67,65,2,1.39130434782609,1.45652173913043,1.41304347826087,0.0434782608695652,80,12,24,92,87,70,-7,-0.2
1969,"Sheffield United",2,42,71,73,38,35,1.69047619047619,1.73809523809524,0.904761904761905,0.833333333333333,25,3,22,44,24,117,1,-3.1
1969,"Sheffield Wednesday",1,42,33,40,71,-31,0.785714285714286,0.952380952380952,1.69047619047619,-0.738095238095238,21,21,22,22,37,117,-16,-2.7
1969,"Shrewsbury Town",3,46,57,62,63,-1,1.23913043478261,1.34782608695652,1.3695652173913,-0.0217391304347826,62,18,24,68,56,69,6,2.9
1969,"Southampton",1,42,35,46,67,-21,0.833333333333333,1.0952380952381,1.5952380952381,-0.5,19,19,22,22,7,93,12,1.2
1969,"Southend United",4,46,55,59,85,-26,1.19565217391304,1.28260869565217,1.84782608695652,-0.565217391304348,85,17,24,92,88,93,-3,1.9
1969,"Southport",3,46,52,48,66,-18,1.1304347826087,1.04347826086957,1.43478260869565,-0.391304347826087,65,21,24,68,76,50,-11,NA
1969,"Stockport County",3,46,29,27,71,-44,0.630434782608696,0.58695652173913,1.54347826086957,-0.956521739130435,68,24,24,68,82,99,-14,-1.6
1969,"Stoke City",1,42,60,56,52,4,1.42857142857143,1.33333333333333,1.23809523809524,0.0952380952380952,8,8,22,22,15,113,-7,-0.9
1969,"Sunderland",1,42,32,30,68,-38,0.761904761904762,0.714285714285714,1.61904761904762,-0.904761904761905,22,22,22,22,34,119,-12,-0.3
1969,"Swansea City",4,46,81,66,45,21,1.76086956521739,1.43478260869565,0.978260869565217,0.456521739130435,71,3,24,92,57,93,14,4.1
1969,"Swindon Town",2,42,67,57,47,10,1.5952380952381,1.35714285714286,1.11904761904762,0.238095238095238,30,8,22,44,35,93,-5,-2.2
1969,"Torquay United",3,46,59,62,59,3,1.28260869565217,1.34782608695652,1.28260869565217,0.0652173913043478,59,15,24,68,52,78,7,-1.8
1969,"Tottenham Hotspur",1,42,60,54,55,-1,1.42857142857143,1.28571428571429,1.30952380952381,-0.0238095238095238,9,9,22,22,4,101,5,-0.2
1969,"Tranmere Rovers",3,46,58,56,72,-16,1.26086956521739,1.21739130434783,1.56521739130435,-0.347826086956522,60,16,24,68,65,89,-5,-2.3
1969,"Walsall",3,46,63,54,67,-13,1.3695652173913,1.17391304347826,1.45652173913043,-0.282608695652174,56,12,24,68,64,100,-8,-1.5
1969,"Watford",2,42,40,44,57,-13,0.952380952380952,1.04761904761905,1.35714285714286,-0.30952380952381,41,19,22,44,40,93,1,0.2
1969,"West Bromwich Albion",1,42,51,58,66,-8,1.21428571428571,1.38095238095238,1.57142857142857,-0.19047619047619,15,15,22,22,19,121,-4,0
1969,"West Ham United",1,42,48,51,60,-9,1.14285714285714,1.21428571428571,1.42857142857143,-0.214285714285714,17,17,22,22,20,94,-3,-1.1
1969,"Wolverhampton Wanderers",1,42,52,55,57,-2,1.23809523809524,1.30952380952381,1.35714285714286,-0.0476190476190476,13,13,22,22,3,121,10,0.7
1969,"Workington",4,46,50,46,64,-18,1.08695652173913,1,1.39130434782609,-0.391304347826087,89,21,24,92,77,26,12,NA
1969,"Wrexham",4,46,87,84,49,35,1.89130434782609,1.82608695652174,1.06521739130435,0.760869565217391,70,2,24,92,54,80,16,3.3
1969,"York City",4,46,62,55,62,-7,1.34782608695652,1.19565217391304,1.34782608695652,-0.152173913043478,81,13,24,92,73,72,8,-0.4
1970,"AFC Bournemouth",4,46,84,81,46,35,1.82608695652174,1.76086956521739,1,0.760869565217391,70,2,24,92,48,90,22,-1.1
1970,"Aldershot",4,46,59,66,71,-5,1.28260869565217,1.43478260869565,1.54347826086957,-0.108695652173913,85,17,24,92,88,57,-3,0.9
1970,"Arsenal",1,42,94,71,29,42,2.23809523809524,1.69047619047619,0.69047619047619,1,1,1,22,22,5,116,-4,-0.2
1970,"Aston Villa",3,46,72,54,46,8,1.56521739130435,1.17391304347826,1,0.173913043478261,48,4,24,68,45,121,3,4.7
1970,"Barnsley",3,46,62,49,52,-3,1.34782608695652,1.06521739130435,1.1304347826087,-0.0652173913043478,55,11,24,68,65,111,-10,0.8
1970,"Barrow",4,46,29,51,90,-39,0.630434782608696,1.10869565217391,1.95652173913043,-0.847826086956522,92,24,24,92,87,44,5,NA
1970,"Birmingham City",2,42,63,58,48,10,1.5,1.38095238095238,1.14285714285714,0.238095238095238,31,9,22,44,24,117,7,1.7
1970,"Blackburn Rovers",2,42,33,37,69,-32,0.785714285714286,0.880952380952381,1.64285714285714,-0.761904761904762,43,21,22,44,53,121,-10,1.7
1970,"Blackpool",1,42,27,34,66,-32,0.642857142857143,0.80952380952381,1.57142857142857,-0.761904761904762,22,22,22,22,27,112,-5,-4.5
1970,"Bolton Wanderers",2,42,31,35,74,-39,0.738095238095238,0.833333333333333,1.76190476190476,-0.928571428571429,44,22,22,44,52,121,-8,0.8
1970,"Bradford City",3,46,53,49,62,-13,1.15217391304348,1.06521739130435,1.34782608695652,-0.282608695652174,62,18,24,68,67,106,-5,-2.1
1970,"Brentford",4,46,62,66,62,4,1.34782608695652,1.43478260869565,1.34782608695652,0.0869565217391304,79,11,24,92,71,93,8,2.5
1970,"Brighton & Hove Albion",3,46,58,50,47,3,1.26086956521739,1.08695652173913,1.02173913043478,0.0652173913043478,58,14,24,68,46,93,12,4.3
1970,"Bristol City",2,42,41,46,64,-18,0.976190476190476,1.0952380952381,1.52380952380952,-0.428571428571429,41,19,22,44,31,108,10,-0.2
1970,"Bristol Rovers",3,46,70,69,50,19,1.52173913043478,1.5,1.08695652173913,0.41304347826087,49,5,24,68,49,92,0,0.5
1970,"Burnley",1,42,34,29,63,-34,0.80952380952381,0.69047619047619,1.5,-0.80952380952381,21,21,22,22,29,121,-8,-3.1
1970,"Bury",3,46,49,52,60,-8,1.06521739130435,1.1304347826087,1.30434782608696,-0.173913043478261,66,22,24,68,74,114,-8,-1.4
1970,"Cambridge United",4,46,58,51,66,-15,1.26086956521739,1.10869565217391,1.43478260869565,-0.326086956521739,86,18,24,92,79,41,7,5.3
1970,"Cardiff City",2,42,73,64,41,23,1.73809523809524,1.52380952380952,0.976190476190476,0.547619047619048,25,3,22,44,43,93,-18,-1.6
1970,"Carlisle United",2,42,73,65,43,22,1.73809523809524,1.54761904761905,1.02380952380952,0.523809523809524,26,4,22,44,32,84,-6,-3.5
1970,"Charlton Athletic",2,42,38,41,65,-24,0.904761904761905,0.976190476190476,1.54761904761905,-0.571428571428571,42,20,22,44,42,92,0,-0.4
1970,"Chelsea",1,42,69,52,42,10,1.64285714285714,1.23809523809524,1,0.238095238095238,5,5,22,22,8,104,-3,-3
1970,"Chester",4,46,79,69,55,14,1.71739130434783,1.5,1.19565217391304,0.304347826086957,72,4,24,92,90,67,-18,1.4
1970,"Chesterfield",3,46,68,66,38,28,1.47826086956522,1.43478260869565,0.826086956521739,0.608695652173913,51,7,24,68,55,100,-4,0.3
1970,"Colchester United",4,46,75,70,54,16,1.6304347826087,1.52173913043478,1.17391304347826,0.347826086956522,74,6,24,92,76,68,-2,0.8
1970,"Coventry City",1,42,58,37,38,-1,1.38095238095238,0.880952380952381,0.904761904761905,-0.0238095238095238,9,9,22,22,19,94,-10,-0.7
1970,"Crewe Alexandra",4,46,62,75,76,-1,1.34782608695652,1.6304347826087,1.65217391304348,-0.0217391304347826,80,12,24,92,92,96,-12,-0.6
1970,"Crystal Palace",1,42,47,39,57,-18,1.11904761904762,0.928571428571429,1.35714285714286,-0.428571428571429,16,16,22,22,20,93,-4,-0.6
1970,"Darlington",4,46,62,58,57,1,1.34782608695652,1.26086956521739,1.23913043478261,0.0217391304347826,81,13,24,92,86,81,-5,0.4
1970,"Derby County",1,42,58,56,54,2,1.38095238095238,1.33333333333333,1.28571428571429,0.0476190476190476,10,10,22,22,1,121,9,-1.8
1970,"Doncaster Rovers",3,46,48,45,66,-21,1.04347826086957,0.978260869565217,1.43478260869565,-0.456521739130435,67,23,24,68,80,88,-13,-0.4
1970,"Everton",1,42,49,54,60,-6,1.16666666666667,1.28571428571429,1.42857142857143,-0.142857142857143,14,14,22,22,16,121,-2,-0.3
1970,"Exeter City",4,46,65,67,68,-1,1.41304347826087,1.45652173913043,1.47826086956522,-0.0217391304347826,78,10,24,92,83,88,-5,2.3
1970,"Fulham",3,46,84,68,41,27,1.82608695652174,1.47826086956522,0.891304347826087,0.58695652173913,45,1,24,68,41,102,4,-1.1
1970,"Gillingham",3,46,43,42,67,-25,0.934782608695652,0.91304347826087,1.45652173913043,-0.543478260869565,68,24,24,68,82,88,-14,0.6
1970,"Grimsby Town",4,46,61,57,71,-14,1.32608695652174,1.23913043478261,1.54347826086957,-0.304347826086957,83,15,24,92,69,110,14,5.4
1970,"Halifax Town",3,46,78,74,55,19,1.69565217391304,1.60869565217391,1.19565217391304,0.41304347826087,47,3,24,68,61,69,-14,-4.4
1970,"Hartlepool United",4,46,36,34,74,-40,0.782608695652174,0.739130434782609,1.60869565217391,-0.869565217391304,91,23,24,92,85,89,6,1.8
1970,"Huddersfield Town",1,42,47,40,49,-9,1.11904761904762,0.952380952380952,1.16666666666667,-0.214285714285714,17,17,22,22,22,99,-5,-3.2
1970,"Hull City",2,42,70,54,41,13,1.66666666666667,1.28571428571429,0.976190476190476,0.30952380952381,27,5,22,44,34,104,-7,-4.1
1970,"Ipswich Town",1,42,46,42,48,-6,1.0952380952381,1,1.14285714285714,-0.142857142857143,18,18,22,22,13,75,5,1.6
1970,"Leeds United",1,42,91,72,30,42,2.16666666666667,1.71428571428571,0.714285714285714,1,2,2,22,22,2,93,0,-0.7
1970,"Leicester City",2,42,82,57,30,27,1.95238095238095,1.35714285714286,0.714285714285714,0.642857142857143,23,1,22,44,12,115,11,0.2
1970,"Leyton Orient",2,42,43,29,51,-22,1.02380952380952,0.69047619047619,1.21428571428571,-0.523809523809524,39,17,22,44,35,102,4,0.2
1970,"Lincoln City",4,46,52,70,71,-1,1.1304347826087,1.52173913043478,1.54347826086957,-0.0217391304347826,89,21,24,92,73,107,16,1.9
1970,"Liverpool",1,42,68,42,24,18,1.61904761904762,1,0.571428571428571,0.428571428571429,6,6,22,22,3,116,3,-0.1
1970,"Luton Town",2,42,67,62,43,19,1.5952380952381,1.47619047619048,1.02380952380952,0.452380952380952,28,6,22,44,39,91,-11,0.1
1970,"Manchester City",1,42,53,47,42,5,1.26190476190476,1.11904761904762,1,0.119047619047619,12,12,22,22,4,117,8,0
1970,"Manchester United",1,42,59,65,66,-1,1.4047619047619,1.54761904761905,1.57142857142857,-0.0238095238095238,8,8,22,22,7,117,1,0
1970,"Mansfield Town",3,46,69,64,62,2,1.5,1.39130434782609,1.34782608695652,0.0434782608695652,50,6,24,68,66,77,-16,-2.4
1970,"Middlesbrough",2,42,65,60,43,17,1.54761904761905,1.42857142857143,1.02380952380952,0.404761904761905,30,8,22,44,30,110,0,1.7
1970,"Millwall",2,42,66,59,42,17,1.57142857142857,1.4047619047619,1,0.404761904761905,29,7,22,44,25,93,4,-3
1970,"Newcastle United",1,42,55,44,46,-2,1.30952380952381,1.04761904761905,1.0952380952381,-0.0476190476190476,11,11,22,22,11,116,0,-2.3
1970,"Newport County",4,46,38,55,85,-30,0.826086956521739,1.19565217391304,1.84782608695652,-0.652173913043478,90,22,24,92,81,67,9,3.3
1970,"Northampton Town",4,46,70,63,59,4,1.52173913043478,1.3695652173913,1.28260869565217,0.0869565217391304,75,7,24,92,89,93,-14,-0.3
1970,"Norwich City",2,42,59,54,52,2,1.4047619047619,1.28571428571429,1.23809523809524,0.0476190476190476,32,10,22,44,23,93,9,1.2
1970,"Nottingham Forest",1,42,50,42,61,-19,1.19047619047619,1,1.45238095238095,-0.452380952380952,13,13,22,22,21,117,-8,0.7
1970,"Notts County",4,46,99,89,36,53,2.15217391304348,1.93478260869565,0.782608695652174,1.15217391304348,69,1,24,92,47,120,22,4.5
1970,"Oldham Athletic",4,46,83,88,63,25,1.80434782608696,1.91304347826087,1.3695652173913,0.543478260869565,71,3,24,92,56,102,15,3.3
1970,"Oxford United",2,42,56,41,48,-7,1.33333333333333,0.976190476190476,1.14285714285714,-0.166666666666667,36,14,22,44,37,54,-1,-2.4
1970,"Peterborough United",4,46,61,70,71,-1,1.32608695652174,1.52173913043478,1.54347826086957,-0.0217391304347826,84,16,24,92,77,60,7,0.9
1970,"Plymouth Argyle",3,46,55,63,63,0,1.19565217391304,1.3695652173913,1.3695652173913,0,61,17,24,68,51,93,10,1
1970,"Port Vale",3,46,57,52,59,-7,1.23913043478261,1.1304347826087,1.28260869565217,-0.152173913043478,59,15,24,68,60,107,-1,-2.9
1970,"Portsmouth",2,42,44,46,61,-15,1.04761904761905,1.0952380952381,1.45238095238095,-0.357142857142857,38,16,22,44,38,93,0,-1.2
1970,"Preston North End",3,46,83,63,39,24,1.80434782608696,1.3695652173913,0.847826086956522,0.521739130434783,46,2,24,68,40,121,6,0.4
1970,"Queens Park Rangers",2,42,59,58,53,5,1.4047619047619,1.38095238095238,1.26190476190476,0.119047619047619,33,11,22,44,26,93,7,0.1
1970,"Reading",3,46,53,48,85,-37,1.15217391304348,1.04347826086957,1.84782608695652,-0.804347826086957,63,19,24,68,84,93,-21,1
1970,"Rochdale",3,46,57,61,68,-7,1.23913043478261,1.32608695652174,1.47826086956522,-0.152173913043478,60,16,24,68,62,92,-2,-2.4
1970,"Rotherham United",3,46,67,64,60,4,1.45652173913043,1.39130434782609,1.30434782608696,0.0869565217391304,53,9,24,68,50,88,3,0.8
1970,"Scunthorpe United",4,46,58,56,61,-5,1.26086956521739,1.21739130434783,1.32608695652174,-0.108695652173913,87,19,24,92,72,70,15,0
1970,"Sheffield United",2,42,77,73,39,34,1.83333333333333,1.73809523809524,0.928571428571429,0.80952380952381,24,2,22,44,10,117,14,-3.9
1970,"Sheffield Wednesday",2,42,48,51,69,-18,1.14285714285714,1.21428571428571,1.64285714285714,-0.428571428571429,37,15,22,44,36,117,1,0.7
1970,"Shrewsbury Town",3,46,61,58,62,-4,1.32608695652174,1.26086956521739,1.34782608695652,-0.0869565217391304,56,12,24,68,57,69,-1,1.7
1970,"Southampton",1,42,63,56,44,12,1.5,1.33333333333333,1.04761904761905,0.285714285714286,7,7,22,22,18,93,-11,0.2
1970,"Southend United",4,46,57,53,66,-13,1.23913043478261,1.15217391304348,1.43478260869565,-0.282608695652174,88,20,24,92,70,93,18,1.9
1970,"Southport",4,46,69,63,57,6,1.5,1.3695652173913,1.23913043478261,0.130434782608696,76,8,24,92,75,50,1,NA
1970,"Stockport County",4,46,62,49,65,-16,1.34782608695652,1.06521739130435,1.41304347826087,-0.347826086956522,82,14,24,92,91,99,-9,-0.3
1970,"Stoke City",1,42,49,44,48,-4,1.16666666666667,1.04761904761905,1.14285714285714,-0.0952380952380952,15,15,22,22,17,113,-2,0.4
1970,"Sunderland",2,42,57,52,54,-2,1.35714285714286,1.23809523809524,1.28571428571429,-0.0476190476190476,34,12,22,44,28,119,6,1.6
1970,"Swansea City",3,46,61,59,56,3,1.32608695652174,1.28260869565217,1.21739130434783,0.0652173913043478,57,13,24,68,58,93,-1,3.2
1970,"Swindon Town",2,42,57,61,51,10,1.35714285714286,1.45238095238095,1.21428571428571,0.238095238095238,35,13,22,44,33,93,2,-2.9
1970,"Torquay United",3,46,68,54,57,-3,1.47826086956522,1.17391304347826,1.23913043478261,-0.0652173913043478,52,8,24,68,68,78,-16,-3
1970,"Tottenham Hotspur",1,42,71,54,33,21,1.69047619047619,1.28571428571429,0.785714285714286,0.5,4,4,22,22,6,101,-2,-0.6
1970,"Tranmere Rovers",3,46,52,45,55,-10,1.1304347826087,0.978260869565217,1.19565217391304,-0.217391304347826,65,21,24,68,64,89,1,-2.4
1970,"Walsall",3,46,53,51,57,-6,1.15217391304348,1.10869565217391,1.23913043478261,-0.130434782608696,64,20,24,68,54,100,10,-0.1
1970,"Watford",2,42,43,38,60,-22,1.02380952380952,0.904761904761905,1.42857142857143,-0.523809523809524,40,18,22,44,44,93,-4,0.9
1970,"West Bromwich Albion",1,42,45,58,75,-17,1.07142857142857,1.38095238095238,1.78571428571429,-0.404761904761905,19,19,22,22,15,121,4,1.5
1970,"West Ham United",1,42,44,47,60,-13,1.04761904761905,1.11904761904762,1.42857142857143,-0.30952380952381,20,20,22,22,14,94,6,-0.3
1970,"Wolverhampton Wanderers",1,42,74,64,54,10,1.76190476190476,1.52380952380952,1.28571428571429,0.238095238095238,3,3,22,22,9,121,-6,-1.6
1970,"Workington",4,46,66,48,49,-1,1.43478260869565,1.04347826086957,1.06521739130435,-0.0217391304347826,77,9,24,92,78,26,-1,NA
1970,"Wrexham",3,46,67,72,65,7,1.45652173913043,1.56521739130435,1.41304347826087,0.152173913043478,54,10,24,68,59,80,-5,1.4
1970,"York City",4,46,79,78,54,24,1.71739130434783,1.69565217391304,1.17391304347826,0.521739130434783,73,5,24,92,63,72,10,-1.9
1971,"AFC Bournemouth",3,46,85,73,37,36,1.84782608695652,1.58695652173913,0.804347826086957,0.782608695652174,48,4,24,68,53,90,-5,-2.4
1971,"Aldershot",4,46,49,48,54,-6,1.06521739130435,1.04347826086957,1.17391304347826,-0.130434782608696,88,20,24,92,71,57,17,0.4
1971,"Arsenal",1,42,74,58,40,18,1.76190476190476,1.38095238095238,0.952380952380952,0.428571428571429,5,5,22,22,2,116,3,0.1
1971,"Aston Villa",3,46,102,85,32,53,2.21739130434783,1.84782608695652,0.695652173913043,1.15217391304348,45,1,24,68,25,121,20,3.4
1971,"Barnsley",3,46,45,32,64,-32,0.978260869565217,0.695652173913043,1.39130434782609,-0.695652173913043,65,21,24,68,83,111,-18,3.7
1971,"Barrow",4,46,50,40,71,-31,1.08695652173913,0.869565217391304,1.54347826086957,-0.673913043478261,87,19,24,92,NA,44,NA,NA
1971,"Birmingham City",2,42,75,60,31,29,1.78571428571429,1.42857142857143,0.738095238095238,0.69047619047619,24,2,22,44,10,117,14,0.8
1971,"Blackburn Rovers",3,46,66,54,57,-3,1.43478260869565,1.17391304347826,1.23913043478261,-0.0652173913043478,53,9,24,68,47,121,6,2.1
1971,"Blackpool",2,42,67,70,50,20,1.5952380952381,1.66666666666667,1.19047619047619,0.476190476190476,27,5,22,44,26,112,1,-5.3
1971,"Bolton Wanderers",3,46,67,51,41,10,1.45652173913043,1.10869565217391,0.891304347826087,0.217391304347826,52,8,24,68,45,121,7,1.3
1971,"Bradford City",3,46,43,45,77,-32,0.934782608695652,0.978260869565217,1.67391304347826,-0.695652173913043,67,23,24,68,82,106,-15,-0.3
1971,"Brentford",4,46,83,76,44,32,1.80434782608696,1.65217391304348,0.956521739130435,0.695652173913043,71,3,24,92,66,93,5,1.9
1971,"Brighton & Hove Albion",3,46,92,82,47,35,2,1.78260869565217,1.02173913043478,0.760869565217391,46,2,24,68,44,93,2,3.3
1971,"Bristol City",2,42,64,61,49,12,1.52380952380952,1.45238095238095,1.16666666666667,0.285714285714286,31,9,22,44,29,108,2,-3.6
1971,"Bristol Rovers",3,46,75,75,56,19,1.6304347826087,1.6304347826087,1.21739130434783,0.41304347826087,49,5,24,68,49,92,0,-0.7
1971,"Burnley",2,42,66,70,55,15,1.57142857142857,1.66666666666667,1.30952380952381,0.357142857142857,29,7,22,44,23,121,6,-1.6
1971,"Bury",4,46,69,73,59,14,1.5,1.58695652173913,1.28260869565217,0.304347826086957,74,6,24,92,81,114,-7,-0.3
1971,"Cambridge United",4,46,65,62,60,2,1.41304347826087,1.34782608695652,1.30434782608696,0.0434782608695652,79,11,24,92,73,41,6,4.3
1971,"Cardiff City",2,42,44,56,69,-13,1.04761904761905,1.33333333333333,1.64285714285714,-0.30952380952381,43,21,22,44,42,93,1,0.1
1971,"Carlisle United",2,42,60,61,57,4,1.42857142857143,1.45238095238095,1.35714285714286,0.0952380952380952,32,10,22,44,40,84,-8,-1.4
1971,"Charlton Athletic",2,42,45,55,77,-22,1.07142857142857,1.30952380952381,1.83333333333333,-0.523809523809524,42,20,22,44,54,92,-12,0.7
1971,"Chelsea",1,42,66,58,49,9,1.57142857142857,1.38095238095238,1.16666666666667,0.214285714285714,8,8,22,22,13,104,-5,-2.6
1971,"Chester",4,46,48,47,56,-9,1.04347826086957,1.02173913043478,1.21739130434783,-0.195652173913043,90,22,24,92,84,67,6,2.2
1971,"Chesterfield",3,46,62,57,57,0,1.34782608695652,1.23913043478261,1.23913043478261,0,55,11,24,68,58,100,-3,0
1971,"Colchester United",4,46,67,70,69,1,1.45652173913043,1.52173913043478,1.5,0.0217391304347826,76,8,24,92,90,68,-14,0.2
1971,"Coventry City",1,42,42,44,67,-23,1,1.04761904761905,1.5952380952381,-0.547619047619048,19,19,22,22,18,94,1,0.5
1971,"Crewe Alexandra",4,46,39,43,69,-26,0.847826086956522,0.934782608695652,1.5,-0.565217391304348,92,24,24,92,89,96,3,0
1971,"Crystal Palace",1,42,37,39,65,-26,0.880952380952381,0.928571428571429,1.54761904761905,-0.619047619047619,20,20,22,22,21,93,-1,-1.7
1971,"Darlington",4,46,53,64,82,-18,1.15217391304348,1.39130434782609,1.78260869565217,-0.391304347826087,86,18,24,92,92,81,-6,0.5
1971,"Derby County",1,42,82,69,33,36,1.95238095238095,1.64285714285714,0.785714285714286,0.857142857142857,1,1,22,22,4,121,-3,-3.7
1971,"Doncaster Rovers",4,46,62,56,63,-7,1.34782608695652,1.21739130434783,1.3695652173913,-0.152173913043478,80,12,24,92,85,88,-5,1.7
1971,"Everton",1,42,45,37,48,-11,1.07142857142857,0.880952380952381,1.14285714285714,-0.261904761904762,16,16,22,22,16,121,0,0.8
1971,"Exeter City",4,46,59,61,68,-7,1.28260869565217,1.32608695652174,1.47826086956522,-0.152173913043478,83,15,24,92,76,88,7,2.2
1971,"Fulham",2,42,46,45,68,-23,1.0952380952381,1.07142857142857,1.61904761904762,-0.547619047619048,41,19,22,44,32,102,9,-0.6
1971,"Gillingham",4,46,61,61,67,-6,1.32608695652174,1.32608695652174,1.45652173913043,-0.130434782608696,82,14,24,92,77,88,5,3.3
1971,"Grimsby Town",4,46,91,88,56,32,1.97826086956522,1.91304347826087,1.21739130434783,0.695652173913043,69,1,24,92,52,110,17,2.9
1971,"Halifax Town",3,46,51,48,61,-13,1.10869565217391,1.04347826086957,1.32608695652174,-0.282608695652174,61,17,24,68,63,69,-2,-2.5
1971,"Hartlepool United",4,46,57,58,69,-11,1.23913043478261,1.26086956521739,1.5,-0.239130434782609,85,17,24,92,87,89,-2,0.3
1971,"Huddersfield Town",1,42,31,27,59,-32,0.738095238095238,0.642857142857143,1.4047619047619,-0.761904761904762,22,22,22,22,43,99,-21,-4
1971,"Hull City",2,42,52,49,53,-4,1.23809523809524,1.16666666666667,1.26190476190476,-0.0952380952380952,34,12,22,44,35,104,-1,-4.2
1971,"Ipswich Town",1,42,49,39,53,-14,1.16666666666667,0.928571428571429,1.26190476190476,-0.333333333333333,13,13,22,22,5,75,8,1.1
1971,"Leeds United",1,42,81,73,31,42,1.92857142857143,1.73809523809524,0.738095238095238,1,2,2,22,22,3,93,-1,-1.8
1971,"Leicester City",1,42,52,41,46,-5,1.23809523809524,0.976190476190476,1.0952380952381,-0.119047619047619,12,12,22,22,19,115,-7,-1.8
1971,"Leyton Orient",2,42,51,50,61,-11,1.21428571428571,1.19047619047619,1.45238095238095,-0.261904761904762,35,13,22,44,37,102,-2,-0.9
1971,"Lincoln City",4,46,77,77,59,18,1.67391304347826,1.67391304347826,1.28260869565217,0.391304347826087,73,5,24,92,79,107,-6,2.5
1971,"Liverpool",1,42,81,64,30,34,1.92857142857143,1.52380952380952,0.714285714285714,0.80952380952381,3,3,22,22,1,116,2,0.2
1971,"Luton Town",2,42,48,43,48,-5,1.14285714285714,1.02380952380952,1.14285714285714,-0.119047619047619,39,17,22,44,34,91,5,1.6
1971,"Manchester City",1,42,80,77,45,32,1.9047619047619,1.83333333333333,1.07142857142857,0.761904761904762,4,4,22,22,11,117,-7,-0.5
1971,"Manchester United",1,42,67,69,61,8,1.5952380952381,1.64285714285714,1.45238095238095,0.19047619047619,7,7,22,22,17,117,-10,0.4
1971,"Mansfield Town",3,46,44,41,63,-22,0.956521739130435,0.891304347826087,1.3695652173913,-0.478260869565217,66,22,24,68,74,77,-8,-2.1
1971,"Middlesbrough",2,42,65,50,48,2,1.54761904761905,1.19047619047619,1.14285714285714,0.0476190476190476,30,8,22,44,27,110,3,0.8
1971,"Millwall",2,42,74,64,46,18,1.76190476190476,1.52380952380952,1.0952380952381,0.428571428571429,25,3,22,44,33,93,-8,-2.8
1971,"Newcastle United",1,42,56,49,52,-3,1.33333333333333,1.16666666666667,1.23809523809524,-0.0714285714285714,11,11,22,22,8,116,3,-2
1971,"Newport County",4,46,62,60,72,-12,1.34782608695652,1.30434782608696,1.56521739130435,-0.260869565217391,81,13,24,92,72,67,9,2.1
1971,"Northampton Town",4,46,49,66,79,-13,1.06521739130435,1.43478260869565,1.71739130434783,-0.282608695652174,89,21,24,92,91,93,-2,-0.1
1971,"Norwich City",2,42,78,60,36,24,1.85714285714286,1.42857142857143,0.857142857142857,0.571428571428571,23,1,22,44,20,93,3,-0.2
1971,"Nottingham Forest",1,42,33,47,81,-34,0.785714285714286,1.11904761904762,1.92857142857143,-0.80952380952381,21,21,22,22,36,117,-15,0.9
1971,"Notts County",3,46,87,74,44,30,1.89130434782609,1.60869565217391,0.956521739130435,0.652173913043478,47,3,24,68,46,120,1,3.2
1971,"Oldham Athletic",3,46,62,59,63,-4,1.34782608695652,1.28260869565217,1.3695652173913,-0.0869565217391304,56,12,24,68,50,102,6,2.3
1971,"Oxford United",2,42,50,43,55,-12,1.19047619047619,1.02380952380952,1.30952380952381,-0.285714285714286,37,15,22,44,28,54,9,-1.3
1971,"Peterborough United",4,46,67,82,64,18,1.45652173913043,1.78260869565217,1.39130434782609,0.391304347826087,77,9,24,92,86,60,-9,0.4
1971,"Plymouth Argyle",3,46,70,74,64,10,1.52173913043478,1.60869565217391,1.39130434782609,0.217391304347826,51,7,24,68,51,93,0,-0.3
1971,"Port Vale",3,46,54,43,59,-16,1.17391304347826,0.934782608695652,1.28260869565217,-0.347826086956522,60,16,24,68,48,107,12,-1.5
1971,"Portsmouth",2,42,49,59,68,-9,1.16666666666667,1.4047619047619,1.61904761904762,-0.214285714285714,38,16,22,44,38,93,0,-2
1971,"Preston North End",2,42,48,52,58,-6,1.14285714285714,1.23809523809524,1.38095238095238,-0.142857142857143,40,18,22,44,41,121,-1,-1.9
1971,"Queens Park Rangers",2,42,74,57,28,29,1.76190476190476,1.35714285714286,0.666666666666667,0.69047619047619,26,4,22,44,24,93,2,-0.1
1971,"Reading",4,46,59,56,76,-20,1.28260869565217,1.21739130434783,1.65217391304348,-0.434782608695652,84,16,24,92,75,93,9,2.7
1971,"Rochdale",3,46,49,57,83,-26,1.06521739130435,1.23913043478261,1.80434782608696,-0.565217391304348,62,18,24,68,59,92,3,-2.7
1971,"Rotherham United",3,46,75,69,52,17,1.6304347826087,1.5,1.1304347826087,0.369565217391304,50,6,24,68,62,88,-12,2.1
1971,"Scunthorpe United",4,46,79,56,37,19,1.71739130434783,1.21739130434783,0.804347826086957,0.41304347826087,72,4,24,92,68,70,4,-1.9
1971,"Sheffield United",1,42,63,61,60,1,1.5,1.45238095238095,1.42857142857143,0.0238095238095238,10,10,22,22,12,117,-2,-5.9
1971,"Sheffield Wednesday",2,42,51,51,58,-7,1.21428571428571,1.21428571428571,1.38095238095238,-0.166666666666667,36,14,22,44,31,117,5,1
1971,"Shrewsbury Town",3,46,61,73,65,8,1.32608695652174,1.58695652173913,1.41304347826087,0.173913043478261,57,13,24,68,60,69,-3,1.6
1971,"Southampton",1,42,43,52,80,-28,1.02380952380952,1.23809523809524,1.9047619047619,-0.666666666666667,18,18,22,22,15,93,3,1.1
1971,"Southend United",4,46,84,81,55,26,1.82608695652174,1.76086956521739,1.19565217391304,0.565217391304348,70,2,24,92,55,93,15,1.9
1971,"Southport",4,46,68,66,46,20,1.47826086956522,1.43478260869565,1,0.434782608695652,75,7,24,92,69,50,6,NA
1971,"Stockport County",4,46,41,55,87,-32,0.891304347826087,1.19565217391304,1.89130434782609,-0.695652173913043,91,23,24,92,78,99,13,0.3
1971,"Stoke City",1,42,45,39,56,-17,1.07142857142857,0.928571428571429,1.33333333333333,-0.404761904761905,17,17,22,22,14,113,3,0
1971,"Sunderland",2,42,67,67,57,10,1.5952380952381,1.5952380952381,1.35714285714286,0.238095238095238,28,6,22,44,30,119,-2,1
1971,"Swansea City",3,46,61,46,59,-13,1.32608695652174,1,1.28260869565217,-0.282608695652174,58,14,24,68,67,93,-9,5.2
1971,"Swindon Town",2,42,57,47,47,0,1.35714285714286,1.11904761904762,1.11904761904762,0,33,11,22,44,39,93,-6,-3.3
1971,"Torquay United",3,46,42,41,69,-28,0.91304347826087,0.891304347826087,1.5,-0.608695652173913,68,24,24,68,88,78,-20,-1.5
1971,"Tottenham Hotspur",1,42,70,63,42,21,1.66666666666667,1.5,1,0.5,6,6,22,22,9,101,-3,0.1
1971,"Tranmere Rovers",3,46,46,50,71,-21,1,1.08695652173913,1.54347826086957,-0.456521739130435,64,20,24,68,56,89,8,-1.5
1971,"Walsall",3,46,63,62,57,5,1.3695652173913,1.34782608695652,1.23913043478261,0.108695652173913,54,10,24,68,57,100,-3,-1
1971,"Watford",2,42,24,24,75,-51,0.571428571428571,0.571428571428571,1.78571428571429,-1.21428571428571,44,22,22,44,65,93,-21,2
1971,"West Bromwich Albion",1,42,47,42,54,-12,1.11904761904762,1,1.28571428571429,-0.285714285714286,15,15,22,22,22,121,-7,-0.4
1971,"West Ham United",1,42,48,47,51,-4,1.14285714285714,1.11904761904762,1.21428571428571,-0.0952380952380952,14,14,22,22,7,94,7,0.4
1971,"Wolverhampton Wanderers",1,42,65,65,57,8,1.54761904761905,1.54761904761905,1.35714285714286,0.19047619047619,9,9,22,22,6,121,3,-1.2
1971,"Workington",4,46,67,50,34,16,1.45652173913043,1.08695652173913,0.739130434782609,0.347826086956522,78,10,24,92,80,26,-2,NA
1971,"Wrexham",3,46,56,59,63,-4,1.21739130434783,1.28260869565217,1.3695652173913,-0.0869565217391304,59,15,24,68,61,80,-2,1.6
1971,"York City",3,46,48,57,66,-9,1.04347826086957,1.23913043478261,1.43478260869565,-0.195652173913043,63,19,24,68,64,72,-1,-2.2
1972,"AFC Bournemouth",3,46,67,66,44,22,1.45652173913043,1.43478260869565,0.956521739130435,0.478260869565217,53,9,24,68,56,90,-3,-0.3
1972,"Aldershot",4,46,78,60,38,22,1.69565217391304,1.30434782608696,0.826086956521739,0.478260869565217,71,3,24,92,52,57,19,-1.5
1972,"Arsenal",1,42,80,57,43,14,1.9047619047619,1.35714285714286,1.02380952380952,0.333333333333333,2,2,22,22,8,116,-6,-0.7
1972,"Aston Villa",2,42,68,51,47,4,1.61904761904762,1.21428571428571,1.11904761904762,0.0952380952380952,25,3,22,44,36,121,-11,1.9
1972,"Barnsley",4,46,58,58,60,-2,1.26086956521739,1.26086956521739,1.30434782608696,-0.0434782608695652,83,15,24,92,79,111,4,5.1
1972,"Birmingham City",1,42,57,53,54,-1,1.35714285714286,1.26190476190476,1.28571428571429,-0.0238095238095238,10,10,22,22,17,117,-7,-0.6
1972,"Blackburn Rovers",3,46,75,57,47,10,1.6304347826087,1.23913043478261,1.02173913043478,0.217391304347826,47,3,24,68,54,121,-7,1.4
1972,"Blackpool",2,42,64,56,51,5,1.52380952380952,1.33333333333333,1.21428571428571,0.119047619047619,26,4,22,44,27,112,-1,-6.1
1972,"Bolton Wanderers",3,46,86,73,39,34,1.8695652173913,1.58695652173913,0.847826086956522,0.739130434782609,45,1,24,68,33,121,12,0.2
1972,"Bradford City",4,46,59,61,65,-4,1.28260869565217,1.32608695652174,1.41304347826087,-0.0869565217391304,82,14,24,92,76,106,6,2.5
1972,"Brentford",3,46,52,51,69,-18,1.1304347826087,1.10869565217391,1.5,-0.391304347826087,66,22,24,68,87,93,-21,1.3
1972,"Brighton & Hove Albion",2,42,37,46,83,-37,0.880952380952381,1.0952380952381,1.97619047619048,-0.880952380952381,44,22,22,44,62,93,-18,2.2
1972,"Bristol City",2,42,63,63,51,12,1.5,1.5,1.21428571428571,0.285714285714286,29,7,22,44,38,108,-9,-5.2
1972,"Bristol Rovers",3,46,73,77,56,21,1.58695652173913,1.67391304347826,1.21739130434783,0.456521739130435,49,5,24,68,46,92,3,-0.2
1972,"Burnley",2,42,86,72,35,37,2.04761904761905,1.71428571428571,0.833333333333333,0.880952380952381,23,1,22,44,5,121,18,-2.1
1972,"Bury",4,46,60,58,51,7,1.30434782608696,1.26086956521739,1.10869565217391,0.152173913043478,81,13,24,92,72,114,9,0.8
1972,"Cambridge United",4,46,77,67,57,10,1.67391304347826,1.45652173913043,1.23913043478261,0.217391304347826,73,5,24,92,65,41,8,3.9
1972,"Cardiff City",2,42,44,43,58,-15,1.04761904761905,1.02380952380952,1.38095238095238,-0.357142857142857,42,20,22,44,40,93,2,-0.4
1972,"Carlisle United",2,42,45,50,52,-2,1.07142857142857,1.19047619047619,1.23809523809524,-0.0476190476190476,40,18,22,44,24,84,16,0.4
1972,"Charlton Athletic",3,46,62,69,67,2,1.34782608695652,1.5,1.45652173913043,0.0434782608695652,54,10,24,68,53,92,1,1.7
1972,"Chelsea",1,42,53,49,51,-2,1.26190476190476,1.16666666666667,1.21428571428571,-0.0476190476190476,13,13,22,22,18,104,-5,-2.7
1972,"Chester",4,46,57,61,52,9,1.23913043478261,1.32608695652174,1.1304347826087,0.195652173913043,84,16,24,92,75,67,9,0.2
1972,"Chesterfield",3,46,60,57,61,-4,1.30434782608696,1.23913043478261,1.32608695652174,-0.0869565217391304,58,14,24,68,49,100,9,-1
1972,"Colchester United",4,46,41,48,76,-28,0.891304347826087,1.04347826086957,1.65217391304348,-0.608695652173913,90,22,24,92,71,68,19,1.6
1972,"Coventry City",1,42,48,40,55,-15,1.14285714285714,0.952380952380952,1.30952380952381,-0.357142857142857,18,18,22,22,15,94,3,-0.1
1972,"Crewe Alexandra",4,46,45,38,61,-23,0.978260869565217,0.826086956521739,1.32608695652174,-0.5,89,21,24,92,88,96,1,-0.2
1972,"Crystal Palace",1,42,39,41,58,-17,0.928571428571429,0.976190476190476,1.38095238095238,-0.404761904761905,21,21,22,22,42,93,-21,-1.7
1972,"Darlington",4,46,36,42,85,-43,0.782608695652174,0.91304347826087,1.84782608695652,-0.934782608695652,92,24,24,92,89,81,3,0.7
1972,"Derby County",1,42,65,56,54,2,1.54761904761905,1.33333333333333,1.28571428571429,0.0476190476190476,4,4,22,22,3,121,1,-3.1
1972,"Doncaster Rovers",4,46,57,49,58,-9,1.23913043478261,1.06521739130435,1.26086956521739,-0.195652173913043,85,17,24,92,90,88,-5,1.8
1972,"Everton",1,42,50,41,49,-8,1.19047619047619,0.976190476190476,1.16666666666667,-0.19047619047619,16,16,22,22,7,121,9,0.9
1972,"Exeter City",4,46,68,57,51,6,1.47826086956522,1.23913043478261,1.10869565217391,0.130434782608696,76,8,24,92,77,88,-1,1.4
1972,"Fulham",2,42,60,58,49,9,1.42857142857143,1.38095238095238,1.16666666666667,0.214285714285714,32,10,22,44,30,102,2,0.6
1972,"Gillingham",4,46,68,63,58,5,1.47826086956522,1.3695652173913,1.26086956521739,0.108695652173913,77,9,24,92,70,88,7,1.9
1972,"Grimsby Town",3,46,68,67,61,6,1.47826086956522,1.45652173913043,1.32608695652174,0.130434782608696,52,8,24,68,50,110,2,1.1
1972,"Halifax Town",3,46,54,43,53,-10,1.17391304347826,0.934782608695652,1.15217391304348,-0.217391304347826,63,19,24,68,57,69,6,-1.6
1972,"Hartlepool United",4,46,53,34,49,-15,1.15217391304348,0.739130434782609,1.06521739130435,-0.326086956521739,87,19,24,92,80,89,7,-0.3
1972,"Hereford United",4,46,81,56,38,18,1.76086956521739,1.21739130434783,0.826086956521739,0.391304347826087,70,2,24,92,63,31,7,-2.2
1972,"Huddersfield Town",2,42,41,36,56,-20,0.976190476190476,0.857142857142857,1.33333333333333,-0.476190476190476,43,21,22,44,55,99,-12,-0.4
1972,"Hull City",2,42,54,64,59,5,1.28571428571429,1.52380952380952,1.4047619047619,0.119047619047619,35,13,22,44,34,104,1,-3.5
1972,"Ipswich Town",1,42,65,55,45,10,1.54761904761905,1.30952380952381,1.07142857142857,0.238095238095238,5,5,22,22,4,75,1,-0.5
1972,"Leeds United",1,42,74,71,45,26,1.76190476190476,1.69047619047619,1.07142857142857,0.619047619047619,3,3,22,22,1,93,2,-2.7
1972,"Leicester City",1,42,47,40,46,-6,1.11904761904762,0.952380952380952,1.0952380952381,-0.142857142857143,19,19,22,22,11,115,8,-0.6
1972,"Leyton Orient",2,42,48,49,53,-4,1.14285714285714,1.16666666666667,1.26190476190476,-0.0952380952380952,37,15,22,44,28,102,9,-2.6
1972,"Lincoln City",4,46,64,64,57,7,1.39130434782609,1.39130434782609,1.23913043478261,0.152173913043478,79,11,24,92,81,107,-2,2.9
1972,"Liverpool",1,42,85,72,42,30,2.02380952380952,1.71428571428571,1,0.714285714285714,1,1,22,22,2,116,-1,0
1972,"Luton Town",2,42,56,44,53,-9,1.33333333333333,1.04761904761905,1.26190476190476,-0.214285714285714,34,12,22,44,25,91,9,1.6
1972,"Manchester City",1,42,56,57,60,-3,1.33333333333333,1.35714285714286,1.42857142857143,-0.0714285714285714,11,11,22,22,12,117,-1,-0.9
1972,"Manchester United",1,42,49,44,60,-16,1.16666666666667,1.04761904761905,1.42857142857143,-0.380952380952381,17,17,22,22,21,117,-4,1.4
1972,"Mansfield Town",4,46,74,78,51,27,1.60869565217391,1.69565217391304,1.10869565217391,0.58695652173913,74,6,24,92,84,77,-10,-0.4
1972,"Middlesbrough",2,42,64,46,43,3,1.52380952380952,1.0952380952381,1.02380952380952,0.0714285714285714,27,5,22,44,23,110,4,-1.2
1972,"Millwall",2,42,58,55,47,8,1.38095238095238,1.30952380952381,1.11904761904762,0.19047619047619,33,11,22,44,35,93,-2,-2.8
1972,"Newcastle United",1,42,61,60,51,9,1.45238095238095,1.42857142857143,1.21428571428571,0.214285714285714,8,8,22,22,16,116,-8,-1.9
1972,"Newport County",4,46,78,64,44,20,1.69565217391304,1.39130434782609,0.956521739130435,0.434782608695652,72,4,24,92,78,67,-6,2.4
1972,"Northampton Town",4,46,41,40,73,-33,0.891304347826087,0.869565217391304,1.58695652173913,-0.717391304347826,91,23,24,92,73,93,18,0.8
1972,"Norwich City",1,42,43,36,63,-27,1.02380952380952,0.857142857142857,1.5,-0.642857142857143,20,20,22,22,22,93,-2,0.6
1972,"Nottingham Forest",2,42,54,47,52,-5,1.28571428571429,1.11904761904762,1.23809523809524,-0.119047619047619,36,14,22,44,29,117,7,3.2
1972,"Notts County",3,46,80,67,47,20,1.73913043478261,1.45652173913043,1.02173913043478,0.434782608695652,46,2,24,68,31,120,15,3.1
1972,"Oldham Athletic",3,46,73,72,54,18,1.58695652173913,1.56521739130435,1.17391304347826,0.391304347826087,50,6,24,68,45,102,5,2.1
1972,"Oxford United",2,42,64,52,43,9,1.52380952380952,1.23809523809524,1.02380952380952,0.214285714285714,28,6,22,44,41,54,-13,-2.1
1972,"Peterborough United",4,46,55,71,76,-5,1.19565217391304,1.54347826086957,1.65217391304348,-0.108695652173913,86,18,24,92,69,60,17,0.9
1972,"Plymouth Argyle",3,46,70,74,66,8,1.52173913043478,1.60869565217391,1.43478260869565,0.173913043478261,51,7,24,68,59,93,-8,-0.1
1972,"Port Vale",3,46,74,56,69,-13,1.60869565217391,1.21739130434783,1.5,-0.282608695652174,48,4,24,68,64,107,-16,-2.3
1972,"Portsmouth",2,42,47,42,59,-17,1.11904761904762,1,1.4047619047619,-0.404761904761905,38,16,22,44,37,93,1,-0.7
1972,"Preston North End",2,42,45,37,64,-27,1.07142857142857,0.880952380952381,1.52380952380952,-0.642857142857143,41,19,22,44,43,121,-2,-1.9
1972,"Queens Park Rangers",2,42,85,81,37,44,2.02380952380952,1.92857142857143,0.880952380952381,1.04761904761905,24,2,22,44,9,93,15,0.1
1972,"Reading",4,46,69,51,38,13,1.5,1.10869565217391,0.826086956521739,0.282608695652174,75,7,24,92,74,93,1,1
1972,"Rochdale",3,46,59,48,54,-6,1.28260869565217,1.04347826086957,1.17391304347826,-0.130434782608696,59,15,24,68,68,92,-9,-3
1972,"Rotherham United",3,46,58,51,65,-14,1.26086956521739,1.10869565217391,1.41304347826087,-0.304347826086957,62,18,24,68,83,88,-21,2
1972,"Scunthorpe United",3,46,40,33,72,-39,0.869565217391304,0.717391304347826,1.56521739130435,-0.847826086956522,68,24,24,68,86,70,-18,-0.4
1972,"Sheffield United",1,42,55,51,59,-8,1.30952380952381,1.21428571428571,1.4047619047619,-0.19047619047619,12,12,22,22,13,117,-1,-4.2
1972,"Sheffield Wednesday",2,42,61,59,55,4,1.45238095238095,1.4047619047619,1.30952380952381,0.0952380952380952,31,9,22,44,39,117,-8,0.3
1972,"Shrewsbury Town",3,46,59,46,54,-8,1.28260869565217,1,1.17391304347826,-0.173913043478261,60,16,24,68,66,69,-6,2.9
1972,"Southampton",1,42,51,47,52,-5,1.21428571428571,1.11904761904762,1.23809523809524,-0.119047619047619,15,15,22,22,20,93,-5,0.4
1972,"Southend United",3,46,61,61,54,7,1.32608695652174,1.32608695652174,1.17391304347826,0.152173913043478,55,11,24,68,58,93,-3,-0.4
1972,"Southport",4,46,88,71,48,23,1.91304347826087,1.54347826086957,1.04347826086957,0.5,69,1,24,92,67,50,2,NA
1972,"Stockport County",4,46,66,53,53,0,1.43478260869565,1.15217391304348,1.15217391304348,0,78,10,24,92,92,99,-14,-0.6
1972,"Stoke City",1,42,52,61,56,5,1.23809523809524,1.45238095238095,1.33333333333333,0.119047619047619,14,14,22,22,6,113,8,0.2
1972,"Sunderland",2,42,63,59,49,10,1.5,1.4047619047619,1.16666666666667,0.238095238095238,30,8,22,44,26,119,4,1.3
1972,"Swansea City",3,46,51,51,73,-22,1.10869565217391,1.10869565217391,1.58695652173913,-0.478260869565217,67,23,24,68,82,93,-15,4.6
1972,"Swindon Town",2,42,46,46,60,-14,1.0952380952381,1.0952380952381,1.42857142857143,-0.333333333333333,39,17,22,44,44,93,-5,-3.7
1972,"Torquay United",4,46,53,44,47,-3,1.15217391304348,0.956521739130435,1.02173913043478,-0.0652173913043478,88,20,24,92,85,78,3,0.8
1972,"Tottenham Hotspur",1,42,61,58,48,10,1.45238095238095,1.38095238095238,1.14285714285714,0.238095238095238,9,9,22,22,10,101,-1,0.4
1972,"Tranmere Rovers",3,46,61,56,52,4,1.32608695652174,1.21739130434783,1.1304347826087,0.0869565217391304,56,12,24,68,61,89,-5,-3.2
1972,"Walsall",3,46,61,56,66,-10,1.32608695652174,1.21739130434783,1.43478260869565,-0.217391304347826,57,13,24,68,60,100,-3,0.2
1972,"Watford",3,46,53,43,48,-5,1.15217391304348,0.934782608695652,1.04347826086957,-0.108695652173913,65,21,24,68,51,93,14,6.3
1972,"West Bromwich Albion",1,42,37,38,62,-24,0.880952380952381,0.904761904761905,1.47619047619048,-0.571428571428571,22,22,22,22,32,121,-10,0.9
1972,"West Ham United",1,42,63,67,53,14,1.5,1.5952380952381,1.26190476190476,0.333333333333333,7,7,22,22,19,94,-12,-0.1
1972,"Wolverhampton Wanderers",1,42,65,66,54,12,1.54761904761905,1.57142857142857,1.28571428571429,0.285714285714286,6,6,22,22,14,121,-8,-1.8
1972,"Workington",4,46,63,59,61,-2,1.3695652173913,1.28260869565217,1.32608695652174,-0.0434782608695652,80,12,24,92,91,26,-11,NA
1972,"Wrexham",3,46,59,55,54,1,1.28260869565217,1.19565217391304,1.17391304347826,0.0217391304347826,61,17,24,68,48,80,13,-0.5
1972,"York City",3,46,54,42,46,-4,1.17391304347826,0.91304347826087,1,-0.0869565217391304,64,20,24,68,47,72,17,-1.1
1973,"AFC Bournemouth",3,46,63,54,58,-4,1.3695652173913,1.17391304347826,1.26086956521739,-0.0869565217391304,56,12,24,68,65,90,-9,-0.5
1973,"Aldershot",3,46,68,65,52,13,1.47826086956522,1.41304347826087,1.1304347826087,0.282608695652174,52,8,24,68,64,57,-12,-2.1
1973,"Arsenal",1,42,56,49,51,-2,1.33333333333333,1.16666666666667,1.21428571428571,-0.0476190476190476,8,8,22,22,17,116,-9,0.2
1973,"Aston Villa",2,42,54,48,45,3,1.28571428571429,1.14285714285714,1.07142857142857,0.0714285714285714,36,14,22,44,24,121,12,2.7
1973,"Barnsley",4,46,61,58,64,-6,1.32608695652174,1.26086956521739,1.39130434782609,-0.130434782608696,79,11,24,92,82,111,-3,4.3
1973,"Birmingham City",1,42,49,52,64,-12,1.16666666666667,1.23809523809524,1.52380952380952,-0.285714285714286,17,17,22,22,15,117,2,-0.3
1973,"Blackburn Rovers",3,46,64,62,64,-2,1.39130434782609,1.34782608695652,1.39130434782609,-0.0434782608695652,54,10,24,68,46,121,8,2.6
1973,"Blackpool",2,42,64,57,40,17,1.52380952380952,1.35714285714286,0.952380952380952,0.404761904761905,27,5,22,44,29,112,-2,-4.7
1973,"Bolton Wanderers",2,42,57,44,40,4,1.35714285714286,1.04761904761905,0.952380952380952,0.0952380952380952,33,11,22,44,31,121,2,-2.1
1973,"Bradford City",4,46,65,58,52,6,1.41304347826087,1.26086956521739,1.1304347826087,0.130434782608696,76,8,24,92,79,106,-3,2.5
1973,"Brentford",4,46,52,48,50,-2,1.1304347826087,1.04347826086957,1.08695652173913,-0.0434782608695652,87,19,24,92,77,93,10,2.3
1973,"Brighton & Hove Albion",3,46,59,52,58,-6,1.28260869565217,1.1304347826087,1.26086956521739,-0.130434782608696,62,18,24,68,60,93,2,3.1
1973,"Bristol City",2,42,52,47,54,-7,1.23809523809524,1.11904761904762,1.28571428571429,-0.166666666666667,38,16,22,44,26,108,12,-3.3
1973,"Bristol Rovers",3,46,83,65,33,32,1.80434782608696,1.41304347826087,0.717391304347826,0.695652173913043,46,2,24,68,40,92,6,-0.3
1973,"Burnley",1,42,62,56,53,3,1.47619047619048,1.33333333333333,1.26190476190476,0.0714285714285714,5,5,22,22,9,121,-4,-5.1
1973,"Bury",4,46,83,81,49,32,1.80434782608696,1.76086956521739,1.06521739130435,0.695652173913043,72,4,24,92,57,114,15,-1
1973,"Cambridge United",3,46,48,48,81,-33,1.04347826086957,1.04347826086957,1.76086956521739,-0.717391304347826,65,21,24,68,74,41,-9,2.1
1973,"Cardiff City",2,42,46,49,62,-13,1.0952380952381,1.16666666666667,1.47619047619048,-0.30952380952381,40,18,22,44,43,93,-3,0.3
1973,"Carlisle United",2,42,69,61,48,13,1.64285714285714,1.45238095238095,1.14285714285714,0.30952380952381,24,2,22,44,22,84,2,-0.5
1973,"Charlton Athletic",3,46,65,66,73,-7,1.41304347826087,1.43478260869565,1.58695652173913,-0.152173913043478,53,9,24,68,47,92,6,2
1973,"Chelsea",1,42,49,56,60,-4,1.16666666666667,1.33333333333333,1.42857142857143,-0.0952380952380952,18,18,22,22,21,104,-3,-0.5
1973,"Chester",4,46,66,54,55,-1,1.43478260869565,1.17391304347826,1.19565217391304,-0.0217391304347826,75,7,24,92,72,67,3,-1.7
1973,"Chesterfield",3,46,77,55,42,13,1.67391304347826,1.19565217391304,0.91304347826087,0.282608695652174,49,5,24,68,58,100,-9,-3.2
1973,"Colchester United",4,46,84,73,36,37,1.82608695652174,1.58695652173913,0.782608695652174,0.804347826086957,71,3,24,92,55,68,16,-0.5
1973,"Coventry City",1,42,52,43,54,-11,1.23809523809524,1.02380952380952,1.28571428571429,-0.261904761904762,15,15,22,22,16,94,-1,-0.3
1973,"Crewe Alexandra",4,46,52,43,71,-28,1.1304347826087,0.934782608695652,1.54347826086957,-0.608695652173913,88,20,24,92,87,96,1,0.5
1973,"Crystal Palace",2,42,45,43,56,-13,1.07142857142857,1.02380952380952,1.33333333333333,-0.30952380952381,42,20,22,44,49,93,-7,0.2
1973,"Darlington",4,46,52,40,62,-22,1.1304347826087,0.869565217391304,1.34782608695652,-0.478260869565217,89,21,24,92,90,81,-1,0.5
1973,"Derby County",1,42,65,52,42,10,1.54761904761905,1.23809523809524,1,0.238095238095238,3,3,22,22,1,121,2,-3.9
1973,"Doncaster Rovers",4,46,47,47,80,-33,1.02173913043478,1.02173913043478,1.73913043478261,-0.717391304347826,90,22,24,92,85,88,5,2
1973,"Everton",1,42,60,50,48,2,1.42857142857143,1.19047619047619,1.14285714285714,0.0476190476190476,7,7,22,22,5,121,2,0
1973,"Exeter City",4,45,62,58,55,3,1.37777777777778,1.28888888888889,1.22222222222222,0.0666666666666667,77,9,24,92,76,88,1,0.9
1973,"Fulham",2,42,58,39,43,-4,1.38095238095238,0.928571428571429,1.02380952380952,-0.0952380952380952,30,8,22,44,34,102,-4,-0.4
1973,"Gillingham",4,46,87,90,49,41,1.89130434782609,1.95652173913043,1.06521739130435,0.891304347826087,70,2,24,92,54,88,16,1.8
1973,"Grimsby Town",3,46,69,67,50,17,1.5,1.45652173913043,1.08695652173913,0.369565217391304,50,6,24,68,61,110,-11,2.4
1973,"Halifax Town",3,46,63,48,51,-3,1.3695652173913,1.04347826086957,1.10869565217391,-0.0652173913043478,57,13,24,68,62,69,-5,-3.1
1973,"Hartlepool United",4,46,60,48,47,1,1.30434782608696,1.04347826086957,1.02173913043478,0.0217391304347826,80,12,24,92,81,89,-1,-1.1
1973,"Hereford United",3,46,57,53,57,-4,1.23913043478261,1.15217391304348,1.23913043478261,-0.0869565217391304,63,19,24,68,56,31,7,-1.6
1973,"Huddersfield Town",3,46,64,56,55,1,1.39130434782609,1.21739130434783,1.19565217391304,0.0217391304347826,55,11,24,68,68,99,-13,2
1973,"Hull City",2,42,56,46,47,-1,1.33333333333333,1.0952380952381,1.11904761904762,-0.0238095238095238,34,12,22,44,30,104,4,-1.3
1973,"Ipswich Town",1,42,65,67,58,9,1.54761904761905,1.5952380952381,1.38095238095238,0.214285714285714,4,4,22,22,2,75,2,-0.8
1973,"Leeds United",1,42,86,66,31,35,2.04761904761905,1.57142857142857,0.738095238095238,0.833333333333333,1,1,22,22,10,93,-9,-3.1
1973,"Leicester City",1,42,55,51,41,10,1.30952380952381,1.21428571428571,0.976190476190476,0.238095238095238,11,11,22,22,18,115,-7,-0.3
1973,"Leyton Orient",2,42,63,55,42,13,1.5,1.30952380952381,1,0.30952380952381,28,6,22,44,35,102,-7,-2.7
1973,"Lincoln City",4,46,60,63,67,-4,1.30434782608696,1.3695652173913,1.45652173913043,-0.0869565217391304,81,13,24,92,73,107,8,2.3
1973,"Liverpool",1,42,79,52,31,21,1.88095238095238,1.23809523809524,0.738095238095238,0.5,2,2,22,22,3,116,-1,0.1
1973,"Luton Town",2,42,69,64,51,13,1.64285714285714,1.52380952380952,1.21428571428571,0.30952380952381,25,3,22,44,20,91,5,1
1973,"Manchester City",1,42,54,39,46,-7,1.28571428571429,0.928571428571429,1.0952380952381,-0.166666666666667,12,12,22,22,8,117,4,-1.5
1973,"Manchester United",1,42,42,38,48,-10,1,0.904761904761905,1.14285714285714,-0.238095238095238,21,21,22,22,23,117,-2,1.8
1973,"Mansfield Town",4,46,56,62,69,-7,1.21739130434783,1.34782608695652,1.5,-0.152173913043478,84,16,24,92,69,77,15,-0.3
1973,"Middlesbrough",2,42,92,77,30,47,2.19047619047619,1.83333333333333,0.714285714285714,1.11904761904762,23,1,22,44,6,110,17,-1.5
1973,"Millwall",2,42,56,51,51,0,1.33333333333333,1.21428571428571,1.21428571428571,0,35,13,22,44,42,93,-7,-1.8
1973,"Newcastle United",1,42,51,49,48,1,1.21428571428571,1.16666666666667,1.14285714285714,0.0238095238095238,16,16,22,22,12,116,4,-0.9
1973,"Newport County",4,46,62,56,65,-9,1.34782608695652,1.21739130434783,1.41304347826087,-0.195652173913043,78,10,24,92,78,67,0,2.1
1973,"Northampton Town",4,46,73,63,48,15,1.58695652173913,1.3695652173913,1.04347826086957,0.326086956521739,73,5,24,92,83,93,-10,-1.3
1973,"Norwich City",1,42,36,37,62,-25,0.857142857142857,0.880952380952381,1.47619047619048,-0.595238095238095,22,22,22,22,25,93,-3,0.6
1973,"Nottingham Forest",2,42,60,57,43,14,1.42857142857143,1.35714285714286,1.02380952380952,0.333333333333333,29,7,22,44,38,117,-9,2.5
1973,"Notts County",2,42,58,55,60,-5,1.38095238095238,1.30952380952381,1.42857142857143,-0.119047619047619,31,9,22,44,36,120,-5,1
1973,"Oldham Athletic",3,46,87,83,47,36,1.89130434782609,1.80434782608696,1.02173913043478,0.782608695652174,45,1,24,68,41,102,4,0.4
1973,"Oxford United",2,42,46,35,46,-11,1.0952380952381,0.833333333333333,1.0952380952381,-0.261904761904762,41,19,22,44,32,54,9,-0.4
1973,"Peterborough United",4,46,92,75,38,37,2,1.6304347826087,0.826086956521739,0.804347826086957,69,1,24,92,50,60,19,-0.6
1973,"Plymouth Argyle",3,46,61,59,54,5,1.32608695652174,1.28260869565217,1.17391304347826,0.108695652173913,59,15,24,68,45,93,14,-0.4
1973,"Port Vale",3,46,56,52,58,-6,1.21739130434783,1.1304347826087,1.26086956521739,-0.130434782608696,64,20,24,68,51,107,13,-0.3
1973,"Portsmouth",2,42,54,45,62,-17,1.28571428571429,1.07142857142857,1.47619047619048,-0.404761904761905,37,15,22,44,39,93,-2,-0.2
1973,"Preston North End",2,42,41,40,62,-22,0.976190476190476,0.952380952380952,1.47619047619048,-0.523809523809524,43,21,22,44,52,121,-9,-1.7
1973,"Queens Park Rangers",1,42,56,56,52,4,1.33333333333333,1.33333333333333,1.23809523809524,0.0952380952380952,9,9,22,22,11,93,-2,0.4
1973,"Reading",4,46,67,58,37,21,1.45652173913043,1.26086956521739,0.804347826086957,0.456521739130435,74,6,24,92,75,93,-1,0.2
1973,"Rochdale",3,46,23,38,94,-56,0.5,0.826086956521739,2.04347826086957,-1.21739130434783,68,24,24,68,86,92,-18,-2.2
1973,"Rotherham United",4,46,58,56,58,-2,1.26086956521739,1.21739130434783,1.26086956521739,-0.0434782608695652,83,15,24,92,71,88,12,2.1
1973,"Scunthorpe United",4,45,54,47,64,-17,1.2,1.04444444444444,1.42222222222222,-0.377777777777778,86,18,24,92,92,70,-6,2.1
1973,"Sheffield United",1,42,54,44,49,-5,1.28571428571429,1.04761904761905,1.16666666666667,-0.119047619047619,13,13,22,22,4,117,9,-3.5
1973,"Sheffield Wednesday",2,42,47,51,63,-12,1.11904761904762,1.21428571428571,1.5,-0.285714285714286,39,17,22,44,44,117,-5,1.5
1973,"Shrewsbury Town",3,46,41,41,62,-21,0.891304347826087,0.891304347826087,1.34782608695652,-0.456521739130435,66,22,24,68,70,69,-4,3.6
1973,"Southampton",1,42,47,47,68,-21,1.11904761904762,1.11904761904762,1.61904761904762,-0.5,20,20,22,22,33,93,-13,1.8
1973,"Southend United",3,46,62,62,62,0,1.34782608695652,1.34782608695652,1.34782608695652,0,58,14,24,68,63,93,-5,-0.8
1973,"Southport",3,46,34,35,82,-47,0.739130434782609,0.760869565217391,1.78260869565217,-1.02173913043478,67,23,24,68,80,50,-13,NA
1973,"Stockport County",4,46,41,44,69,-25,0.891304347826087,0.956521739130435,1.5,-0.543478260869565,92,24,24,92,89,99,3,1.2
1973,"Stoke City",1,42,61,54,42,12,1.45238095238095,1.28571428571429,1,0.285714285714286,6,6,22,22,7,113,-1,-1.3
1973,"Sunderland",2,42,66,58,44,14,1.57142857142857,1.38095238095238,1.04761904761905,0.333333333333333,26,4,22,44,27,119,-1,1.3
1973,"Swansea City",4,46,59,45,46,-1,1.28260869565217,0.978260869565217,1,-0.0217391304347826,82,14,24,92,88,93,-6,3.9
1973,"Swindon Town",2,42,32,36,72,-36,0.761904761904762,0.857142857142857,1.71428571428571,-0.857142857142857,44,22,22,44,48,93,-4,-4.1
1973,"Torquay United",4,46,56,52,57,-5,1.21739130434783,1.1304347826087,1.23913043478261,-0.108695652173913,85,17,24,92,84,78,1,0.8
1973,"Tottenham Hotspur",1,42,56,45,50,-5,1.33333333333333,1.07142857142857,1.19047619047619,-0.119047619047619,10,10,22,22,19,101,-9,0.2
1973,"Tranmere Rovers",3,46,60,50,44,6,1.30434782608696,1.08695652173913,0.956521739130435,0.130434782608696,61,17,24,68,66,89,-5,-1.7
1973,"Walsall",3,46,61,57,48,9,1.32608695652174,1.23913043478261,1.04347826086957,0.195652173913043,60,16,24,68,53,100,7,1
1973,"Watford",3,46,69,64,56,8,1.5,1.39130434782609,1.21739130434783,0.173913043478261,51,7,24,68,67,93,-16,4
1973,"West Bromwich Albion",2,42,58,48,45,3,1.38095238095238,1.14285714285714,1.07142857142857,0.0714285714285714,32,10,22,44,28,121,4,1.5
1973,"West Ham United",1,42,48,55,60,-5,1.14285714285714,1.30952380952381,1.42857142857143,-0.119047619047619,19,19,22,22,14,94,5,0.9
1973,"Wolverhampton Wanderers",1,42,54,49,49,0,1.28571428571429,1.16666666666667,1.16666666666667,0,14,14,22,22,13,121,1,-0.8
1973,"Workington",4,46,46,43,74,-31,1,0.934782608695652,1.60869565217391,-0.673913043478261,91,23,24,92,91,26,0,NA
1973,"Wrexham",3,46,78,63,43,20,1.69565217391304,1.3695652173913,0.934782608695652,0.434782608695652,48,4,24,68,59,80,-11,-4.1
1973,"York City",3,46,82,67,38,29,1.78260869565217,1.45652173913043,0.826086956521739,0.630434782608696,47,3,24,68,37,72,10,-2.2
1974,"AFC Bournemouth",3,46,51,44,58,-14,1.10869565217391,0.956521739130435,1.26086956521739,-0.304347826086957,65,21,24,68,74,90,-9,1.1
1974,"Aldershot",3,46,53,53,63,-10,1.15217391304348,1.15217391304348,1.3695652173913,-0.217391304347826,64,20,24,68,64,57,0,-1.7
1974,"Arsenal",1,42,50,47,49,-2,1.19047619047619,1.11904761904762,1.16666666666667,-0.0476190476190476,17,17,22,22,17,116,0,1.1
1974,"Aston Villa",2,42,83,79,32,47,1.97619047619048,1.88095238095238,0.761904761904762,1.11904761904762,24,2,22,44,16,121,8,1.4
1974,"Barnsley",4,46,56,62,65,-3,1.21739130434783,1.34782608695652,1.41304347826087,-0.0652173913043478,82,14,24,92,80,111,2,4.9
1974,"Birmingham City",1,42,51,53,61,-8,1.21428571428571,1.26190476190476,1.45238095238095,-0.19047619047619,15,15,22,22,19,117,-4,-0.9
1974,"Blackburn Rovers",3,46,82,68,45,23,1.78260869565217,1.47826086956522,0.978260869565217,0.5,46,2,24,68,39,121,7,1.9
1974,"Blackpool",2,42,59,38,33,5,1.4047619047619,0.904761904761905,0.785714285714286,0.119047619047619,29,7,22,44,32,112,-3,-4.1
1974,"Bolton Wanderers",2,42,57,45,41,4,1.35714285714286,1.07142857142857,0.976190476190476,0.0952380952380952,31,9,22,44,25,121,6,-3
1974,"Bradford City",4,46,64,56,51,5,1.39130434782609,1.21739130434783,1.10869565217391,0.108695652173913,79,11,24,92,86,106,-7,3.4
1974,"Brentford",4,46,67,53,45,8,1.45652173913043,1.15217391304348,0.978260869565217,0.173913043478261,77,9,24,92,83,93,-6,2
1974,"Brighton & Hove Albion",3,46,58,56,64,-8,1.26086956521739,1.21739130434783,1.39130434782609,-0.173913043478261,60,16,24,68,48,93,12,3.2
1974,"Bristol City",2,42,71,47,33,14,1.69047619047619,1.11904761904762,0.785714285714286,0.333333333333333,26,4,22,44,26,108,0,-2.3
1974,"Bristol Rovers",2,42,47,42,64,-22,1.11904761904762,1,1.52380952380952,-0.523809523809524,40,18,22,44,40,92,0,-1
1974,"Burnley",1,42,62,68,67,1,1.47619047619048,1.61904761904762,1.5952380952381,0.0238095238095238,9,9,22,22,21,121,-12,-5.6
1974,"Bury",3,46,60,53,50,3,1.30434782608696,1.15217391304348,1.08695652173913,0.0652173913043478,57,13,24,68,58,114,-1,-1.5
1974,"Cambridge United",4,46,74,62,44,18,1.60869565217391,1.34782608695652,0.956521739130435,0.391304347826087,74,6,24,92,82,41,-8,0.6
1974,"Cardiff City",2,42,41,36,62,-26,0.976190476190476,0.857142857142857,1.47619047619048,-0.619047619047619,43,21,22,44,46,93,-3,0
1974,"Carlisle United",1,42,41,43,59,-16,0.976190476190476,1.02380952380952,1.4047619047619,-0.380952380952381,22,22,22,22,41,84,-19,-1.6
1974,"Charlton Athletic",3,46,77,76,61,15,1.67391304347826,1.65217391304348,1.32608695652174,0.326086956521739,47,3,24,68,31,92,16,0.8
1974,"Chelsea",1,42,42,42,72,-30,1,1,1.71428571428571,-0.714285714285714,21,21,22,22,36,104,-15,1.4
1974,"Chester",4,46,80,64,38,26,1.73913043478261,1.39130434782609,0.826086956521739,0.565217391304348,72,4,24,92,59,67,13,-1.1
1974,"Chesterfield",3,46,60,62,66,-4,1.30434782608696,1.34782608695652,1.43478260869565,-0.0869565217391304,58,14,24,68,57,100,1,-1.1
1974,"Colchester United",3,46,64,70,63,7,1.39130434782609,1.52173913043478,1.3695652173913,0.152173913043478,55,11,24,68,66,68,-11,-2
1974,"Coventry City",1,42,51,51,62,-11,1.21428571428571,1.21428571428571,1.47619047619048,-0.261904761904762,16,16,22,22,15,94,1,-0.1
1974,"Crewe Alexandra",4,46,51,34,47,-13,1.10869565217391,0.739130434782609,1.02173913043478,-0.282608695652174,87,19,24,92,84,96,3,0.9
1974,"Crystal Palace",3,46,69,66,57,9,1.5,1.43478260869565,1.23913043478261,0.195652173913043,49,5,24,68,50,93,-1,1.2
1974,"Darlington",4,46,49,54,67,-13,1.06521739130435,1.17391304347826,1.45652173913043,-0.282608695652174,90,22,24,92,87,81,3,1.9
1974,"Derby County",1,42,74,67,49,18,1.76190476190476,1.5952380952381,1.16666666666667,0.428571428571429,1,1,22,22,4,121,-3,-5
1974,"Doncaster Rovers",4,46,54,65,79,-14,1.17391304347826,1.41304347826087,1.71739130434783,-0.304347826086957,85,17,24,92,76,88,9,2.7
1974,"Everton",1,42,66,56,42,14,1.57142857142857,1.33333333333333,1,0.333333333333333,5,5,22,22,10,121,-5,0.4
1974,"Exeter City",4,46,68,60,63,-3,1.47826086956522,1.30434782608696,1.3695652173913,-0.0652173913043478,76,8,24,92,77,88,-1,-0.9
1974,"Fulham",2,42,55,44,39,5,1.30952380952381,1.04761904761905,0.928571428571429,0.119047619047619,34,12,22,44,33,102,1,0.4
1974,"Gillingham",3,46,65,65,60,5,1.41304347826087,1.41304347826087,1.30434782608696,0.108695652173913,54,10,24,68,62,88,-8,0.6
1974,"Grimsby Town",3,46,58,55,64,-9,1.26086956521739,1.19565217391304,1.39130434782609,-0.195652173913043,61,17,24,68,63,110,-2,2.9
1974,"Halifax Town",3,46,56,49,65,-16,1.21739130434783,1.06521739130435,1.41304347826087,-0.347826086956522,62,18,24,68,68,69,-6,-2.6
1974,"Hartlepool United",4,46,59,52,62,-10,1.28260869565217,1.1304347826087,1.34782608695652,-0.217391304347826,81,13,24,92,81,89,0,-0.6
1974,"Hereford United",3,46,62,64,66,-2,1.34782608695652,1.39130434782609,1.43478260869565,-0.0434782608695652,56,12,24,68,45,31,11,-1.7
1974,"Huddersfield Town",3,46,43,47,76,-29,0.934782608695652,1.02173913043478,1.65217391304348,-0.630434782608696,68,24,24,68,73,99,-5,3.3
1974,"Hull City",2,42,59,40,53,-13,1.4047619047619,0.952380952380952,1.26190476190476,-0.30952380952381,30,8,22,44,34,104,-4,-1.7
1974,"Ipswich Town",1,42,74,66,44,22,1.76190476190476,1.57142857142857,1.04761904761905,0.523809523809524,2,2,22,22,6,75,-4,-1.6
1974,"Leeds United",1,42,61,57,49,8,1.45238095238095,1.35714285714286,1.16666666666667,0.19047619047619,10,10,22,22,5,93,5,-1.9
1974,"Leicester City",1,42,48,46,60,-14,1.14285714285714,1.0952380952381,1.42857142857143,-0.333333333333333,18,18,22,22,8,115,10,0.3
1974,"Leyton Orient",2,42,53,28,39,-11,1.26190476190476,0.666666666666667,0.928571428571429,-0.261904761904762,35,13,22,44,35,102,0,-3.1
1974,"Lincoln City",4,46,78,79,48,31,1.69565217391304,1.71739130434783,1.04347826086957,0.673913043478261,73,5,24,92,69,107,4,1
1974,"Liverpool",1,42,71,60,39,21,1.69047619047619,1.42857142857143,0.928571428571429,0.5,3,3,22,22,1,116,2,0.1
1974,"Luton Town",1,42,44,47,65,-18,1.04761904761905,1.11904761904762,1.54761904761905,-0.428571428571429,20,20,22,22,29,91,-9,0.7
1974,"Manchester City",1,42,64,54,54,0,1.52380952380952,1.28571428571429,1.28571428571429,0,8,8,22,22,7,117,1,-1.7
1974,"Manchester United",2,42,87,66,30,36,2.07142857142857,1.57142857142857,0.714285714285714,0.857142857142857,23,1,22,44,3,117,20,1.9
1974,"Mansfield Town",4,46,96,90,40,50,2.08695652173913,1.95652173913043,0.869565217391304,1.08695652173913,69,1,24,92,54,77,15,-1.3
1974,"Middlesbrough",1,42,66,54,40,14,1.57142857142857,1.28571428571429,0.952380952380952,0.333333333333333,6,6,22,22,13,110,-7,-3.5
1974,"Millwall",2,42,42,44,56,-12,1,1.04761904761905,1.33333333333333,-0.285714285714286,42,20,22,44,47,93,-5,-0.4
1974,"Newcastle United",1,42,54,59,72,-13,1.28571428571429,1.4047619047619,1.71428571428571,-0.30952380952381,12,12,22,22,14,116,-2,-0.2
1974,"Newport County",4,46,66,68,75,-7,1.43478260869565,1.47826086956522,1.6304347826087,-0.152173913043478,78,10,24,92,90,67,-12,1.6
1974,"Northampton Town",4,46,56,67,73,-6,1.21739130434783,1.45652173913043,1.58695652173913,-0.130434782608696,83,15,24,92,70,93,13,-0.7
1974,"Norwich City",2,42,73,58,37,21,1.73809523809524,1.38095238095238,0.880952380952381,0.5,25,3,22,44,9,93,16,0.5
1974,"Nottingham Forest",2,42,50,43,55,-12,1.19047619047619,1.02380952380952,1.30952380952381,-0.285714285714286,38,16,22,44,30,117,8,2.9
1974,"Notts County",2,42,52,49,59,-10,1.23809523809524,1.16666666666667,1.4047619047619,-0.238095238095238,36,14,22,44,28,120,8,-0.6
1974,"Oldham Athletic",2,42,45,40,48,-8,1.07142857142857,0.952380952380952,1.14285714285714,-0.19047619047619,41,19,22,44,37,102,4,0.5
1974,"Oxford United",2,42,57,41,51,-10,1.35714285714286,0.976190476190476,1.21428571428571,-0.238095238095238,32,10,22,44,42,54,-10,0.9
1974,"Peterborough United",3,46,69,47,53,-6,1.5,1.02173913043478,1.15217391304348,-0.130434782608696,50,6,24,68,55,60,-5,-2.9
1974,"Plymouth Argyle",3,46,83,79,58,21,1.80434782608696,1.71739130434783,1.26086956521739,0.456521739130435,45,1,24,68,38,93,7,-1.4
1974,"Port Vale",3,46,69,61,54,7,1.5,1.32608695652174,1.17391304347826,0.152173913043478,51,7,24,68,56,107,-5,-2.9
1974,"Portsmouth",2,42,49,44,54,-10,1.16666666666667,1.04761904761905,1.28571428571429,-0.238095238095238,39,17,22,44,44,93,-5,1.3
1974,"Preston North End",3,46,68,63,56,7,1.47826086956522,1.3695652173913,1.21739130434783,0.152173913043478,52,8,24,68,52,121,0,-1.5
1974,"Queens Park Rangers",1,42,58,54,54,0,1.38095238095238,1.28571428571429,1.28571428571429,0,11,11,22,22,2,93,9,-0.8
1974,"Reading",4,46,73,63,47,16,1.58695652173913,1.3695652173913,1.02173913043478,0.347826086956522,75,7,24,92,71,93,4,2.3
1974,"Rochdale",4,46,52,59,75,-16,1.1304347826087,1.28260869565217,1.6304347826087,-0.347826086956522,86,18,24,92,85,92,1,0
1974,"Rotherham United",4,46,81,71,41,30,1.76086956521739,1.54347826086957,0.891304347826087,0.652173913043478,71,3,24,92,60,88,11,1.5
1974,"Scunthorpe United",4,46,36,41,78,-37,0.782608695652174,0.891304347826087,1.69565217391304,-0.804347826086957,92,24,24,92,88,70,4,1.5
1974,"Sheffield United",1,42,67,58,51,7,1.5952380952381,1.38095238095238,1.21428571428571,0.166666666666667,4,4,22,22,22,117,-18,-3.6
1974,"Sheffield Wednesday",2,42,26,29,64,-35,0.619047619047619,0.69047619047619,1.52380952380952,-0.833333333333333,44,22,22,44,65,117,-21,3.6
1974,"Shrewsbury Town",4,46,88,80,43,37,1.91304347826087,1.73913043478261,0.934782608695652,0.804347826086957,70,2,24,92,53,69,17,3.9
1974,"Southampton",2,42,56,53,54,-1,1.33333333333333,1.26190476190476,1.28571428571429,-0.0238095238095238,33,11,22,44,27,93,6,2.8
1974,"Southend United",3,46,55,46,51,-5,1.19565217391304,1,1.10869565217391,-0.108695652173913,63,19,24,68,67,93,-4,-2.6
1974,"Southport",4,46,62,56,56,0,1.34782608695652,1.21739130434783,1.21739130434783,0,80,12,24,92,91,50,-11,NA
1974,"Stockport County",4,46,50,43,70,-27,1.08695652173913,0.934782608695652,1.52173913043478,-0.58695652173913,89,21,24,92,89,99,0,-0.2
1974,"Stoke City",1,42,66,64,48,16,1.57142857142857,1.52380952380952,1.14285714285714,0.380952380952381,7,7,22,22,12,113,-5,-1.5
1974,"Sunderland",2,42,70,65,35,30,1.66666666666667,1.54761904761905,0.833333333333333,0.714285714285714,27,5,22,44,23,119,4,0.6
1974,"Swansea City",4,46,51,46,73,-27,1.10869565217391,1,1.58695652173913,-0.58695652173913,88,20,24,92,79,93,9,2.4
1974,"Swindon Town",3,46,74,64,58,6,1.60869565217391,1.39130434782609,1.26086956521739,0.130434782608696,48,4,24,68,61,93,-13,-2.8
1974,"Torquay United",4,46,56,46,61,-15,1.21739130434783,1,1.32608695652174,-0.326086956521739,84,16,24,92,78,78,6,-0.8
1974,"Tottenham Hotspur",1,42,47,52,63,-11,1.11904761904762,1.23809523809524,1.5,-0.261904761904762,19,19,22,22,11,101,8,1.6
1974,"Tranmere Rovers",3,46,51,55,57,-2,1.10869565217391,1.19565217391304,1.23913043478261,-0.0434782608695652,66,22,24,68,72,89,-6,-0.8
1974,"Walsall",3,46,67,67,52,15,1.45652173913043,1.45652173913043,1.1304347826087,0.326086956521739,53,9,24,68,51,100,2,-0.2
1974,"Watford",3,46,47,52,75,-23,1.02173913043478,1.1304347826087,1.6304347826087,-0.5,67,23,24,68,75,93,-8,5.6
1974,"West Bromwich Albion",2,42,63,54,42,12,1.5,1.28571428571429,1,0.285714285714286,28,6,22,44,24,121,4,1.6
1974,"West Ham United",1,42,52,58,59,-1,1.23809523809524,1.38095238095238,1.4047619047619,-0.0238095238095238,14,14,22,22,18,94,-4,-0.2
1974,"Wolverhampton Wanderers",1,42,53,57,54,3,1.26190476190476,1.35714285714286,1.28571428571429,0.0714285714285714,13,13,22,22,20,121,-7,-3.1
1974,"Workington",4,46,41,36,66,-30,0.891304347826087,0.782608695652174,1.43478260869565,-0.652173913043478,91,23,24,92,92,26,-1,NA
1974,"Wrexham",3,46,60,65,55,10,1.30434782608696,1.41304347826087,1.19565217391304,0.217391304347826,59,15,24,68,49,80,10,-2.5
1974,"York City",2,42,52,51,55,-4,1.23809523809524,1.21428571428571,1.30952380952381,-0.0952380952380952,37,15,22,44,43,72,-6,-1.6
1975,"AFC Bournemouth",4,46,72,57,48,9,1.56521739130435,1.23913043478261,1.04347826086957,0.195652173913043,74,6,24,92,81,90,-7,1.5
1975,"Aldershot",3,46,52,59,75,-16,1.1304347826087,1.28260869565217,1.6304347826087,-0.347826086956522,64,20,24,68,84,57,-20,-2
1975,"Arsenal",1,42,49,47,53,-6,1.16666666666667,1.11904761904762,1.26190476190476,-0.142857142857143,17,17,22,22,8,116,9,1
1975,"Aston Villa",1,42,50,51,59,-8,1.19047619047619,1.21428571428571,1.4047619047619,-0.19047619047619,16,16,22,22,4,121,12,0
1975,"Barnsley",4,46,58,52,48,4,1.26086956521739,1.1304347826087,1.04347826086957,0.0869565217391304,80,12,24,92,74,111,6,4.7
1975,"Birmingham City",1,42,46,57,75,-18,1.0952380952381,1.35714285714286,1.78571428571429,-0.428571428571429,19,19,22,22,13,117,6,-0.2
1975,"Blackburn Rovers",2,42,50,45,50,-5,1.19047619047619,1.07142857142857,1.19047619047619,-0.119047619047619,39,17,22,44,33,121,6,-0.2
1975,"Blackpool",2,42,56,40,49,-9,1.33333333333333,0.952380952380952,1.16666666666667,-0.214285714285714,32,10,22,44,28,112,4,-2.4
1975,"Bolton Wanderers",2,42,72,64,38,26,1.71428571428571,1.52380952380952,0.904761904761905,0.619047619047619,25,3,22,44,26,121,-1,-3.6
1975,"Bradford City",4,46,53,63,65,-2,1.15217391304348,1.3695652173913,1.41304347826087,-0.0434782608695652,86,18,24,92,73,106,13,5.1
1975,"Brentford",4,46,55,56,60,-4,1.19565217391304,1.21739130434783,1.30434782608696,-0.0869565217391304,83,15,24,92,82,93,1,2.9
1975,"Brighton & Hove Albion",3,46,75,78,53,25,1.6304347826087,1.69565217391304,1.15217391304348,0.543478260869565,48,4,24,68,46,93,2,1.4
1975,"Bristol City",2,42,72,59,35,24,1.71428571428571,1.4047619047619,0.833333333333333,0.571428571428571,26,4,22,44,17,108,9,-2.7
1975,"Bristol Rovers",2,42,49,38,50,-12,1.16666666666667,0.904761904761905,1.19047619047619,-0.285714285714286,40,18,22,44,36,92,4,-2
1975,"Burnley",1,42,37,43,66,-23,0.880952380952381,1.02380952380952,1.57142857142857,-0.547619047619048,21,21,22,22,37,121,-16,-6.1
1975,"Bury",3,46,58,51,46,5,1.26086956521739,1.10869565217391,1,0.108695652173913,58,14,24,68,50,114,8,-0.6
1975,"Cambridge United",4,46,57,58,62,-4,1.23913043478261,1.26086956521739,1.34782608695652,-0.0869565217391304,82,14,24,92,69,41,13,-0.5
1975,"Cardiff City",3,46,79,69,48,21,1.71739130434783,1.5,1.04347826086957,0.456521739130435,46,2,24,68,39,93,7,-2
1975,"Carlisle United",2,42,49,45,59,-14,1.16666666666667,1.07142857142857,1.4047619047619,-0.333333333333333,41,19,22,44,41,84,0,-0.1
1975,"Charlton Athletic",2,42,57,61,72,-11,1.35714285714286,1.45238095238095,1.71428571428571,-0.261904761904762,31,9,22,44,30,92,1,0.7
1975,"Chelsea",2,42,52,53,54,-1,1.23809523809524,1.26190476190476,1.28571428571429,-0.0238095238095238,36,14,22,44,24,104,12,3
1975,"Chester",3,46,57,43,62,-19,1.23913043478261,0.934782608695652,1.34782608695652,-0.41304347826087,59,15,24,68,55,67,4,-1.1
1975,"Chesterfield",3,46,60,69,69,0,1.30434782608696,1.5,1.5,0,57,13,24,68,61,100,-4,-0.5
1975,"Colchester United",3,46,50,41,65,-24,1.08695652173913,0.891304347826087,1.41304347826087,-0.521739130434783,66,22,24,68,71,68,-5,-0.8
1975,"Coventry City",1,42,53,47,57,-10,1.26190476190476,1.11904761904762,1.35714285714286,-0.238095238095238,15,15,22,22,19,94,-4,-0.2
1975,"Crewe Alexandra",4,46,54,58,57,1,1.17391304347826,1.26086956521739,1.23913043478261,0.0217391304347826,84,16,24,92,78,96,6,0.4
1975,"Crystal Palace",3,46,71,61,46,15,1.54347826086957,1.32608695652174,1,0.326086956521739,50,6,24,68,47,93,3,2.3
1975,"Darlington",4,46,52,48,57,-9,1.1304347826087,1.04347826086957,1.23913043478261,-0.195652173913043,87,19,24,92,79,81,8,3
1975,"Derby County",1,42,74,75,58,17,1.76190476190476,1.78571428571429,1.38095238095238,0.404761904761905,4,4,22,22,18,121,-14,-4.3
1975,"Doncaster Rovers",4,46,68,75,69,6,1.47826086956522,1.6304347826087,1.5,0.130434782608696,76,8,24,92,75,88,1,2.1
1975,"Everton",1,42,57,60,66,-6,1.35714285714286,1.42857142857143,1.57142857142857,-0.142857142857143,10,10,22,22,10,121,0,0.8
1975,"Exeter City",4,46,68,56,47,9,1.47826086956522,1.21739130434783,1.02173913043478,0.195652173913043,77,9,24,92,70,88,7,-1.1
1975,"Fulham",2,42,53,45,47,-2,1.26190476190476,1.07142857142857,1.11904761904762,-0.0476190476190476,33,11,22,44,40,102,-7,-1.1
1975,"Gillingham",3,46,55,58,68,-10,1.19565217391304,1.26086956521739,1.47826086956522,-0.217391304347826,62,18,24,68,56,88,6,1.3
1975,"Grimsby Town",3,46,55,62,74,-12,1.19565217391304,1.34782608695652,1.60869565217391,-0.260869565217391,63,19,24,68,67,110,-4,2.6
1975,"Halifax Town",3,46,46,41,61,-20,1,0.891304347826087,1.32608695652174,-0.434782608695652,68,24,24,68,89,69,-21,-2.1
1975,"Hartlepool United",4,46,58,62,78,-16,1.26086956521739,1.34782608695652,1.69565217391304,-0.347826086956522,81,13,24,92,90,89,-9,0.6
1975,"Hereford United",3,46,89,86,55,31,1.93478260869565,1.8695652173913,1.19565217391304,0.673913043478261,45,1,24,68,44,31,1,-3.1
1975,"Huddersfield Town",4,46,77,56,41,15,1.67391304347826,1.21739130434783,0.891304347826087,0.326086956521739,73,5,24,92,76,99,-3,3.5
1975,"Hull City",2,42,53,45,49,-4,1.26190476190476,1.07142857142857,1.16666666666667,-0.0952380952380952,34,12,22,44,38,104,-4,0.6
1975,"Ipswich Town",1,42,62,54,48,6,1.47619047619048,1.28571428571429,1.14285714285714,0.142857142857143,6,6,22,22,3,75,3,-1.4
1975,"Leeds United",1,42,72,65,46,19,1.71428571428571,1.54761904761905,1.0952380952381,0.452380952380952,5,5,22,22,9,93,-4,-3.1
1975,"Leicester City",1,42,58,48,51,-3,1.38095238095238,1.14285714285714,1.21428571428571,-0.0714285714285714,8,8,22,22,12,115,-4,-1
1975,"Leyton Orient",2,42,53,37,39,-2,1.26190476190476,0.880952380952381,0.928571428571429,-0.0476190476190476,35,13,22,44,42,102,-7,-3.8
1975,"Lincoln City",4,46,106,111,39,72,2.30434782608696,2.41304347826087,0.847826086956522,1.56521739130435,69,1,24,92,53,107,16,0.4
1975,"Liverpool",1,42,83,66,31,35,1.97619047619048,1.57142857142857,0.738095238095238,0.833333333333333,1,1,22,22,1,116,0,0
1975,"Luton Town",2,42,67,61,51,10,1.5952380952381,1.45238095238095,1.21428571428571,0.238095238095238,29,7,22,44,27,91,2,2
1975,"Manchester City",1,42,59,64,46,18,1.4047619047619,1.52380952380952,1.0952380952381,0.428571428571429,7,7,22,22,2,117,5,-0.8
1975,"Manchester United",1,42,79,68,42,26,1.88095238095238,1.61904761904762,1,0.619047619047619,3,3,22,22,6,117,-3,-0.1
1975,"Mansfield Town",3,46,63,58,52,6,1.3695652173913,1.26086956521739,1.1304347826087,0.130434782608696,54,10,24,68,45,77,9,-1.7
1975,"Middlesbrough",1,42,55,46,45,1,1.30952380952381,1.0952380952381,1.07142857142857,0.0238095238095238,13,13,22,22,11,110,2,-3
1975,"Millwall",3,46,76,54,43,11,1.65217391304348,1.17391304347826,0.934782608695652,0.239130434782609,47,3,24,68,32,93,15,1.6
1975,"Newcastle United",1,42,54,71,62,9,1.28571428571429,1.69047619047619,1.47619047619048,0.214285714285714,14,14,22,22,5,116,9,0.3
1975,"Newport County",4,46,48,57,90,-33,1.04347826086957,1.23913043478261,1.95652173913043,-0.717391304347826,90,22,24,92,86,67,4,2.7
1975,"Northampton Town",4,46,97,87,40,47,2.10869565217391,1.89130434782609,0.869565217391304,1.02173913043478,70,2,24,92,65,93,5,-0.7
1975,"Norwich City",1,42,58,58,58,0,1.38095238095238,1.38095238095238,1.38095238095238,0,9,9,22,22,14,93,-5,-1.4
1975,"Nottingham Forest",2,42,63,55,40,15,1.5,1.30952380952381,0.952380952380952,0.357142857142857,30,8,22,44,25,117,5,2.2
1975,"Notts County",2,42,68,60,41,19,1.61904761904762,1.42857142857143,0.976190476190476,0.452380952380952,28,6,22,44,29,120,-1,-2.3
1975,"Oldham Athletic",2,42,51,57,68,-11,1.21428571428571,1.35714285714286,1.61904761904762,-0.261904761904762,37,15,22,44,35,102,2,0.7
1975,"Oxford United",2,42,44,39,59,-20,1.04761904761905,0.928571428571429,1.4047619047619,-0.476190476190476,42,20,22,44,62,54,-20,2.3
1975,"Peterborough United",3,46,63,63,63,0,1.3695652173913,1.3695652173913,1.3695652173913,0,55,11,24,68,59,60,-4,-3
1975,"Plymouth Argyle",2,42,51,48,54,-6,1.21428571428571,1.14285714285714,1.28571428571429,-0.142857142857143,38,16,22,44,43,93,-5,-0.8
1975,"Port Vale",3,46,61,55,54,1,1.32608695652174,1.19565217391304,1.17391304347826,0.0217391304347826,56,12,24,68,63,107,-7,-1.6
1975,"Portsmouth",2,42,34,32,61,-29,0.80952380952381,0.761904761904762,1.45238095238095,-0.69047619047619,44,22,22,44,66,93,-22,1.8
1975,"Preston North End",3,46,67,62,57,5,1.45652173913043,1.34782608695652,1.23913043478261,0.108695652173913,52,8,24,68,51,121,1,-3.9
1975,"Queens Park Rangers",1,42,83,67,33,34,1.97619047619048,1.5952380952381,0.785714285714286,0.80952380952381,2,2,22,22,15,93,-13,-1.1
1975,"Reading",4,46,84,70,51,19,1.82608695652174,1.52173913043478,1.10869565217391,0.41304347826087,71,3,24,92,64,93,7,2.6
1975,"Rochdale",4,46,54,40,54,-14,1.17391304347826,0.869565217391304,1.17391304347826,-0.304347826086957,85,17,24,92,87,92,-2,-0.1
1975,"Rotherham United",3,46,57,54,65,-11,1.23913043478261,1.17391304347826,1.41304347826087,-0.239130434782609,60,16,24,68,49,88,11,0.2
1975,"Scunthorpe United",4,46,52,50,59,-9,1.1304347826087,1.08695652173913,1.28260869565217,-0.195652173913043,88,20,24,92,88,70,0,0.5
1975,"Sheffield United",1,42,28,33,82,-49,0.666666666666667,0.785714285714286,1.95238095238095,-1.16666666666667,22,22,22,22,34,117,-12,-0.7
1975,"Sheffield Wednesday",3,46,52,48,59,-11,1.1304347826087,1.04347826086957,1.28260869565217,-0.239130434782609,65,21,24,68,52,117,13,6
1975,"Shrewsbury Town",3,46,67,61,59,2,1.45652173913043,1.32608695652174,1.28260869565217,0.0434782608695652,53,9,24,68,54,69,-1,1.4
1975,"Southampton",2,42,70,66,50,16,1.66666666666667,1.57142857142857,1.19047619047619,0.380952380952381,27,5,22,44,31,93,-4,1.3
1975,"Southend United",3,46,49,65,75,-10,1.06521739130435,1.41304347826087,1.6304347826087,-0.217391304347826,67,23,24,68,80,93,-13,-1.1
1975,"Southport",4,46,34,41,77,-36,0.739130434782609,0.891304347826087,1.67391304347826,-0.782608695652174,91,23,24,92,91,50,0,NA
1975,"Stockport County",4,46,51,43,76,-33,1.10869565217391,0.934782608695652,1.65217391304348,-0.717391304347826,89,21,24,92,85,99,4,1
1975,"Stoke City",1,42,56,48,50,-2,1.33333333333333,1.14285714285714,1.19047619047619,-0.0476190476190476,12,12,22,22,22,113,-10,-2
1975,"Sunderland",2,42,80,67,36,31,1.9047619047619,1.5952380952381,0.857142857142857,0.738095238095238,23,1,22,44,20,119,3,-1.7
1975,"Swansea City",4,46,63,66,57,9,1.3695652173913,1.43478260869565,1.23913043478261,0.195652173913043,79,11,24,92,72,93,7,1.2
1975,"Swindon Town",3,46,56,62,75,-13,1.21739130434783,1.34782608695652,1.6304347826087,-0.282608695652174,61,17,24,68,57,93,4,-0.8
1975,"Torquay United",4,46,68,55,63,-8,1.47826086956522,1.19565217391304,1.3695652173913,-0.173913043478261,78,10,24,92,83,78,-5,-1.4
1975,"Tottenham Hotspur",1,42,57,63,63,0,1.35714285714286,1.5,1.5,0,11,11,22,22,21,101,-10,0.1
1975,"Tranmere Rovers",4,46,82,89,55,34,1.78260869565217,1.93478260869565,1.19565217391304,0.739130434782609,72,4,24,92,58,89,14,-1.8
1975,"Walsall",3,46,68,74,61,13,1.47826086956522,1.60869565217391,1.32608695652174,0.282608695652174,51,7,24,68,60,100,-9,0.1
1975,"Watford",4,46,72,62,62,0,1.56521739130435,1.34782608695652,1.34782608695652,0,75,7,24,92,77,93,-2,6.3
1975,"West Bromwich Albion",2,42,73,50,33,17,1.73809523809524,1.19047619047619,0.785714285714286,0.404761904761905,24,2,22,44,7,121,17,0.2
1975,"West Ham United",1,42,49,48,71,-23,1.16666666666667,1.14285714285714,1.69047619047619,-0.547619047619048,18,18,22,22,16,94,2,1.5
1975,"Wolverhampton Wanderers",1,42,40,51,68,-17,0.952380952380952,1.21428571428571,1.61904761904762,-0.404761904761905,20,20,22,22,23,121,-3,-4.8
1975,"Workington",4,46,28,30,87,-57,0.608695652173913,0.652173913043478,1.89130434782609,-1.23913043478261,92,24,24,92,92,26,0,NA
1975,"Wrexham",3,46,72,66,55,11,1.56521739130435,1.43478260869565,1.19565217391304,0.239130434782609,49,5,24,68,48,80,1,-3.2
1975,"York City",2,42,38,39,71,-32,0.904761904761905,0.928571428571429,1.69047619047619,-0.761904761904762,43,21,22,44,68,72,-25,-0.9
1976,"AFC Bournemouth",4,46,63,54,44,10,1.3695652173913,1.17391304347826,0.956521739130435,0.217391304347826,81,13,24,92,86,90,-5,3.6
1976,"Aldershot",4,46,59,49,59,-10,1.28260869565217,1.06521739130435,1.28260869565217,-0.217391304347826,84,16,24,92,74,57,10,1.1
1976,"Arsenal",1,42,59,64,59,5,1.4047619047619,1.52380952380952,1.4047619047619,0.119047619047619,8,8,22,22,4,116,4,0.4
1976,"Aston Villa",1,42,73,76,50,26,1.73809523809524,1.80952380952381,1.19047619047619,0.619047619047619,4,4,22,22,8,121,-4,-1.8
1976,"Barnsley",4,46,78,62,39,23,1.69565217391304,1.34782608695652,0.847826086956522,0.5,74,6,24,92,75,111,-1,4.2
1976,"Birmingham City",1,42,51,63,61,2,1.21428571428571,1.5,1.45238095238095,0.0476190476190476,13,13,22,22,11,117,2,-2.8
1976,"Blackburn Rovers",2,42,54,42,54,-12,1.28571428571429,1,1.28571428571429,-0.285714285714286,33,11,22,44,27,121,6,0
1976,"Blackpool",2,42,68,58,42,16,1.61904761904762,1.38095238095238,1,0.380952380952381,28,6,22,44,40,112,-12,-2.5
1976,"Bolton Wanderers",2,42,71,75,54,21,1.69047619047619,1.78571428571429,1.28571428571429,0.5,26,4,22,44,23,121,3,-3.9
1976,"Bradford City",4,46,82,78,51,27,1.78260869565217,1.69565217391304,1.10869565217391,0.58695652173913,73,5,24,92,65,106,8,3.9
1976,"Brentford",4,46,61,77,76,1,1.32608695652174,1.67391304347826,1.65217391304348,0.0217391304347826,82,14,24,92,72,93,10,2.7
1976,"Brighton & Hove Albion",3,46,86,83,40,43,1.8695652173913,1.80434782608696,0.869565217391304,0.934782608695652,46,2,24,68,25,93,21,0.2
1976,"Bristol City",1,42,46,38,48,-10,1.0952380952381,0.904761904761905,1.14285714285714,-0.238095238095238,17,17,22,22,17,108,0,-3.3
1976,"Bristol Rovers",2,42,49,53,68,-15,1.16666666666667,1.26190476190476,1.61904761904762,-0.357142857142857,36,14,22,44,36,92,0,-2.7
1976,"Burnley",2,42,47,46,64,-18,1.11904761904762,1.0952380952381,1.52380952380952,-0.428571428571429,37,15,22,44,31,121,6,-5.3
1976,"Bury",3,46,77,64,59,5,1.67391304347826,1.39130434782609,1.28260869565217,0.108695652173913,50,6,24,68,61,114,-11,-1
1976,"Cambridge United",4,46,91,87,40,47,1.97826086956522,1.89130434782609,0.869565217391304,1.02173913043478,69,1,24,92,46,41,23,-1
1976,"Cardiff City",2,42,46,56,67,-11,1.0952380952381,1.33333333333333,1.5952380952381,-0.261904761904762,39,17,22,44,37,93,2,-4.2
1976,"Carlisle United",2,42,45,49,75,-26,1.07142857142857,1.16666666666667,1.78571428571429,-0.619047619047619,41,19,22,44,57,84,-16,-2.5
1976,"Charlton Athletic",2,42,64,71,58,13,1.52380952380952,1.69047619047619,1.38095238095238,0.30952380952381,30,8,22,44,38,92,-8,1.1
1976,"Chelsea",2,42,76,73,53,20,1.80952380952381,1.73809523809524,1.26190476190476,0.476190476190476,24,2,22,44,16,104,8,1.2
1976,"Chester",3,46,62,48,58,-10,1.34782608695652,1.04347826086957,1.26086956521739,-0.217391304347826,55,11,24,68,50,67,5,-0.4
1976,"Chesterfield",3,46,52,56,64,-8,1.1304347826087,1.21739130434783,1.39130434782609,-0.173913043478261,61,17,24,68,51,100,10,0
1976,"Colchester United",4,46,84,77,43,34,1.82608695652174,1.67391304347826,0.934782608695652,0.739130434782609,71,3,24,92,54,68,17,-0.3
1976,"Coventry City",1,42,45,48,59,-11,1.07142857142857,1.14285714285714,1.4047619047619,-0.261904761904762,19,19,22,22,7,94,12,1
1976,"Crewe Alexandra",4,46,68,47,60,-13,1.47826086956522,1.02173913043478,1.30434782608696,-0.282608695652174,78,10,24,92,80,96,-2,-0.6
1976,"Crystal Palace",3,46,82,68,40,28,1.78260869565217,1.47826086956522,0.869565217391304,0.608695652173913,47,3,24,68,34,93,13,1.9
1976,"Darlington",4,46,67,59,64,-5,1.45652173913043,1.28260869565217,1.39130434782609,-0.108695652173913,79,11,24,92,87,81,-8,1.2
1976,"Derby County",1,42,46,50,55,-5,1.0952380952381,1.19047619047619,1.30952380952381,-0.119047619047619,18,18,22,22,12,121,6,-0.5
1976,"Doncaster Rovers",4,46,72,71,65,6,1.56521739130435,1.54347826086957,1.41304347826087,0.130434782608696,75,7,24,92,81,88,-6,1.9
1976,"Everton",1,42,56,62,64,-2,1.33333333333333,1.47619047619048,1.52380952380952,-0.0476190476190476,10,10,22,22,3,121,7,0.9
1976,"Exeter City",4,46,87,70,46,24,1.89130434782609,1.52173913043478,1,0.521739130434783,70,2,24,92,60,88,10,-1.2
1976,"Fulham",2,42,46,54,61,-7,1.0952380952381,1.28571428571429,1.45238095238095,-0.166666666666667,40,18,22,44,32,102,8,-2.2
1976,"Gillingham",3,46,60,55,64,-9,1.30434782608696,1.19565217391304,1.39130434782609,-0.195652173913043,56,12,24,68,52,88,4,0.7
1976,"Grimsby Town",3,46,45,45,69,-24,0.978260869565217,0.978260869565217,1.5,-0.521739130434783,67,23,24,68,73,110,-6,2.4
1976,"Halifax Town",4,46,47,47,58,-11,1.02173913043478,1.02173913043478,1.26086956521739,-0.239130434782609,89,21,24,92,89,69,0,0.6
1976,"Hartlepool United",4,46,42,47,73,-26,0.91304347826087,1.02173913043478,1.58695652173913,-0.565217391304348,90,22,24,92,88,89,2,0.4
1976,"Hereford United",2,42,39,57,78,-21,0.928571428571429,1.35714285714286,1.85714285714286,-0.5,44,22,22,44,67,31,-23,-4.1
1976,"Huddersfield Town",4,46,69,60,49,11,1.5,1.30434782608696,1.06521739130435,0.239130434782609,76,8,24,92,79,99,-3,3.9
1976,"Hull City",2,42,47,45,53,-8,1.11904761904762,1.07142857142857,1.26190476190476,-0.19047619047619,38,16,22,44,44,104,-6,0.3
1976,"Ipswich Town",1,42,74,66,39,27,1.76190476190476,1.57142857142857,0.928571428571429,0.642857142857143,3,3,22,22,18,75,-15,-2.4
1976,"Leeds United",1,42,57,48,51,-3,1.35714285714286,1.14285714285714,1.21428571428571,-0.0714285714285714,9,9,22,22,9,93,0,-1.7
1976,"Leicester City",1,42,54,47,60,-13,1.28571428571429,1.11904761904762,1.42857142857143,-0.30952380952381,12,12,22,22,22,115,-10,-0.8
1976,"Leyton Orient",2,42,43,37,55,-18,1.02380952380952,0.880952380952381,1.30952380952381,-0.428571428571429,42,20,22,44,42,102,0,-3.3
1976,"Lincoln City",3,46,71,77,70,7,1.54347826086957,1.67391304347826,1.52173913043478,0.152173913043478,53,9,24,68,59,107,-6,-3.8
1976,"Liverpool",1,42,80,62,33,29,1.9047619047619,1.47619047619048,0.785714285714286,0.69047619047619,1,1,22,22,2,116,-1,-0.1
1976,"Luton Town",2,42,69,67,48,19,1.64285714285714,1.5952380952381,1.14285714285714,0.452380952380952,27,5,22,44,35,91,-8,2.1
1976,"Manchester City",1,42,77,60,34,26,1.83333333333333,1.42857142857143,0.80952380952381,0.619047619047619,2,2,22,22,5,117,-3,-1.9
1976,"Manchester United",1,42,65,71,62,9,1.54761904761905,1.69047619047619,1.47619047619048,0.214285714285714,6,6,22,22,10,117,-4,-0.5
1976,"Mansfield Town",3,46,92,78,42,36,2,1.69565217391304,0.91304347826087,0.782608695652174,45,1,24,68,43,77,2,-0.9
1976,"Middlesbrough",1,42,55,40,45,-5,1.30952380952381,0.952380952380952,1.07142857142857,-0.119047619047619,11,11,22,22,13,110,-2,-3.5
1976,"Millwall",2,42,58,57,53,4,1.38095238095238,1.35714285714286,1.26190476190476,0.0952380952380952,32,10,22,44,39,93,-7,-0.6
1976,"Newcastle United",1,42,67,64,49,15,1.5952380952381,1.52380952380952,1.16666666666667,0.357142857142857,5,5,22,22,21,116,-16,-1.2
1976,"Newport County",4,46,52,42,58,-16,1.1304347826087,0.91304347826087,1.26086956521739,-0.347826086956522,86,18,24,92,82,67,4,1.8
1976,"Northampton Town",3,46,47,60,75,-15,1.02173913043478,1.30434782608696,1.6304347826087,-0.326086956521739,65,21,24,68,77,93,-12,-0.4
1976,"Norwich City",1,42,51,47,64,-17,1.21428571428571,1.11904761904762,1.52380952380952,-0.404761904761905,14,14,22,22,14,93,0,0.9
1976,"Nottingham Forest",2,42,73,77,43,34,1.73809523809524,1.83333333333333,1.02380952380952,0.80952380952381,25,3,22,44,1,117,24,1.7
1976,"Notts County",2,42,67,65,60,5,1.5952380952381,1.54761904761905,1.42857142857143,0.119047619047619,29,7,22,44,41,120,-12,-2.2
1976,"Oldham Athletic",2,42,52,52,64,-12,1.23809523809524,1.23809523809524,1.52380952380952,-0.285714285714286,35,13,22,44,33,102,2,1
1976,"Oxford United",3,46,51,55,65,-10,1.10869565217391,1.19565217391304,1.41304347826087,-0.217391304347826,62,18,24,68,62,54,0,4.4
1976,"Peterborough United",3,46,54,55,65,-10,1.17391304347826,1.19565217391304,1.41304347826087,-0.217391304347826,59,15,24,68,47,60,12,-1.8
1976,"Plymouth Argyle",2,42,40,46,65,-19,0.952380952380952,1.0952380952381,1.54761904761905,-0.452380952380952,43,21,22,44,64,93,-21,1.4
1976,"Port Vale",3,46,49,47,71,-24,1.06521739130435,1.02173913043478,1.54347826086957,-0.521739130434783,63,19,24,68,66,107,-3,0.6
1976,"Portsmouth",3,46,47,53,70,-17,1.02173913043478,1.15217391304348,1.52173913043478,-0.369565217391304,66,22,24,68,68,93,-2,4.2
1976,"Preston North End",3,46,75,64,43,21,1.6304347826087,1.39130434782609,0.934782608695652,0.456521739130435,51,7,24,68,48,121,3,-1.9
1976,"Queens Park Rangers",1,42,51,47,52,-5,1.21428571428571,1.11904761904762,1.23809523809524,-0.119047619047619,15,15,22,22,20,93,-5,-0.1
1976,"Reading",3,46,48,49,73,-24,1.04347826086957,1.06521739130435,1.58695652173913,-0.521739130434783,64,20,24,68,76,93,-12,2.8
1976,"Rochdale",4,46,51,50,59,-9,1.10869565217391,1.08695652173913,1.28260869565217,-0.195652173913043,87,19,24,92,92,92,-5,-0.1
1976,"Rotherham United",3,46,81,69,44,25,1.76086956521739,1.5,0.956521739130435,0.543478260869565,49,5,24,68,63,88,-14,-0.9
1976,"Scunthorpe United",4,46,50,49,73,-24,1.08695652173913,1.06521739130435,1.58695652173913,-0.521739130434783,88,20,24,92,83,70,5,1.2
1976,"Sheffield United",2,42,54,54,63,-9,1.28571428571429,1.28571428571429,1.5,-0.214285714285714,34,12,22,44,30,117,4,0.4
1976,"Sheffield Wednesday",3,46,75,65,55,10,1.6304347826087,1.41304347826087,1.19565217391304,0.217391304347826,52,8,24,68,58,117,-6,3.9
1976,"Shrewsbury Town",3,46,65,65,59,6,1.41304347826087,1.41304347826087,1.28260869565217,0.130434782608696,54,10,24,68,55,69,-1,1.5
1976,"Southampton",2,42,61,72,67,5,1.45238095238095,1.71428571428571,1.5952380952381,0.119047619047619,31,9,22,44,24,93,7,1.7
1976,"Southend United",4,46,64,52,45,7,1.39130434782609,1.1304347826087,0.978260869565217,0.152173913043478,80,12,24,92,70,93,10,0.9
1976,"Southport",4,46,28,33,77,-44,0.608695652173913,0.717391304347826,1.67391304347826,-0.956521739130435,91,23,24,92,91,50,0,NA
1976,"Stockport County",4,46,58,53,57,-4,1.26086956521739,1.15217391304348,1.23913043478261,-0.0869565217391304,85,17,24,92,84,99,1,-0.2
1976,"Stoke City",1,42,44,28,51,-23,1.04761904761905,0.666666666666667,1.21428571428571,-0.547619047619048,22,22,22,22,28,113,-6,-0.9
1976,"Sunderland",1,42,45,46,54,-8,1.07142857142857,1.0952380952381,1.28571428571429,-0.19047619047619,20,20,22,22,29,119,-9,-2.2
1976,"Swansea City",4,46,83,92,68,24,1.80434782608696,2,1.47826086956522,0.521739130434783,72,4,24,92,71,93,1,-0.8
1976,"Swindon Town",3,46,60,68,75,-7,1.30434782608696,1.47826086956522,1.6304347826087,-0.152173913043478,57,13,24,68,53,93,4,1
1976,"Torquay United",4,46,60,59,67,-8,1.30434782608696,1.28260869565217,1.45652173913043,-0.173913043478261,83,15,24,92,78,78,5,-0.9
1976,"Tottenham Hotspur",1,42,45,48,72,-24,1.07142857142857,1.14285714285714,1.71428571428571,-0.571428571428571,21,21,22,22,26,101,-5,1.8
1976,"Tranmere Rovers",3,46,56,51,53,-2,1.21739130434783,1.10869565217391,1.15217391304348,-0.0434782608695652,58,14,24,68,56,89,2,-3.1
1976,"Walsall",3,46,54,57,65,-8,1.17391304347826,1.23913043478261,1.41304347826087,-0.173913043478261,60,16,24,68,49,100,11,0.8
1976,"Watford",4,46,69,67,50,17,1.5,1.45652173913043,1.08695652173913,0.369565217391304,77,9,24,92,69,93,8,6.7
1976,"West Bromwich Albion",1,42,61,62,56,6,1.45238095238095,1.47619047619048,1.33333333333333,0.142857142857143,7,7,22,22,6,121,1,-3.3
1976,"West Ham United",1,42,47,46,65,-19,1.11904761904762,1.0952380952381,1.54761904761905,-0.452380952380952,16,16,22,22,19,94,-3,0.1
1976,"Wolverhampton Wanderers",2,42,79,84,45,39,1.88095238095238,2,1.07142857142857,0.928571428571429,23,1,22,44,15,121,8,-4.9
1976,"Workington",4,46,23,41,102,-61,0.5,0.891304347826087,2.21739130434783,-1.32608695652174,92,24,24,92,NA,26,NA,NA
1976,"Wrexham",3,46,82,80,54,26,1.78260869565217,1.73913043478261,1.17391304347826,0.565217391304348,48,4,24,68,45,80,3,-3
1976,"York City",3,46,42,50,89,-39,0.91304347826087,1.08695652173913,1.93478260869565,-0.847826086956522,68,24,24,68,90,72,-22,0.4
1977,"AFC Bournemouth",4,46,57,41,51,-10,1.23913043478261,0.891304347826087,1.10869565217391,-0.217391304347826,86,18,24,92,88,90,-2,4.8
1977,"Aldershot",4,46,73,67,47,20,1.58695652173913,1.45652173913043,1.02173913043478,0.434782608695652,74,6,24,92,73,57,1,1
1977,"Arsenal",1,42,73,60,37,23,1.73809523809524,1.42857142857143,0.880952380952381,0.547619047619048,4,4,22,22,7,116,-3,-0.2
1977,"Aston Villa",1,42,64,57,42,15,1.52380952380952,1.35714285714286,1,0.357142857142857,8,8,22,22,8,121,0,-1.5
1977,"Barnsley",4,46,68,61,49,12,1.47826086956522,1.32608695652174,1.06521739130435,0.260869565217391,75,7,24,92,72,111,3,4
1977,"Birmingham City",1,42,57,55,60,-5,1.35714285714286,1.30952380952381,1.42857142857143,-0.119047619047619,11,11,22,22,21,117,-10,-2.9
1977,"Blackburn Rovers",2,42,61,56,60,-4,1.45238095238095,1.33333333333333,1.42857142857143,-0.0952380952380952,27,5,22,44,44,121,-17,0.2
1977,"Blackpool",2,42,49,59,60,-1,1.16666666666667,1.4047619047619,1.42857142857143,-0.0238095238095238,40,18,22,44,55,112,-15,-1.4
1977,"Bolton Wanderers",2,42,82,63,33,30,1.95238095238095,1.5,0.785714285714286,0.714285714285714,23,1,22,44,16,121,7,-4.8
1977,"Bradford City",3,46,46,56,86,-30,1,1.21739130434783,1.8695652173913,-0.652173913043478,65,21,24,68,81,106,-16,3.9
1977,"Brentford",4,46,77,86,54,32,1.67391304347826,1.8695652173913,1.17391304347826,0.695652173913043,72,4,24,92,53,93,19,1.6
1977,"Brighton & Hove Albion",2,42,78,63,38,25,1.85714285714286,1.5,0.904761904761905,0.595238095238095,25,3,22,44,23,93,2,-2.1
1977,"Bristol City",1,42,46,49,53,-4,1.0952380952381,1.16666666666667,1.26190476190476,-0.0952380952380952,17,17,22,22,11,108,6,-3.2
1977,"Bristol Rovers",2,42,51,61,77,-16,1.21428571428571,1.45238095238095,1.83333333333333,-0.380952380952381,36,14,22,44,35,92,1,-1.6
1977,"Burnley",2,42,55,56,64,-8,1.30952380952381,1.33333333333333,1.52380952380952,-0.19047619047619,31,9,22,44,32,121,-1,-4.6
1977,"Bury",3,46,58,62,56,6,1.26086956521739,1.34782608695652,1.21739130434783,0.130434782608696,61,17,24,68,63,114,-2,0.4
1977,"Cambridge United",3,46,81,72,51,21,1.76086956521739,1.56521739130435,1.10869565217391,0.456521739130435,46,2,24,68,36,41,10,-3.7
1977,"Cardiff City",2,42,51,51,71,-20,1.21428571428571,1.21428571428571,1.69047619047619,-0.476190476190476,37,15,22,44,29,93,8,-3.3
1977,"Carlisle United",3,46,61,59,59,0,1.32608695652174,1.28260869565217,1.28260869565217,0,57,13,24,68,52,84,5,-3.4
1977,"Charlton Athletic",2,42,51,55,68,-13,1.21428571428571,1.30952380952381,1.61904761904762,-0.30952380952381,38,16,22,44,41,92,-3,2.2
1977,"Chelsea",1,42,47,46,69,-23,1.11904761904762,1.0952380952381,1.64285714285714,-0.547619047619048,16,16,22,22,22,104,-6,-0.1
1977,"Chester",3,46,70,59,56,3,1.52173913043478,1.28260869565217,1.21739130434783,0.0652173913043478,50,6,24,68,60,67,-10,-0.9
1977,"Chesterfield",3,46,65,58,49,9,1.41304347826087,1.26086956521739,1.06521739130435,0.195652173913043,51,7,24,68,64,100,-13,-1
1977,"Colchester United",3,46,63,55,44,11,1.3695652173913,1.19565217391304,0.956521739130435,0.239130434782609,54,10,24,68,50,68,4,-2.4
1977,"Coventry City",1,42,66,75,62,13,1.57142857142857,1.78571428571429,1.47619047619048,0.30952380952381,7,7,22,22,10,94,-3,-0.2
1977,"Crewe Alexandra",4,46,59,50,69,-19,1.28260869565217,1.08695652173913,1.5,-0.41304347826087,80,12,24,92,92,96,-12,-0.5
1977,"Crystal Palace",2,42,54,50,47,3,1.28571428571429,1.19047619047619,1.11904761904762,0.0714285714285714,34,12,22,44,25,93,9,0.7
1977,"Darlington",4,46,55,52,59,-7,1.19565217391304,1.1304347826087,1.28260869565217,-0.152173913043478,87,19,24,92,90,81,-3,0.6
1977,"Derby County",1,42,55,54,59,-5,1.30952380952381,1.28571428571429,1.4047619047619,-0.119047619047619,12,12,22,22,19,121,-7,-0.3
1977,"Doncaster Rovers",4,46,59,52,65,-13,1.28260869565217,1.1304347826087,1.41304347826087,-0.282608695652174,81,13,24,92,89,88,-8,1.4
1977,"Everton",1,42,77,76,45,31,1.83333333333333,1.80952380952381,1.07142857142857,0.738095238095238,3,3,22,22,5,121,-2,-0.1
1977,"Exeter City",3,46,59,49,59,-10,1.28260869565217,1.06521739130435,1.28260869565217,-0.217391304347826,60,16,24,68,54,88,6,-3
1977,"Fulham",2,42,55,49,49,0,1.30952380952381,1.16666666666667,1.16666666666667,0,32,10,22,44,33,102,-1,-2.1
1977,"Gillingham",3,46,65,67,60,7,1.41304347826087,1.45652173913043,1.30434782608696,0.152173913043478,52,8,24,68,49,88,3,-0.6
1977,"Grimsby Town",4,46,74,57,51,6,1.60869565217391,1.23913043478261,1.10869565217391,0.130434782608696,73,5,24,92,70,110,3,0.7
1977,"Halifax Town",4,46,51,52,62,-10,1.10869565217391,1.1304347826087,1.34782608695652,-0.217391304347826,89,21,24,92,91,69,-2,0.3
1977,"Hartlepool United",4,46,52,51,84,-33,1.1304347826087,1.10869565217391,1.82608695652174,-0.717391304347826,88,20,24,92,83,89,5,0.4
1977,"Hereford United",3,46,41,34,60,-26,0.891304347826087,0.739130434782609,1.30434782608696,-0.565217391304348,67,23,24,68,82,31,-15,-2
1977,"Huddersfield Town",4,46,60,63,55,8,1.30434782608696,1.3695652173913,1.19565217391304,0.173913043478261,79,11,24,92,77,99,2,3.5
1977,"Hull City",2,42,36,34,52,-18,0.857142857142857,0.80952380952381,1.23809523809524,-0.428571428571429,44,22,22,44,51,104,-7,0.8
1977,"Ipswich Town",1,42,46,47,61,-14,1.0952380952381,1.11904761904762,1.45238095238095,-0.333333333333333,18,18,22,22,4,75,14,-1.1
1977,"Leeds United",1,42,64,63,53,10,1.52380952380952,1.5,1.26190476190476,0.238095238095238,9,9,22,22,6,93,3,-1.9
1977,"Leicester City",1,42,27,26,70,-44,0.642857142857143,0.619047619047619,1.66666666666667,-1.04761904761905,22,22,22,22,40,115,-18,-1.1
1977,"Leyton Orient",2,42,48,43,49,-6,1.14285714285714,1.02380952380952,1.16666666666667,-0.142857142857143,42,20,22,44,31,102,11,-3.4
1977,"Lincoln City",3,46,60,53,61,-8,1.30434782608696,1.15217391304348,1.32608695652174,-0.173913043478261,59,15,24,68,68,107,-9,-1.9
1977,"Liverpool",1,42,81,65,34,31,1.92857142857143,1.54761904761905,0.80952380952381,0.738095238095238,2,2,22,22,1,116,1,0.1
1977,"Luton Town",2,42,52,54,52,2,1.23809523809524,1.28571428571429,1.23809523809524,0.0476190476190476,35,13,22,44,39,91,-4,2.5
1977,"Manchester City",1,42,72,74,51,23,1.71428571428571,1.76190476190476,1.21428571428571,0.547619047619048,5,5,22,22,14,117,-9,-2.5
1977,"Manchester United",1,42,58,67,63,4,1.38095238095238,1.5952380952381,1.5,0.0952380952380952,10,10,22,22,9,117,1,0.8
1977,"Mansfield Town",2,42,41,49,69,-20,0.976190476190476,1.16666666666667,1.64285714285714,-0.476190476190476,43,21,22,44,62,77,-19,-2
1977,"Middlesbrough",1,42,51,42,54,-12,1.21428571428571,1,1.28571428571429,-0.285714285714286,13,13,22,22,12,110,1,-1.1
1977,"Millwall",2,42,50,49,57,-8,1.19047619047619,1.16666666666667,1.35714285714286,-0.19047619047619,39,17,22,44,43,93,-4,1.7
1977,"Newcastle United",1,42,28,42,78,-36,0.666666666666667,1,1.85714285714286,-0.857142857142857,21,21,22,22,28,116,-7,1.3
1977,"Newport County",4,46,59,65,73,-8,1.28260869565217,1.41304347826087,1.58695652173913,-0.173913043478261,82,14,24,92,75,67,7,-1
1977,"Northampton Town",4,46,64,63,68,-5,1.39130434782609,1.3695652173913,1.47826086956522,-0.108695652173913,77,9,24,92,85,93,-8,2.7
1977,"Norwich City",1,42,51,52,66,-14,1.21428571428571,1.23809523809524,1.57142857142857,-0.333333333333333,14,14,22,22,18,93,-4,0
1977,"Nottingham Forest",1,42,89,69,24,45,2.11904761904762,1.64285714285714,0.571428571428571,1.07142857142857,1,1,22,22,3,117,-2,-0.2
1977,"Notts County",2,42,49,54,62,-8,1.16666666666667,1.28571428571429,1.47619047619048,-0.19047619047619,41,19,22,44,30,120,11,-0.7
1977,"Oldham Athletic",2,42,55,54,58,-4,1.30952380952381,1.28571428571429,1.38095238095238,-0.0952380952380952,33,11,22,44,37,102,-4,0.2
1977,"Oxford United",3,46,53,64,67,-3,1.15217391304348,1.39130434782609,1.45652173913043,-0.0652173913043478,62,18,24,68,57,54,5,4.1
1977,"Peterborough United",3,46,76,47,33,14,1.65217391304348,1.02173913043478,0.717391304347826,0.304347826086957,47,3,24,68,65,60,-18,-2.7
1977,"Plymouth Argyle",3,46,50,61,68,-7,1.08695652173913,1.32608695652174,1.47826086956522,-0.152173913043478,64,20,24,68,59,93,5,2.7
1977,"Port Vale",3,46,44,46,67,-21,0.956521739130435,1,1.45652173913043,-0.456521739130435,66,22,24,68,84,107,-18,1.1
1977,"Portsmouth",3,46,38,41,75,-34,0.826086956521739,0.891304347826087,1.6304347826087,-0.739130434782609,68,24,24,68,76,93,-8,4.9
1977,"Preston North End",3,46,76,63,38,25,1.65217391304348,1.3695652173913,0.826086956521739,0.543478260869565,48,4,24,68,34,121,14,-1.2
1977,"Queens Park Rangers",1,42,42,47,64,-17,1,1.11904761904762,1.52380952380952,-0.404761904761905,20,20,22,22,20,93,0,1.5
1977,"Reading",4,46,68,55,52,3,1.47826086956522,1.19565217391304,1.1304347826087,0.0652173913043478,76,8,24,92,69,93,7,3.3
1977,"Rochdale",4,46,32,43,85,-42,0.695652173913043,0.934782608695652,1.84782608695652,-0.91304347826087,92,24,24,92,86,92,6,0.3
1977,"Rotherham United",3,46,52,51,68,-17,1.1304347826087,1.10869565217391,1.47826086956522,-0.369565217391304,63,19,24,68,56,88,7,-0.2
1977,"Scunthorpe United",4,46,58,50,55,-5,1.26086956521739,1.08695652173913,1.19565217391304,-0.108695652173913,83,15,24,92,80,70,3,1.1
1977,"Sheffield United",2,42,56,62,73,-11,1.33333333333333,1.47619047619048,1.73809523809524,-0.261904761904762,30,8,22,44,42,117,-12,-1.2
1977,"Sheffield Wednesday",3,46,61,50,52,-2,1.32608695652174,1.08695652173913,1.1304347826087,-0.0434782608695652,58,14,24,68,61,117,-3,4.7
1977,"Shrewsbury Town",3,46,63,63,57,6,1.3695652173913,1.3695652173913,1.23913043478261,0.130434782608696,55,11,24,68,47,69,8,1.6
1977,"Southampton",2,42,79,70,39,31,1.88095238095238,1.66666666666667,0.928571428571429,0.738095238095238,24,2,22,44,15,93,9,1.2
1977,"Southend United",4,46,85,66,39,27,1.84782608695652,1.43478260869565,0.847826086956522,0.58695652173913,70,2,24,92,58,93,12,0.8
1977,"Southport",4,46,37,52,76,-24,0.804347826086957,1.1304347826087,1.65217391304348,-0.521739130434783,91,23,24,92,NA,50,NA,NA
1977,"Stockport County",4,46,58,56,56,0,1.26086956521739,1.21739130434783,1.21739130434783,0,84,16,24,92,87,99,-3,-0.4
1977,"Stoke City",2,42,58,53,49,4,1.38095238095238,1.26190476190476,1.16666666666667,0.0952380952380952,28,6,22,44,26,113,2,-0.4
1977,"Sunderland",2,42,58,67,59,8,1.38095238095238,1.5952380952381,1.4047619047619,0.19047619047619,29,7,22,44,24,119,5,-1.6
1977,"Swansea City",4,46,79,87,47,40,1.71739130434783,1.89130434782609,1.02173913043478,0.869565217391304,71,3,24,92,45,93,26,-0.4
1977,"Swindon Town",3,46,64,67,60,7,1.39130434782609,1.45652173913043,1.30434782608696,0.152173913043478,53,9,24,68,48,93,5,1.9
1977,"Torquay United",4,46,63,57,56,1,1.3695652173913,1.23913043478261,1.21739130434783,0.0217391304347826,78,10,24,92,78,78,0,0.5
1977,"Tottenham Hotspur",2,42,76,83,49,34,1.80952380952381,1.97619047619048,1.16666666666667,0.80952380952381,26,4,22,44,13,101,13,1.3
1977,"Tranmere Rovers",3,46,63,57,52,5,1.3695652173913,1.23913043478261,1.1304347826087,0.108695652173913,56,12,24,68,67,89,-11,-2.3
1977,"Walsall",3,46,71,61,50,11,1.54347826086957,1.32608695652174,1.08695652173913,0.239130434782609,49,5,24,68,66,100,-17,0.2
1977,"Watford",4,46,101,85,38,47,2.19565217391304,1.84782608695652,0.826086956521739,1.02173913043478,69,1,24,92,46,93,23,4.9
1977,"West Bromwich Albion",1,42,68,62,53,9,1.61904761904762,1.47619047619048,1.26190476190476,0.214285714285714,6,6,22,22,2,121,4,-3.5
1977,"West Ham United",1,42,44,52,69,-17,1.04761904761905,1.23809523809524,1.64285714285714,-0.404761904761905,19,19,22,22,27,94,-8,0.1
1977,"Wimbledon",4,46,58,66,67,-1,1.26086956521739,1.43478260869565,1.45652173913043,-0.0217391304347826,85,17,24,92,71,27,14,7.8
1977,"Wolverhampton Wanderers",1,42,48,51,64,-13,1.14285714285714,1.21428571428571,1.52380952380952,-0.30952380952381,15,15,22,22,17,121,-2,-5.4
1977,"Wrexham",3,46,84,78,45,33,1.82608695652174,1.69565217391304,0.978260869565217,0.717391304347826,45,1,24,68,38,80,7,-3.5
1977,"York City",4,46,48,50,69,-19,1.04347826086957,1.08695652173913,1.5,-0.41304347826087,90,22,24,92,79,72,11,2.2
1978,"AFC Bournemouth",4,46,53,47,48,-1,1.15217391304348,1.02173913043478,1.04347826086957,-0.0217391304347826,88,20,24,92,81,90,7,5.6
1978,"Aldershot",4,46,77,63,47,16,1.67391304347826,1.3695652173913,1.02173913043478,0.347826086956522,73,5,24,92,78,57,-5,0.5
1978,"Arsenal",1,42,65,61,48,13,1.54761904761905,1.45238095238095,1.14285714285714,0.30952380952381,7,7,22,22,4,116,3,0.6
1978,"Aston Villa",1,42,61,59,49,10,1.45238095238095,1.4047619047619,1.16666666666667,0.238095238095238,8,8,22,22,8,121,0,-0.9
1978,"Barnsley",4,46,85,73,42,31,1.84782608695652,1.58695652173913,0.91304347826087,0.673913043478261,72,4,24,92,57,111,15,4.5
1978,"Birmingham City",1,42,28,37,64,-27,0.666666666666667,0.880952380952381,1.52380952380952,-0.642857142857143,21,21,22,22,26,117,-5,-2.2
1978,"Blackburn Rovers",2,42,40,41,72,-31,0.952380952380952,0.976190476190476,1.71428571428571,-0.738095238095238,44,22,22,44,46,121,-2,1.9
1978,"Blackpool",3,46,63,61,59,2,1.3695652173913,1.32608695652174,1.28260869565217,0.0434782608695652,55,11,24,68,60,112,-5,-0.8
1978,"Bolton Wanderers",1,42,47,54,75,-21,1.11904761904762,1.28571428571429,1.78571428571429,-0.5,16,16,22,22,22,121,-6,-3.8
1978,"Bradford City",4,46,60,62,68,-6,1.30434782608696,1.34782608695652,1.47826086956522,-0.130434782608696,81,13,24,92,72,106,9,4.7
1978,"Brentford",3,46,66,53,49,4,1.43478260869565,1.15217391304348,1.06521739130435,0.0869565217391304,53,9,24,68,61,93,-8,0.2
1978,"Brighton & Hove Albion",2,42,79,72,39,33,1.88095238095238,1.71428571428571,0.928571428571429,0.785714285714286,23,1,22,44,18,93,5,-1.6
1978,"Bristol City",1,42,55,47,51,-4,1.30952380952381,1.11904761904762,1.21428571428571,-0.0952380952380952,11,11,22,22,21,108,-10,-4.4
1978,"Bristol Rovers",2,42,52,48,60,-12,1.23809523809524,1.14285714285714,1.42857142857143,-0.285714285714286,35,13,22,44,41,92,-6,-1.4
1978,"Burnley",2,42,54,51,62,-11,1.28571428571429,1.21428571428571,1.47619047619048,-0.261904761904762,32,10,22,44,43,121,-11,-5.2
1978,"Bury",3,46,53,59,65,-6,1.15217391304348,1.28260869565217,1.41304347826087,-0.130434782608696,63,19,24,68,63,114,0,0.7
1978,"Cambridge United",2,42,52,44,52,-8,1.23809523809524,1.04761904761905,1.23809523809524,-0.19047619047619,36,14,22,44,34,41,2,-4
1978,"Cardiff City",2,42,58,56,70,-14,1.38095238095238,1.33333333333333,1.66666666666667,-0.333333333333333,29,7,22,44,35,93,-6,-3.1
1978,"Carlisle United",3,46,67,53,42,11,1.45652173913043,1.15217391304348,0.91304347826087,0.239130434782609,52,8,24,68,51,84,1,-2.8
1978,"Charlton Athletic",2,42,46,60,69,-9,1.0952380952381,1.42857142857143,1.64285714285714,-0.214285714285714,41,19,22,44,44,92,-3,2.7
1978,"Chelsea",1,42,25,44,92,-48,0.595238095238095,1.04761904761905,2.19047619047619,-1.14285714285714,22,22,22,22,23,104,-1,0.1
1978,"Chester",3,46,58,57,61,-4,1.26086956521739,1.23913043478261,1.32608695652174,-0.0869565217391304,60,16,24,68,53,67,7,0.8
1978,"Chesterfield",3,46,53,51,65,-14,1.15217391304348,1.10869565217391,1.41304347826087,-0.304347826086957,64,20,24,68,47,100,17,-0.2
1978,"Colchester United",3,46,68,60,55,5,1.47826086956522,1.30434782608696,1.19565217391304,0.108695652173913,50,6,24,68,49,68,1,-3.9
1978,"Coventry City",1,42,58,58,68,-10,1.38095238095238,1.38095238095238,1.61904761904762,-0.238095238095238,10,10,22,22,10,94,0,0.3
1978,"Crewe Alexandra",4,46,32,43,90,-47,0.695652173913043,0.934782608695652,1.95652173913043,-1.02173913043478,92,24,24,92,90,96,2,2.1
1978,"Crystal Palace",2,42,76,51,24,27,1.80952380952381,1.21428571428571,0.571428571428571,0.642857142857143,25,3,22,44,14,93,11,0.2
1978,"Darlington",4,46,48,49,66,-17,1.04347826086957,1.06521739130435,1.43478260869565,-0.369565217391304,90,22,24,92,91,81,-1,-0.2
1978,"Derby County",1,42,41,44,71,-27,0.976190476190476,1.04761904761905,1.69047619047619,-0.642857142857143,19,19,22,22,20,121,-1,1.4
1978,"Doncaster Rovers",4,46,50,50,73,-23,1.08695652173913,1.08695652173913,1.58695652173913,-0.5,89,21,24,92,80,88,9,-0.2
1978,"Everton",1,42,68,52,40,12,1.61904761904762,1.23809523809524,0.952380952380952,0.285714285714286,5,5,22,22,19,121,-14,-0.3
1978,"Exeter City",3,46,66,61,56,5,1.43478260869565,1.32608695652174,1.21739130434783,0.108695652173913,54,10,24,68,50,88,4,-2.7
1978,"Fulham",2,42,54,50,47,3,1.28571428571429,1.19047619047619,1.11904761904762,0.0714285714285714,33,11,22,44,42,102,-9,-1.5
1978,"Gillingham",3,46,80,65,42,23,1.73913043478261,1.41304347826087,0.91304347826087,0.5,49,5,24,68,62,88,-13,-1.8
1978,"Grimsby Town",4,46,87,82,49,33,1.89130434782609,1.78260869565217,1.06521739130435,0.717391304347826,70,2,24,92,45,110,25,-0.7
1978,"Halifax Town",4,46,35,39,72,-33,0.760869565217391,0.847826086956522,1.56521739130435,-0.717391304347826,91,23,24,92,86,69,5,0.1
1978,"Hartlepool United",4,46,57,57,66,-9,1.23913043478261,1.23913043478261,1.43478260869565,-0.195652173913043,83,15,24,92,87,89,-4,-0.4
1978,"Hereford United",4,46,58,53,53,0,1.26086956521739,1.15217391304348,1.15217391304348,0,82,14,24,92,89,31,-7,-0.1
1978,"Huddersfield Town",4,46,65,57,53,4,1.41304347826087,1.23913043478261,1.15217391304348,0.0869565217391304,77,9,24,92,69,99,8,1.9
1978,"Hull City",3,46,68,66,61,5,1.47826086956522,1.43478260869565,1.32608695652174,0.108695652173913,51,7,24,68,65,104,-14,1
1978,"Ipswich Town",1,42,69,63,49,14,1.64285714285714,1.5,1.16666666666667,0.333333333333333,4,4,22,22,3,75,1,-2.4
1978,"Leeds United",1,42,68,70,52,18,1.61904761904762,1.66666666666667,1.23809523809524,0.428571428571429,6,6,22,22,12,93,-6,-2.4
1978,"Leicester City",2,42,47,43,52,-9,1.11904761904762,1.02380952380952,1.23809523809524,-0.214285714285714,40,18,22,44,24,115,16,0.5
1978,"Leyton Orient",2,42,55,51,51,0,1.30952380952381,1.21428571428571,1.21428571428571,0,31,9,22,44,38,102,-7,-4.3
1978,"Lincoln City",3,46,32,41,88,-47,0.695652173913043,0.891304347826087,1.91304347826087,-1.02173913043478,68,24,24,68,76,107,-8,-0.9
1978,"Liverpool",1,42,98,85,16,69,2.33333333333333,2.02380952380952,0.380952380952381,1.64285714285714,1,1,22,22,1,116,0,-0.1
1978,"Luton Town",2,42,49,60,57,3,1.16666666666667,1.42857142857143,1.35714285714286,0.0714285714285714,39,17,22,44,29,91,10,2.3
1978,"Manchester City",1,42,52,58,56,2,1.23809523809524,1.38095238095238,1.33333333333333,0.0476190476190476,14,14,22,22,16,117,-2,-0.8
1978,"Manchester United",1,42,60,60,63,-3,1.42857142857143,1.42857142857143,1.5,-0.0714285714285714,9,9,22,22,2,117,7,-0.2
1978,"Mansfield Town",3,46,55,51,52,-1,1.19565217391304,1.10869565217391,1.1304347826087,-0.0217391304347826,62,18,24,68,67,77,-5,0.3
1978,"Middlesbrough",1,42,55,57,50,7,1.30952380952381,1.35714285714286,1.19047619047619,0.166666666666667,12,12,22,22,9,110,3,-0.6
1978,"Millwall",2,42,43,42,61,-19,1.02380952380952,1,1.45238095238095,-0.452380952380952,43,21,22,44,58,93,-15,3.4
1978,"Newcastle United",2,42,59,51,55,-4,1.4047619047619,1.21428571428571,1.30952380952381,-0.0952380952380952,28,6,22,44,31,116,-3,0.8
1978,"Newport County",4,46,73,66,55,11,1.58695652173913,1.43478260869565,1.19565217391304,0.239130434782609,75,7,24,92,70,67,5,-0.7
1978,"Northampton Town",4,46,54,64,76,-12,1.17391304347826,1.39130434782609,1.65217391304348,-0.260869565217391,85,17,24,92,79,93,6,2.1
1978,"Norwich City",1,42,44,51,57,-6,1.04761904761905,1.21428571428571,1.35714285714286,-0.142857142857143,18,18,22,22,13,93,5,1.4
1978,"Nottingham Forest",1,42,81,61,26,35,1.92857142857143,1.45238095238095,0.619047619047619,0.833333333333333,3,3,22,22,5,117,-2,0
1978,"Notts County",2,42,58,48,60,-12,1.38095238095238,1.14285714285714,1.42857142857143,-0.285714285714286,30,8,22,44,40,120,-10,-2.3
1978,"Oldham Athletic",2,42,52,52,61,-9,1.23809523809524,1.23809523809524,1.45238095238095,-0.214285714285714,37,15,22,44,32,102,5,0.1
1978,"Oxford United",3,46,60,44,50,-6,1.30434782608696,0.956521739130435,1.08695652173913,-0.130434782608696,57,13,24,68,64,54,-7,2
1978,"Peterborough United",3,46,47,44,63,-19,1.02173913043478,0.956521739130435,1.3695652173913,-0.41304347826087,65,21,24,68,75,60,-10,-2
1978,"Plymouth Argyle",3,46,59,67,68,-1,1.28260869565217,1.45652173913043,1.47826086956522,-0.0217391304347826,59,15,24,68,59,93,0,2.1
1978,"Port Vale",4,46,56,57,70,-13,1.21739130434783,1.23913043478261,1.52173913043478,-0.282608695652174,84,16,24,92,88,107,-4,3.8
1978,"Portsmouth",4,46,72,62,48,14,1.56521739130435,1.34782608695652,1.04347826086957,0.304347826086957,76,8,24,92,73,93,3,3.6
1978,"Preston North End",2,42,54,59,57,2,1.28571428571429,1.4047619047619,1.35714285714286,0.0476190476190476,34,12,22,44,36,121,-2,-1.6
1978,"Queens Park Rangers",1,42,31,45,73,-28,0.738095238095238,1.07142857142857,1.73809523809524,-0.666666666666667,20,20,22,22,27,93,-7,1
1978,"Reading",4,46,91,76,35,41,1.97826086956522,1.65217391304348,0.760869565217391,0.891304347826087,69,1,24,92,54,93,15,0.8
1978,"Rochdale",4,46,54,47,64,-17,1.17391304347826,1.02173913043478,1.39130434782609,-0.369565217391304,86,18,24,92,92,92,-6,0
1978,"Rotherham United",3,46,61,49,55,-6,1.32608695652174,1.06521739130435,1.19565217391304,-0.130434782608696,56,12,24,68,55,88,1,-1.3
1978,"Scunthorpe United",4,46,62,54,60,-6,1.34782608695652,1.17391304347826,1.30434782608696,-0.130434782608696,80,12,24,92,82,70,-2,0.7
1978,"Sheffield United",2,42,45,52,69,-17,1.07142857142857,1.23809523809524,1.64285714285714,-0.404761904761905,42,20,22,44,56,117,-14,-0.5
1978,"Sheffield Wednesday",3,46,58,53,53,0,1.26086956521739,1.15217391304348,1.15217391304348,0,61,17,24,68,48,117,13,4.6
1978,"Shrewsbury Town",3,46,82,61,41,20,1.78260869565217,1.32608695652174,0.891304347826087,0.434782608695652,47,3,24,68,33,69,14,0.5
1978,"Southampton",1,42,52,47,53,-6,1.23809523809524,1.11904761904762,1.26190476190476,-0.142857142857143,15,15,22,22,7,93,8,0.2
1978,"Southend United",3,46,60,51,49,2,1.30434782608696,1.10869565217391,1.06521739130435,0.0434782608695652,58,14,24,68,66,93,-8,-0.7
1978,"Stockport County",4,46,54,58,60,-2,1.17391304347826,1.26086956521739,1.30434782608696,-0.0434782608695652,87,19,24,92,84,99,3,-0.1
1978,"Stoke City",2,42,76,58,31,27,1.80952380952381,1.38095238095238,0.738095238095238,0.642857142857143,26,4,22,44,17,113,9,-0.7
1978,"Sunderland",2,42,77,70,44,26,1.83333333333333,1.66666666666667,1.04761904761905,0.619047619047619,24,2,22,44,25,119,-1,-0.7
1978,"Swansea City",3,46,84,83,61,22,1.82608695652174,1.80434782608696,1.32608695652174,0.478260869565217,45,1,24,68,30,93,15,-1.2
1978,"Swindon Town",3,46,82,74,52,22,1.78260869565217,1.60869565217391,1.1304347826087,0.478260869565217,48,4,24,68,52,93,-4,2.2
1978,"Torquay United",4,46,65,58,65,-7,1.41304347826087,1.26086956521739,1.41304347826087,-0.152173913043478,78,10,24,92,77,78,1,-0.4
1978,"Tottenham Hotspur",1,42,54,48,61,-13,1.28571428571429,1.14285714285714,1.45238095238095,-0.30952380952381,13,13,22,22,11,101,2,0.7
1978,"Tranmere Rovers",3,46,34,45,78,-33,0.739130434782609,0.978260869565217,1.69565217391304,-0.717391304347826,67,23,24,68,83,89,-16,-0.3
1978,"Walsall",3,46,42,56,71,-15,0.91304347826087,1.21739130434783,1.54347826086957,-0.326086956521739,66,22,24,68,71,100,-5,2.2
1978,"Watford",3,46,84,83,52,31,1.82608695652174,1.80434782608696,1.1304347826087,0.673913043478261,46,2,24,68,39,93,7,2.2
1978,"West Bromwich Albion",1,42,83,72,35,37,1.97619047619048,1.71428571428571,0.833333333333333,0.880952380952381,2,2,22,22,15,121,-13,-2.7
1978,"West Ham United",2,42,68,70,39,31,1.61904761904762,1.66666666666667,0.928571428571429,0.738095238095238,27,5,22,44,28,94,-1,0.8
1978,"Wigan Athletic",4,46,76,63,48,15,1.65217391304348,1.3695652173913,1.04347826086957,0.326086956521739,74,6,24,92,74,42,0,1.2
1978,"Wimbledon",4,46,86,78,46,32,1.8695652173913,1.69565217391304,1,0.695652173913043,71,3,24,92,68,27,3,5.9
1978,"Wolverhampton Wanderers",1,42,47,44,68,-24,1.11904761904762,1.04761904761905,1.61904761904762,-0.571428571428571,17,17,22,22,6,121,11,-2.8
1978,"Wrexham",2,42,50,45,42,3,1.19047619047619,1.07142857142857,1,0.0714285714285714,38,16,22,44,37,80,1,-3.7
1978,"York City",4,46,65,51,55,-4,1.41304347826087,1.10869565217391,1.19565217391304,-0.0869565217391304,79,11,24,92,85,72,-6,0
1979,"AFC Bournemouth",4,46,57,52,51,1,1.23913043478261,1.1304347826087,1.10869565217391,0.0217391304347826,81,13,24,92,81,90,0,3.9
1979,"Aldershot",4,46,61,62,53,9,1.32608695652174,1.34782608695652,1.15217391304348,0.195652173913043,78,10,24,92,76,57,2,-1.2
1979,"Arsenal",1,42,70,52,36,16,1.66666666666667,1.23809523809524,0.857142857142857,0.380952380952381,4,4,22,22,3,116,1,0
1979,"Aston Villa",1,42,62,51,50,1,1.47619047619048,1.21428571428571,1.19047619047619,0.0238095238095238,8,8,22,22,1,121,7,0.6
1979,"Barnsley",3,46,62,53,56,-3,1.34782608695652,1.15217391304348,1.21739130434783,-0.0652173913043478,57,13,24,68,47,111,10,2
1979,"Birmingham City",2,42,74,58,38,20,1.76190476190476,1.38095238095238,0.904761904761905,0.476190476190476,26,4,22,44,14,117,12,-2.5
1979,"Blackburn Rovers",3,46,84,58,36,22,1.82608695652174,1.26086956521739,0.782608695652174,0.478260869565217,46,2,24,68,26,121,20,2.2
1979,"Blackpool",3,46,56,62,74,-12,1.21739130434783,1.34782608695652,1.60869565217391,-0.260869565217391,60,16,24,68,67,112,-7,-0.7
1979,"Bolton Wanderers",1,42,30,38,73,-35,0.714285714285714,0.904761904761905,1.73809523809524,-0.833333333333333,22,22,22,22,36,121,-14,-2.8
1979,"Bradford City",4,46,84,77,50,27,1.82608695652174,1.67391304347826,1.08695652173913,0.58695652173913,72,4,24,92,83,106,-11,2.9
1979,"Brentford",3,46,56,59,73,-14,1.21739130434783,1.28260869565217,1.58695652173913,-0.304347826086957,61,17,24,68,54,93,7,0.4
1979,"Brighton & Hove Albion",1,42,48,47,57,-10,1.14285714285714,1.11904761904762,1.35714285714286,-0.238095238095238,18,18,22,22,15,93,3,-2
1979,"Bristol City",1,42,40,37,66,-29,0.952380952380952,0.880952380952381,1.57142857142857,-0.69047619047619,21,21,22,22,43,108,-22,-2.5
1979,"Bristol Rovers",2,42,46,50,64,-14,1.0952380952381,1.19047619047619,1.52380952380952,-0.333333333333333,41,19,22,44,44,92,-3,-0.4
1979,"Burnley",2,42,33,39,73,-34,0.785714285714286,0.928571428571429,1.73809523809524,-0.80952380952381,43,21,22,44,52,121,-9,-4.1
1979,"Bury",3,46,55,45,59,-14,1.19565217391304,0.978260869565217,1.28260869565217,-0.304347826086957,63,19,24,68,80,114,-17,1.4
1979,"Cambridge United",2,42,58,61,53,8,1.38095238095238,1.45238095238095,1.26190476190476,0.19047619047619,34,12,22,44,33,41,1,-3.9
1979,"Cardiff City",2,42,56,41,48,-7,1.33333333333333,0.976190476190476,1.14285714285714,-0.166666666666667,35,13,22,44,41,93,-6,-3
1979,"Carlisle United",3,46,66,66,56,10,1.43478260869565,1.43478260869565,1.21739130434783,0.217391304347826,51,7,24,68,61,84,-10,-2.4
1979,"Charlton Athletic",2,42,28,39,78,-39,0.666666666666667,0.928571428571429,1.85714285714286,-0.928571428571429,44,22,22,44,46,92,-2,2.5
1979,"Chelsea",2,42,76,66,52,14,1.80952380952381,1.57142857142857,1.23809523809524,0.333333333333333,23,1,22,44,35,104,-12,1.8
1979,"Chester",3,46,64,49,57,-8,1.39130434782609,1.06521739130435,1.23913043478261,-0.173913043478261,53,9,24,68,58,67,-5,-0.7
1979,"Chesterfield",3,46,80,71,46,25,1.73913043478261,1.54347826086957,1,0.543478260869565,47,3,24,68,48,100,-1,-2.9
1979,"Colchester United",3,46,72,64,56,8,1.56521739130435,1.39130434782609,1.21739130434783,0.173913043478261,49,5,24,68,66,68,-17,-4.3
1979,"Coventry City",1,42,55,56,66,-10,1.30952380952381,1.33333333333333,1.57142857142857,-0.238095238095238,10,10,22,22,16,94,-6,-0.2
1979,"Crewe Alexandra",4,46,46,35,68,-33,1,0.760869565217391,1.47826086956522,-0.717391304347826,90,22,24,92,86,96,4,3.4
1979,"Crystal Palace",1,42,52,41,50,-9,1.23809523809524,0.976190476190476,1.19047619047619,-0.214285714285714,14,14,22,22,22,93,-8,0.1
1979,"Darlington",4,46,44,50,74,-24,0.956521739130435,1.08695652173913,1.60869565217391,-0.521739130434783,91,23,24,92,77,81,14,2.2
1979,"Derby County",1,42,41,47,67,-20,0.976190476190476,1.11904761904762,1.5952380952381,-0.476190476190476,20,20,22,22,28,121,-8,0.4
1979,"Doncaster Rovers",4,46,59,62,63,-1,1.28260869565217,1.34782608695652,1.3695652173913,-0.0217391304347826,80,12,24,92,71,88,9,-0.8
1979,"Everton",1,42,44,43,51,-8,1.04761904761905,1.02380952380952,1.21428571428571,-0.19047619047619,19,19,22,22,17,121,2,1.3
1979,"Exeter City",3,46,67,60,68,-8,1.45652173913043,1.30434782608696,1.47826086956522,-0.173913043478261,50,6,24,68,55,88,-5,-1.9
1979,"Fulham",2,42,40,42,74,-32,0.952380952380952,1,1.76190476190476,-0.761904761904762,42,20,22,44,56,102,-14,-2.2
1979,"Gillingham",3,46,56,49,51,-2,1.21739130434783,1.06521739130435,1.10869565217391,-0.0434782608695652,62,18,24,68,62,88,0,-2
1979,"Grimsby Town",3,46,88,73,42,31,1.91304347826087,1.58695652173913,0.91304347826087,0.673913043478261,45,1,24,68,29,110,16,-2.5
1979,"Halifax Town",4,46,52,46,72,-26,1.1304347826087,1,1.56521739130435,-0.565217391304348,86,18,24,92,91,69,-5,-0.5
1979,"Hartlepool United",4,46,52,59,64,-5,1.1304347826087,1.28260869565217,1.39130434782609,-0.108695652173913,87,19,24,92,73,89,14,0.2
1979,"Hereford United",4,46,47,38,52,-14,1.02173913043478,0.826086956521739,1.1304347826087,-0.304347826086957,89,21,24,92,90,31,-1,0.3
1979,"Huddersfield Town",4,46,93,101,48,53,2.02173913043478,2.19565217391304,1.04347826086957,1.15217391304348,69,1,24,92,49,99,20,1.7
1979,"Hull City",3,46,52,51,69,-18,1.1304347826087,1.10869565217391,1.5,-0.391304347826087,65,21,24,68,68,104,-3,3.1
1979,"Ipswich Town",1,42,75,68,39,29,1.78571428571429,1.61904761904762,0.928571428571429,0.69047619047619,3,3,22,22,2,75,1,-2.6
1979,"Leeds United",1,42,53,46,50,-4,1.26190476190476,1.0952380952381,1.19047619047619,-0.0952380952380952,12,12,22,22,9,93,3,-0.9
1979,"Leicester City",2,42,76,58,38,20,1.80952380952381,1.38095238095238,0.904761904761905,0.476190476190476,24,2,22,44,21,115,3,-0.9
1979,"Leyton Orient",2,42,53,48,54,-6,1.26190476190476,1.14285714285714,1.28571428571429,-0.142857142857143,38,16,22,44,37,102,1,-2
1979,"Lincoln City",4,46,71,64,42,22,1.54347826086957,1.39130434782609,0.91304347826087,0.478260869565217,76,8,24,92,70,107,6,-0.6
1979,"Liverpool",1,42,85,81,30,51,2.02380952380952,1.92857142857143,0.714285714285714,1.21428571428571,1,1,22,22,7,116,-6,0
1979,"Luton Town",2,42,65,66,45,21,1.54761904761905,1.57142857142857,1.07142857142857,0.5,29,7,22,44,27,91,2,1.2
1979,"Manchester City",1,42,49,43,66,-23,1.16666666666667,1.02380952380952,1.57142857142857,-0.547619047619048,16,16,22,22,12,117,4,0.2
1979,"Manchester United",1,42,82,65,35,30,1.95238095238095,1.54761904761905,0.833333333333333,0.714285714285714,2,2,22,22,8,117,-6,-1.3
1979,"Mansfield Town",3,46,46,47,58,-11,1,1.02173913043478,1.26086956521739,-0.239130434782609,67,23,24,68,74,77,-7,0.8
1979,"Middlesbrough",1,42,60,50,44,6,1.42857142857143,1.19047619047619,1.04761904761905,0.142857142857143,9,9,22,22,13,110,-4,-3.2
1979,"Millwall",3,46,61,65,59,6,1.32608695652174,1.41304347826087,1.28260869565217,0.130434782608696,58,14,24,68,59,93,-1,3.8
1979,"Newcastle United",2,42,59,53,49,4,1.4047619047619,1.26190476190476,1.16666666666667,0.0952380952380952,31,9,22,44,34,116,-3,0.8
1979,"Newport County",4,46,88,83,50,33,1.91304347826087,1.80434782608696,1.08695652173913,0.717391304347826,70,2,24,92,57,67,13,-0.7
1979,"Northampton Town",4,46,60,51,66,-15,1.30434782608696,1.10869565217391,1.43478260869565,-0.326086956521739,79,11,24,92,78,93,1,1.3
1979,"Norwich City",1,42,53,58,66,-8,1.26190476190476,1.38095238095238,1.57142857142857,-0.19047619047619,13,13,22,22,20,93,-7,0.3
1979,"Nottingham Forest",1,42,68,63,43,20,1.61904761904762,1.5,1.02380952380952,0.476190476190476,5,5,22,22,6,117,-1,-0.4
1979,"Notts County",2,42,48,51,52,-1,1.14285714285714,1.21428571428571,1.23809523809524,-0.0238095238095238,40,18,22,44,24,120,16,-0.7
1979,"Oldham Athletic",2,42,59,49,53,-4,1.4047619047619,1.16666666666667,1.26190476190476,-0.0952380952380952,32,10,22,44,38,102,-6,0.4
1979,"Oxford United",3,46,55,57,62,-5,1.19565217391304,1.23913043478261,1.34782608695652,-0.108695652173913,64,20,24,68,60,54,4,2.5
1979,"Peterborough United",4,46,73,58,47,11,1.58695652173913,1.26086956521739,1.02173913043478,0.239130434782609,75,7,24,92,75,60,0,-0.3
1979,"Plymouth Argyle",3,46,60,59,55,4,1.30434782608696,1.28260869565217,1.19565217391304,0.0869565217391304,59,15,24,68,51,93,8,2.3
1979,"Port Vale",4,46,48,56,70,-14,1.04347826086957,1.21739130434783,1.52173913043478,-0.304347826086957,88,20,24,92,88,107,0,5.7
1979,"Portsmouth",4,46,84,91,49,42,1.82608695652174,1.97826086956522,1.06521739130435,0.91304347826087,73,5,24,92,50,93,23,4.1
1979,"Preston North End",2,42,55,56,52,4,1.30952380952381,1.33333333333333,1.23809523809524,0.0952380952380952,36,14,22,44,42,121,-6,-2.7
1979,"Queens Park Rangers",2,42,67,75,53,22,1.5952380952381,1.78571428571429,1.26190476190476,0.523809523809524,27,5,22,44,32,93,-5,1.6
1979,"Reading",3,46,64,66,65,1,1.39130434782609,1.43478260869565,1.41304347826087,0.0217391304347826,54,10,24,68,53,93,1,0.1
1979,"Rochdale",4,46,34,33,79,-46,0.739130434782609,0.717391304347826,1.71739130434783,-1,92,24,24,92,84,92,8,1.3
1979,"Rotherham United",3,46,64,58,66,-8,1.39130434782609,1.26086956521739,1.43478260869565,-0.173913043478261,55,11,24,68,45,88,10,0.1
1979,"Scunthorpe United",4,46,57,58,75,-17,1.23913043478261,1.26086956521739,1.6304347826087,-0.369565217391304,82,14,24,92,87,70,-5,0.2
1979,"Sheffield United",3,46,64,60,66,-6,1.39130434782609,1.30434782608696,1.43478260869565,-0.130434782608696,56,12,24,68,63,117,-7,3.4
1979,"Sheffield Wednesday",3,46,79,81,47,34,1.71739130434783,1.76086956521739,1.02173913043478,0.739130434782609,48,4,24,68,30,117,18,3
1979,"Shrewsbury Town",2,42,59,60,53,7,1.4047619047619,1.42857142857143,1.26190476190476,0.166666666666667,33,11,22,44,39,69,-6,-2.2
1979,"Southampton",1,42,63,65,53,12,1.5,1.54761904761905,1.26190476190476,0.285714285714286,7,7,22,22,5,93,2,0
1979,"Southend United",3,46,52,47,58,-11,1.1304347826087,1.02173913043478,1.26086956521739,-0.239130434782609,66,22,24,68,69,93,-3,-0.5
1979,"Stockport County",4,46,54,48,72,-24,1.17391304347826,1.04347826086957,1.56521739130435,-0.521739130434783,84,16,24,92,85,99,-1,1.2
1979,"Stoke City",1,42,49,44,58,-14,1.16666666666667,1.04761904761905,1.38095238095238,-0.333333333333333,17,17,22,22,11,113,6,-2.7
1979,"Sunderland",2,42,75,69,42,27,1.78571428571429,1.64285714285714,1,0.642857142857143,25,3,22,44,18,119,7,0
1979,"Swansea City",2,42,60,48,53,-5,1.42857142857143,1.14285714285714,1.26190476190476,-0.119047619047619,30,8,22,44,25,93,5,-3.1
1979,"Swindon Town",3,46,65,71,63,8,1.41304347826087,1.54347826086957,1.3695652173913,0.173913043478261,52,8,24,68,64,93,-12,2.6
1979,"Torquay United",4,46,62,70,69,1,1.34782608695652,1.52173913043478,1.5,0.0217391304347826,77,9,24,92,82,78,-5,-0.6
1979,"Tottenham Hotspur",1,42,55,52,62,-10,1.30952380952381,1.23809523809524,1.47619047619048,-0.238095238095238,11,11,22,22,10,101,1,0.8
1979,"Tranmere Rovers",4,46,55,50,56,-6,1.19565217391304,1.08695652173913,1.21739130434783,-0.130434782608696,83,15,24,92,89,89,-6,3.5
1979,"Walsall",4,46,87,75,47,28,1.89130434782609,1.6304347826087,1.02173913043478,0.608695652173913,71,3,24,92,65,100,6,0.3
1979,"Watford",2,42,49,39,46,-7,1.16666666666667,0.928571428571429,1.0952380952381,-0.166666666666667,39,17,22,44,31,93,8,0.4
1979,"West Bromwich Albion",1,42,52,54,50,4,1.23809523809524,1.28571428571429,1.19047619047619,0.0952380952380952,15,15,22,22,4,121,11,-2.5
1979,"West Ham United",2,42,67,54,43,11,1.5952380952381,1.28571428571429,1.02380952380952,0.261904761904762,28,6,22,44,23,94,5,0.1
1979,"Wigan Athletic",4,46,76,76,61,15,1.65217391304348,1.65217391304348,1.32608695652174,0.326086956521739,74,6,24,92,79,42,-5,1.2
1979,"Wimbledon",3,46,44,52,81,-29,0.956521739130435,1.1304347826087,1.76086956521739,-0.630434782608696,68,24,24,68,72,27,-4,6
1979,"Wolverhampton Wanderers",1,42,66,58,47,11,1.57142857142857,1.38095238095238,1.11904761904762,0.261904761904762,6,6,22,22,19,121,-13,-2.4
1979,"Wrexham",2,42,54,40,49,-9,1.28571428571429,0.952380952380952,1.16666666666667,-0.214285714285714,37,15,22,44,40,80,-3,-5.2
1979,"York City",4,46,53,65,82,-17,1.15217391304348,1.41304347826087,1.78260869565217,-0.369565217391304,85,17,24,92,92,72,-7,0.4
1980,"AFC Bournemouth",4,46,61,47,48,-1,1.32608695652174,1.02173913043478,1.04347826086957,-0.0217391304347826,81,13,24,92,72,90,9,2.9
1980,"Aldershot",4,46,68,43,41,2,1.47826086956522,0.934782608695652,0.891304347826087,0.0434782608695652,76,8,24,92,84,57,-8,-1.5
1980,"Arsenal",1,42,72,61,45,16,1.71428571428571,1.45238095238095,1.07142857142857,0.380952380952381,3,3,22,22,4,116,-1,0.2
1980,"Aston Villa",1,42,86,72,40,32,2.04761904761905,1.71428571428571,0.952380952380952,0.761904761904762,1,1,22,22,11,121,-10,-1.6
1980,"Barnsley",3,46,80,72,45,27,1.73913043478261,1.56521739130435,0.978260869565217,0.58695652173913,47,3,24,68,28,111,19,2
1980,"Birmingham City",1,42,51,50,61,-11,1.21428571428571,1.19047619047619,1.45238095238095,-0.261904761904762,14,14,22,22,16,117,-2,-4.2
1980,"Blackburn Rovers",2,42,66,42,29,13,1.57142857142857,1,0.69047619047619,0.30952380952381,26,4,22,44,32,121,-6,-1.3
1980,"Blackpool",3,46,41,45,75,-30,0.891304347826087,0.978260869565217,1.6304347826087,-0.652173913043478,67,23,24,68,80,112,-13,-0.6
1980,"Bolton Wanderers",2,42,52,61,66,-5,1.23809523809524,1.45238095238095,1.57142857142857,-0.119047619047619,36,14,22,44,39,121,-3,-1.1
1980,"Bradford City",4,46,58,53,60,-7,1.26086956521739,1.15217391304348,1.30434782608696,-0.152173913043478,83,15,24,92,70,106,13,3
1980,"Brentford",3,46,61,52,49,3,1.32608695652174,1.1304347826087,1.06521739130435,0.0652173913043478,54,10,24,68,52,93,2,0.4
1980,"Brighton & Hove Albion",1,42,49,54,67,-13,1.16666666666667,1.28571428571429,1.5952380952381,-0.30952380952381,15,15,22,22,13,93,2,-1.1
1980,"Bristol City",2,42,37,29,51,-22,0.880952380952381,0.69047619047619,1.21428571428571,-0.523809523809524,43,21,22,44,67,108,-24,1.4
1980,"Bristol Rovers",2,42,28,34,65,-31,0.666666666666667,0.80952380952381,1.54761904761905,-0.738095238095238,44,22,22,44,56,92,-12,1.2
1980,"Burnley",3,46,68,60,48,12,1.47826086956522,1.30434782608696,1.04347826086957,0.260869565217391,52,8,24,68,45,121,7,-2.2
1980,"Bury",4,46,62,70,62,8,1.34782608695652,1.52173913043478,1.34782608695652,0.173913043478261,80,12,24,92,77,114,3,2.9
1980,"Cambridge United",2,42,57,53,65,-12,1.35714285714286,1.26190476190476,1.54761904761905,-0.285714285714286,33,11,22,44,36,41,-3,-1.2
1980,"Cardiff City",2,42,48,44,60,-16,1.14285714285714,1.04761904761905,1.42857142857143,-0.380952380952381,41,19,22,44,42,93,-1,-4
1980,"Carlisle United",3,46,55,56,70,-14,1.19565217391304,1.21739130434783,1.52173913043478,-0.304347826086957,61,17,24,68,46,84,15,-2.7
1980,"Charlton Athletic",3,46,84,63,44,19,1.82608695652174,1.3695652173913,0.956521739130435,0.41304347826087,46,2,24,68,35,92,11,1
1980,"Chelsea",2,42,54,46,41,5,1.28571428571429,1.0952380952381,0.976190476190476,0.119047619047619,35,13,22,44,34,104,1,2.5
1980,"Chester",3,46,56,38,48,-10,1.21739130434783,0.826086956521739,1.04347826086957,-0.217391304347826,58,14,24,68,68,67,-10,-0.5
1980,"Chesterfield",3,46,79,72,48,24,1.71739130434783,1.56521739130435,1.04347826086957,0.521739130434783,48,4,24,68,55,100,-7,-3.6
1980,"Colchester United",3,46,53,45,65,-20,1.15217391304348,0.978260869565217,1.41304347826087,-0.434782608695652,66,22,24,68,74,68,-8,-1.4
1980,"Coventry City",1,42,49,48,68,-20,1.16666666666667,1.14285714285714,1.61904761904762,-0.476190476190476,16,16,22,22,14,94,2,0
1980,"Crewe Alexandra",4,46,53,48,61,-13,1.15217391304348,1.04347826086957,1.32608695652174,-0.282608695652174,86,18,24,92,92,96,-6,2
1980,"Crystal Palace",1,42,25,47,83,-36,0.595238095238095,1.11904761904762,1.97619047619048,-0.857142857142857,22,22,22,22,37,93,-15,1.9
1980,"Darlington",4,46,68,65,59,6,1.47826086956522,1.41304347826087,1.28260869565217,0.130434782608696,77,9,24,92,81,81,-4,0.7
1980,"Derby County",2,42,60,57,52,5,1.42857142857143,1.35714285714286,1.23809523809524,0.119047619047619,28,6,22,44,38,121,-10,0.8
1980,"Doncaster Rovers",4,46,78,59,49,10,1.69565217391304,1.28260869565217,1.06521739130435,0.217391304347826,71,3,24,92,63,88,8,-0.8
1980,"Everton",1,42,49,55,58,-3,1.16666666666667,1.30952380952381,1.38095238095238,-0.0714285714285714,17,17,22,22,8,121,9,0.8
1980,"Exeter City",3,46,61,62,66,-4,1.32608695652174,1.34782608695652,1.43478260869565,-0.0869565217391304,55,11,24,68,61,88,-6,-0.5
1980,"Fulham",3,46,58,57,64,-7,1.26086956521739,1.23913043478261,1.39130434782609,-0.152173913043478,56,12,24,68,47,102,9,-0.9
1980,"Gillingham",3,46,54,48,58,-10,1.17391304347826,1.04347826086957,1.26086956521739,-0.217391304347826,62,18,24,68,49,88,13,-2.1
1980,"Grimsby Town",2,42,60,44,42,2,1.42857142857143,1.04761904761905,1,0.0476190476190476,29,7,22,44,40,110,-11,-1.9
1980,"Halifax Town",4,46,45,44,71,-27,0.978260869565217,0.956521739130435,1.54347826086957,-0.58695652173913,91,23,24,92,86,69,5,0.2
1980,"Hartlepool United",4,46,69,64,61,3,1.5,1.39130434782609,1.32608695652174,0.0652173913043478,73,5,24,92,82,89,-9,0.3
1980,"Hereford United",4,46,46,38,62,-24,1,0.826086956521739,1.34782608695652,-0.521739130434783,90,22,24,92,78,31,12,0.5
1980,"Huddersfield Town",3,46,77,71,40,31,1.67391304347826,1.54347826086957,0.869565217391304,0.673913043478261,49,5,24,68,62,99,-13,-0.6
1980,"Hull City",3,46,40,40,71,-31,0.869565217391304,0.869565217391304,1.54347826086957,-0.673913043478261,68,24,24,68,76,104,-8,2.4
1980,"Ipswich Town",1,42,79,77,43,34,1.88095238095238,1.83333333333333,1.02380952380952,0.80952380952381,2,2,22,22,2,75,0,-3.2
1980,"Leeds United",1,42,61,39,47,-8,1.45238095238095,0.928571428571429,1.11904761904762,-0.19047619047619,9,9,22,22,20,93,-11,0.5
1980,"Leicester City",1,42,45,40,67,-27,1.07142857142857,0.952380952380952,1.5952380952381,-0.642857142857143,21,21,22,22,30,115,-9,-2
1980,"Leyton Orient",2,42,51,52,56,-4,1.21428571428571,1.23809523809524,1.33333333333333,-0.0952380952380952,37,15,22,44,44,102,-7,-2
1980,"Lincoln City",4,46,90,66,25,41,1.95652173913043,1.43478260869565,0.543478260869565,0.891304347826087,70,2,24,92,48,107,22,-1
1980,"Liverpool",1,42,68,62,42,20,1.61904761904762,1.47619047619048,1,0.476190476190476,7,7,22,22,1,116,6,0.5
1980,"Luton Town",2,42,66,61,46,15,1.57142857142857,1.45238095238095,1.0952380952381,0.357142857142857,27,5,22,44,23,91,4,0.9
1980,"Manchester City",1,42,53,56,59,-3,1.26190476190476,1.33333333333333,1.4047619047619,-0.0714285714285714,12,12,22,22,9,117,3,0.7
1980,"Manchester United",1,42,63,51,36,15,1.5,1.21428571428571,0.857142857142857,0.357142857142857,8,8,22,22,3,117,5,0.2
1980,"Mansfield Town",4,46,69,58,44,14,1.5,1.26086956521739,0.956521739130435,0.304347826086957,74,6,24,92,87,77,-13,0.6
1980,"Middlesbrough",1,42,53,53,61,-8,1.26190476190476,1.26190476190476,1.45238095238095,-0.19047619047619,13,13,22,22,22,110,-9,-1.5
1980,"Millwall",3,46,56,43,60,-17,1.21739130434783,0.934782608695652,1.30434782608696,-0.369565217391304,59,15,24,68,53,93,6,3.4
1980,"Newcastle United",2,42,56,30,45,-15,1.33333333333333,0.714285714285714,1.07142857142857,-0.357142857142857,34,12,22,44,31,116,3,0.3
1980,"Newport County",3,46,58,64,61,3,1.26086956521739,1.39130434782609,1.32608695652174,0.0652173913043478,57,13,24,68,60,67,-3,-3.3
1980,"Northampton Town",4,46,67,65,67,-2,1.45652173913043,1.41304347826087,1.45652173913043,-0.0434782608695652,78,10,24,92,90,93,-12,0
1980,"Norwich City",1,42,46,49,73,-24,1.0952380952381,1.16666666666667,1.73809523809524,-0.571428571428571,20,20,22,22,25,93,-5,0.6
1980,"Nottingham Forest",1,42,69,62,44,18,1.64285714285714,1.47619047619048,1.04761904761905,0.428571428571429,6,6,22,22,12,117,-6,-0.2
1980,"Notts County",2,42,71,49,38,11,1.69047619047619,1.16666666666667,0.904761904761905,0.261904761904762,24,2,22,44,15,120,9,0
1980,"Oldham Athletic",2,42,51,39,48,-9,1.21428571428571,0.928571428571429,1.14285714285714,-0.214285714285714,38,16,22,44,33,102,5,1.7
1980,"Oxford United",3,46,56,39,47,-8,1.21739130434783,0.847826086956522,1.02173913043478,-0.173913043478261,60,16,24,68,50,54,10,3
1980,"Peterborough United",4,46,69,68,54,14,1.5,1.47826086956522,1.17391304347826,0.304347826086957,75,7,24,92,73,60,2,0.3
1980,"Plymouth Argyle",3,46,71,56,44,12,1.54347826086957,1.21739130434783,0.956521739130435,0.260869565217391,51,7,24,68,54,93,-3,1.4
1980,"Port Vale",4,46,51,57,70,-13,1.10869565217391,1.23913043478261,1.52173913043478,-0.282608695652174,88,20,24,92,75,107,13,5.3
1980,"Portsmouth",3,46,75,55,47,8,1.6304347826087,1.19565217391304,1.02173913043478,0.173913043478261,50,6,24,68,58,93,-8,1.2
1980,"Preston North End",2,42,47,41,62,-21,1.11904761904762,0.976190476190476,1.47619047619048,-0.5,42,20,22,44,59,121,-17,-1.9
1980,"Queens Park Rangers",2,42,58,56,46,10,1.38095238095238,1.33333333333333,1.0952380952381,0.238095238095238,32,10,22,44,27,93,5,2
1980,"Reading",3,46,64,62,62,0,1.39130434782609,1.34782608695652,1.34782608695652,0,53,9,24,68,57,93,-4,-0.6
1980,"Rochdale",4,46,57,60,70,-10,1.23913043478261,1.30434782608696,1.52173913043478,-0.217391304347826,84,16,24,92,89,92,-5,0.4
1980,"Rotherham United",3,46,85,62,32,30,1.84782608695652,1.34782608695652,0.695652173913043,0.652173913043478,45,1,24,68,29,88,16,-2.2
1980,"Scunthorpe United",4,46,53,60,69,-9,1.15217391304348,1.30434782608696,1.5,-0.195652173913043,87,19,24,92,91,70,-4,1.1
1980,"Sheffield United",3,46,54,65,63,2,1.17391304347826,1.41304347826087,1.3695652173913,0.0434782608695652,63,19,24,68,69,117,-6,5
1980,"Sheffield Wednesday",2,42,59,53,51,2,1.4047619047619,1.26190476190476,1.21428571428571,0.0476190476190476,30,8,22,44,26,117,4,0.7
1980,"Shrewsbury Town",2,42,50,46,47,-1,1.19047619047619,1.0952380952381,1.11904761904762,-0.0238095238095238,39,17,22,44,41,69,-2,-2.3
1980,"Southampton",1,42,70,76,56,20,1.66666666666667,1.80952380952381,1.33333333333333,0.476190476190476,5,5,22,22,7,93,-2,-1
1980,"Southend United",4,46,97,79,31,48,2.10869565217391,1.71739130434783,0.673913043478261,1.04347826086957,69,1,24,92,51,93,18,2.3
1980,"Stockport County",4,46,55,44,57,-13,1.19565217391304,0.956521739130435,1.23913043478261,-0.282608695652174,85,17,24,92,88,99,-3,1.4
1980,"Stoke City",1,42,54,51,60,-9,1.28571428571429,1.21428571428571,1.42857142857143,-0.214285714285714,11,11,22,22,17,113,-6,-4.7
1980,"Sunderland",1,42,49,52,53,-1,1.16666666666667,1.23809523809524,1.26190476190476,-0.0238095238095238,18,18,22,22,18,119,0,-0.1
1980,"Swansea City",2,42,68,64,44,20,1.61904761904762,1.52380952380952,1.04761904761905,0.476190476190476,25,3,22,44,6,93,19,-3.9
1980,"Swindon Town",3,46,54,51,56,-5,1.17391304347826,1.10869565217391,1.21739130434783,-0.108695652173913,64,20,24,68,66,93,-2,2.2
1980,"Torquay United",4,46,59,55,63,-8,1.28260869565217,1.19565217391304,1.3695652173913,-0.173913043478261,82,14,24,92,83,78,-1,0.7
1980,"Tottenham Hotspur",1,42,57,70,68,2,1.35714285714286,1.66666666666667,1.61904761904762,0.0476190476190476,10,10,22,22,5,101,5,-0.1
1980,"Tranmere Rovers",4,46,49,59,73,-14,1.06521739130435,1.28260869565217,1.58695652173913,-0.304347826086957,89,21,24,92,79,89,10,4
1980,"Walsall",3,46,54,59,74,-15,1.17391304347826,1.28260869565217,1.60869565217391,-0.326086956521739,65,21,24,68,64,100,1,-2.1
1980,"Watford",2,42,59,50,45,5,1.4047619047619,1.19047619047619,1.07142857142857,0.119047619047619,31,9,22,44,24,93,7,-0.9
1980,"West Bromwich Albion",1,42,72,60,42,18,1.71428571428571,1.42857142857143,1,0.428571428571429,4,4,22,22,19,121,-15,-3.9
1980,"West Ham United",2,42,94,79,29,50,2.23809523809524,1.88095238095238,0.69047619047619,1.19047619047619,23,1,22,44,10,94,13,0.1
1980,"Wigan Athletic",4,46,65,51,55,-4,1.41304347826087,1.10869565217391,1.19565217391304,-0.0869565217391304,79,11,24,92,71,42,8,2.5
1980,"Wimbledon",4,46,78,64,46,18,1.69565217391304,1.39130434782609,1,0.391304347826087,72,4,24,92,65,27,7,6.5
1980,"Wolverhampton Wanderers",1,42,48,43,55,-12,1.14285714285714,1.02380952380952,1.30952380952381,-0.285714285714286,19,19,22,22,21,121,-2,-1.4
1980,"Wrexham",2,42,50,43,45,-2,1.19047619047619,1.02380952380952,1.07142857142857,-0.0476190476190476,40,18,22,44,43,80,-3,-5.2
1980,"York City",4,46,45,47,66,-19,0.978260869565217,1.02173913043478,1.43478260869565,-0.41304347826087,92,24,24,92,85,72,7,0.2
1981,"AFC Bournemouth",4,46,88,62,30,32,1.91304347826087,1.34782608695652,0.652173913043478,0.695652173913043,72,4,24,92,56,90,16,1.9
1981,"Aldershot",4,46,54,57,68,-11,1.17391304347826,1.23913043478261,1.47826086956522,-0.239130434782609,84,16,24,92,86,57,-2,-0.1
1981,"Arsenal",1,42,71,48,37,11,1.69047619047619,1.14285714285714,0.880952380952381,0.261904761904762,4,4,22,22,9,116,-5,0
1981,"Aston Villa",1,42,57,55,53,2,1.35714285714286,1.30952380952381,1.26190476190476,0.0476190476190476,11,11,22,22,6,121,5,0.4
1981,"Barnsley",2,42,67,59,41,18,1.5952380952381,1.4047619047619,0.976190476190476,0.428571428571429,28,6,22,44,32,111,-4,-1
1981,"Birmingham City",1,42,44,53,61,-8,1.04761904761905,1.26190476190476,1.45238095238095,-0.19047619047619,16,16,22,22,16,117,0,-3.2
1981,"Blackburn Rovers",2,42,59,47,43,4,1.4047619047619,1.11904761904762,1.02380952380952,0.0952380952380952,32,10,22,44,33,121,-1,0.5
1981,"Blackpool",4,46,58,66,60,6,1.26086956521739,1.43478260869565,1.30434782608696,0.130434782608696,80,12,24,92,87,112,-7,0.6
1981,"Bolton Wanderers",2,42,46,39,61,-22,1.0952380952381,0.928571428571429,1.45238095238095,-0.523809523809524,39,17,22,44,43,121,-4,-2
1981,"Bradford City",4,46,91,88,45,43,1.97826086956522,1.91304347826087,0.978260869565217,0.934782608695652,70,2,24,92,57,106,13,0.8
1981,"Brentford",3,46,68,56,47,9,1.47826086956522,1.21739130434783,1.02173913043478,0.195652173913043,52,8,24,68,53,93,-1,0.5
1981,"Brighton & Hove Albion",1,42,52,43,52,-9,1.23809523809524,1.02380952380952,1.23809523809524,-0.214285714285714,13,13,22,22,22,93,-9,-3.2
1981,"Bristol City",3,46,46,40,65,-25,1,0.869565217391304,1.41304347826087,-0.543478260869565,67,23,24,68,81,108,-14,2.8
1981,"Bristol Rovers",3,46,63,58,65,-7,1.3695652173913,1.26086956521739,1.41304347826087,-0.152173913043478,56,12,24,68,51,92,5,2.2
1981,"Burnley",3,46,80,66,45,21,1.73913043478261,1.43478260869565,0.978260869565217,0.456521739130435,45,1,24,68,44,121,1,-2.6
1981,"Bury",4,46,68,80,59,21,1.47826086956522,1.73913043478261,1.28260869565217,0.456521739130435,77,9,24,92,73,114,4,1
1981,"Cambridge United",2,42,48,48,53,-5,1.14285714285714,1.14285714285714,1.26190476190476,-0.119047619047619,36,14,22,44,34,41,2,0.8
1981,"Cardiff City",2,42,44,45,61,-16,1.04761904761905,1.07142857142857,1.45238095238095,-0.380952380952381,42,20,22,44,46,93,-4,-3.7
1981,"Carlisle United",3,46,80,65,50,15,1.73913043478261,1.41304347826087,1.08695652173913,0.326086956521739,46,2,24,68,36,84,10,-4.6
1981,"Charlton Athletic",2,42,51,50,65,-15,1.21428571428571,1.19047619047619,1.54761904761905,-0.357142857142857,35,13,22,44,37,92,-2,0.6
1981,"Chelsea",2,42,57,60,60,0,1.35714285714286,1.42857142857143,1.42857142857143,0,34,12,22,44,40,104,-6,2.2
1981,"Chester",3,46,32,36,78,-42,0.695652173913043,0.782608695652174,1.69565217391304,-0.91304347826087,68,24,24,68,82,67,-14,0.4
1981,"Chesterfield",3,46,64,57,58,-1,1.39130434782609,1.23913043478261,1.26086956521739,-0.0217391304347826,55,11,24,68,68,100,-13,-2.8
1981,"Colchester United",4,46,72,82,57,25,1.56521739130435,1.78260869565217,1.23913043478261,0.543478260869565,74,6,24,92,74,68,0,-1.3
1981,"Coventry City",1,42,50,56,62,-6,1.19047619047619,1.33333333333333,1.47619047619048,-0.142857142857143,14,14,22,22,19,94,-5,-0.5
1981,"Crewe Alexandra",4,46,27,29,84,-55,0.58695652173913,0.630434782608696,1.82608695652174,-1.19565217391304,92,24,24,92,91,96,1,1.6
1981,"Crystal Palace",2,42,48,34,45,-11,1.14285714285714,0.80952380952381,1.07142857142857,-0.261904761904762,37,15,22,44,38,93,-1,2.8
1981,"Darlington",4,46,58,61,62,-1,1.26086956521739,1.32608695652174,1.34782608695652,-0.0217391304347826,81,13,24,92,85,81,-4,-0.4
1981,"Derby County",2,42,48,53,68,-15,1.14285714285714,1.26190476190476,1.61904761904762,-0.357142857142857,38,16,22,44,35,121,3,1.3
1981,"Doncaster Rovers",3,46,56,55,68,-13,1.21739130434783,1.19565217391304,1.47826086956522,-0.282608695652174,63,19,24,68,67,88,-4,-2.8
1981,"Everton",1,42,64,56,50,6,1.52380952380952,1.33333333333333,1.19047619047619,0.142857142857143,8,8,22,22,7,121,1,-0.5
1981,"Exeter City",3,46,57,71,84,-13,1.23913043478261,1.54347826086957,1.82608695652174,-0.282608695652174,61,17,24,68,62,88,-1,-0.5
1981,"Fulham",3,46,78,77,51,26,1.69565217391304,1.67391304347826,1.10869565217391,0.565217391304348,47,3,24,68,26,102,21,-0.8
1981,"Gillingham",3,46,71,64,56,8,1.54347826086957,1.39130434782609,1.21739130434783,0.173913043478261,49,5,24,68,58,88,-9,-3.2
1981,"Grimsby Town",2,42,46,53,65,-12,1.0952380952381,1.26190476190476,1.54761904761905,-0.285714285714286,40,18,22,44,41,110,-1,0
1981,"Halifax Town",4,46,49,51,72,-21,1.06521739130435,1.10869565217391,1.56521739130435,-0.456521739130435,86,18,24,92,79,69,7,-0.4
1981,"Hartlepool United",4,46,55,73,84,-11,1.19565217391304,1.58695652173913,1.82608695652174,-0.239130434782609,82,14,24,92,90,89,-8,2.6
1981,"Hereford United",4,46,67,64,58,6,1.45652173913043,1.39130434782609,1.26086956521739,0.130434782608696,78,10,24,92,92,31,-14,-0.9
1981,"Huddersfield Town",3,46,57,64,59,5,1.23913043478261,1.39130434782609,1.28260869565217,0.108695652173913,62,18,24,68,47,99,15,1.3
1981,"Hull City",4,46,69,70,61,9,1.5,1.52173913043478,1.32608695652174,0.195652173913043,76,8,24,92,70,104,6,1.6
1981,"Ipswich Town",1,42,83,75,53,22,1.97619047619048,1.78571428571429,1.26190476190476,0.523809523809524,2,2,22,22,10,75,-8,-2.1
1981,"Leeds United",1,42,42,39,61,-22,1,0.928571428571429,1.45238095238095,-0.523809523809524,20,20,22,22,30,93,-10,1.9
1981,"Leicester City",2,42,66,56,48,8,1.57142857142857,1.33333333333333,1.14285714285714,0.19047619047619,30,8,22,44,25,115,5,0.4
1981,"Leyton Orient",2,42,39,36,61,-25,0.928571428571429,0.857142857142857,1.45238095238095,-0.595238095238095,44,22,22,44,63,102,-19,-1.3
1981,"Lincoln City",3,46,77,66,40,26,1.67391304347826,1.43478260869565,0.869565217391304,0.565217391304348,48,4,24,68,50,107,-2,-3
1981,"Liverpool",1,42,87,80,32,48,2.07142857142857,1.9047619047619,0.761904761904762,1.14285714285714,1,1,22,22,1,116,0,-0.5
1981,"Luton Town",2,42,88,86,46,40,2.0952380952381,2.04761904761905,1.0952380952381,0.952380952380952,23,1,22,44,18,91,5,0.3
1981,"Manchester City",1,42,58,49,50,-1,1.38095238095238,1.16666666666667,1.19047619047619,-0.0238095238095238,9,9,22,22,20,117,-11,0.4
1981,"Manchester United",1,42,78,59,29,30,1.85714285714286,1.4047619047619,0.69047619047619,0.714285714285714,3,3,22,22,3,117,0,0.1
1981,"Mansfield Town",4,46,49,63,81,-18,1.06521739130435,1.3695652173913,1.76086956521739,-0.391304347826087,87,19,24,92,78,77,9,1.5
1981,"Middlesbrough",1,42,39,34,52,-18,0.928571428571429,0.80952380952381,1.23809523809524,-0.428571428571429,22,22,22,22,39,110,-17,-0.2
1981,"Millwall",3,46,67,62,62,0,1.45652173913043,1.34782608695652,1.34782608695652,0,53,9,24,68,61,93,-8,1.7
1981,"Newcastle United",2,42,62,52,50,2,1.47619047619048,1.23809523809524,1.19047619047619,0.0476190476190476,31,9,22,44,27,116,4,-1.1
1981,"Newport County",3,46,58,54,54,0,1.26086956521739,1.17391304347826,1.17391304347826,0,60,16,24,68,48,67,12,-3
1981,"Northampton Town",4,46,42,57,84,-27,0.91304347826087,1.23913043478261,1.82608695652174,-0.58695652173913,90,22,24,92,83,93,7,0.4
1981,"Norwich City",2,42,71,64,50,14,1.69047619047619,1.52380952380952,1.19047619047619,0.333333333333333,25,3,22,44,14,93,11,0.7
1981,"Nottingham Forest",1,42,57,42,48,-6,1.35714285714286,1,1.14285714285714,-0.142857142857143,12,12,22,22,4,117,8,0.4
1981,"Notts County",1,42,47,61,69,-8,1.11904761904762,1.45238095238095,1.64285714285714,-0.19047619047619,15,15,22,22,15,120,0,-0.6
1981,"Oldham Athletic",2,42,59,50,51,-1,1.4047619047619,1.19047619047619,1.21428571428571,-0.0238095238095238,33,11,22,44,29,102,4,1.6
1981,"Oxford United",3,46,71,63,49,14,1.54347826086957,1.3695652173913,1.06521739130435,0.304347826086957,50,6,24,68,49,54,1,0.7
1981,"Peterborough United",4,46,82,71,57,14,1.78260869565217,1.54347826086957,1.23913043478261,0.304347826086957,73,5,24,92,77,60,-4,2.1
1981,"Plymouth Argyle",3,46,65,64,56,8,1.41304347826087,1.39130434782609,1.21739130434783,0.173913043478261,54,10,24,68,52,93,2,1
1981,"Port Vale",4,46,70,56,49,7,1.52173913043478,1.21739130434783,1.06521739130435,0.152173913043478,75,7,24,92,71,107,4,2.9
1981,"Portsmouth",3,46,61,56,51,5,1.32608695652174,1.21739130434783,1.10869565217391,0.108695652173913,58,14,24,68,45,93,13,2.8
1981,"Preston North End",3,46,61,50,56,-6,1.32608695652174,1.08695652173913,1.21739130434783,-0.130434782608696,59,15,24,68,60,121,-1,-0.4
1981,"Queens Park Rangers",2,42,69,65,43,22,1.64285714285714,1.54761904761905,1.02380952380952,0.523809523809524,27,5,22,44,23,93,4,1.6
1981,"Reading",3,46,62,67,75,-8,1.34782608695652,1.45652173913043,1.6304347826087,-0.173913043478261,57,13,24,68,65,93,-8,-0.1
1981,"Rochdale",4,46,46,50,62,-12,1,1.08695652173913,1.34782608695652,-0.260869565217391,89,21,24,92,89,92,0,1.1
1981,"Rotherham United",2,42,67,66,54,12,1.5952380952381,1.57142857142857,1.28571428571429,0.285714285714286,29,7,22,44,42,88,-13,-4.4
1981,"Scunthorpe United",4,46,42,43,79,-36,0.91304347826087,0.934782608695652,1.71739130434783,-0.782608695652174,91,23,24,92,72,70,19,1.6
1981,"Sheffield United",4,46,96,94,41,53,2.08695652173913,2.04347826086957,0.891304347826087,1.15217391304348,69,1,24,92,54,117,15,5.9
1981,"Sheffield Wednesday",2,42,70,55,51,4,1.66666666666667,1.30952380952381,1.21428571428571,0.0952380952380952,26,4,22,44,28,117,-2,2.3
1981,"Shrewsbury Town",2,42,46,37,57,-20,1.0952380952381,0.880952380952381,1.35714285714286,-0.476190476190476,41,19,22,44,31,69,10,-2.7
1981,"Southampton",1,42,66,72,67,5,1.57142857142857,1.71428571428571,1.5952380952381,0.119047619047619,7,7,22,22,11,93,-4,-0.8
1981,"Southend United",3,46,69,63,51,12,1.5,1.3695652173913,1.10869565217391,0.260869565217391,51,7,24,68,59,93,-8,1.6
1981,"Stockport County",4,46,49,48,67,-19,1.06521739130435,1.04347826086957,1.45652173913043,-0.41304347826087,88,20,24,92,84,99,4,3.7
1981,"Stoke City",1,42,44,44,63,-19,1.04761904761905,1.04761904761905,1.5,-0.452380952380952,17,17,22,22,12,113,5,-3.3
1981,"Sunderland",1,42,44,38,58,-20,1.04761904761905,0.904761904761905,1.38095238095238,-0.476190476190476,18,18,22,22,17,119,1,-2.3
1981,"Swansea City",1,42,69,58,51,7,1.64285714285714,1.38095238095238,1.21428571428571,0.166666666666667,6,6,22,22,21,93,-15,-5.9
1981,"Swindon Town",3,46,52,55,71,-16,1.1304347826087,1.19565217391304,1.54347826086957,-0.347826086956522,66,22,24,68,76,93,-10,3.5
1981,"Torquay United",4,46,55,47,59,-12,1.19565217391304,1.02173913043478,1.28260869565217,-0.260869565217391,83,15,24,92,80,78,3,1.4
1981,"Tottenham Hotspur",1,42,71,67,48,19,1.69047619047619,1.5952380952381,1.14285714285714,0.452380952380952,5,5,22,22,5,101,0,-1.1
1981,"Tranmere Rovers",4,46,60,51,56,-5,1.30434782608696,1.10869565217391,1.21739130434783,-0.108695652173913,79,11,24,92,88,89,-9,4.2
1981,"Walsall",3,46,53,51,55,-4,1.15217391304348,1.10869565217391,1.19565217391304,-0.0869565217391304,64,20,24,68,55,100,9,-2.1
1981,"Watford",2,42,80,76,42,34,1.9047619047619,1.80952380952381,1,0.80952380952381,24,2,22,44,2,93,22,-0.8
1981,"West Bromwich Albion",1,42,44,46,57,-11,1.04761904761905,1.0952380952381,1.35714285714286,-0.261904761904762,19,19,22,22,13,121,6,-3.5
1981,"West Ham United",1,42,58,66,57,9,1.38095238095238,1.57142857142857,1.35714285714286,0.214285714285714,10,10,22,22,8,94,2,-1.2
1981,"Wigan Athletic",4,46,91,80,46,34,1.97826086956522,1.73913043478261,1,0.739130434782609,71,3,24,92,64,42,7,1
1981,"Wimbledon",3,46,53,61,75,-14,1.15217391304348,1.32608695652174,1.6304347826087,-0.304347826086957,65,21,24,68,69,27,-4,5.1
1981,"Wolverhampton Wanderers",1,42,40,32,63,-31,0.952380952380952,0.761904761904762,1.5,-0.738095238095238,21,21,22,22,24,121,-3,-1.2
1981,"Wrexham",2,42,44,40,56,-16,1.04761904761905,0.952380952380952,1.33333333333333,-0.380952380952381,43,21,22,44,66,80,-23,-4.1
1981,"York City",4,46,50,69,91,-22,1.08695652173913,1.5,1.97826086956522,-0.478260869565217,85,17,24,92,75,72,10,-0.4
1982,"AFC Bournemouth",3,46,61,59,68,-9,1.32608695652174,1.28260869565217,1.47826086956522,-0.195652173913043,56,12,24,68,61,90,-5,-0.7
1982,"Aldershot",4,46,51,61,82,-21,1.10869565217391,1.32608695652174,1.78260869565217,-0.456521739130435,86,18,24,92,73,57,13,1.2
1982,"Arsenal",1,42,58,58,56,2,1.38095238095238,1.38095238095238,1.33333333333333,0.0476190476190476,9,9,22,22,6,116,3,-0.1
1982,"Aston Villa",1,42,68,62,50,12,1.61904761904762,1.47619047619048,1.19047619047619,0.285714285714286,6,6,22,22,9,121,-3,0.4
1982,"Barnsley",2,42,57,57,55,2,1.35714285714286,1.35714285714286,1.30952380952381,0.0476190476190476,32,10,22,44,36,111,-4,-0.3
1982,"Birmingham City",1,42,50,40,55,-15,1.19047619047619,0.952380952380952,1.30952380952381,-0.357142857142857,16,16,22,22,20,117,-4,-2.5
1982,"Blackburn Rovers",2,42,57,58,58,0,1.35714285714286,1.38095238095238,1.38095238095238,0,33,11,22,44,28,121,5,2.9
1982,"Blackpool",4,46,51,55,74,-19,1.10869565217391,1.19565217391304,1.60869565217391,-0.41304347826087,87,19,24,92,74,112,13,2.3
1982,"Bolton Wanderers",2,42,44,42,61,-19,1.04761904761905,1,1.45238095238095,-0.452380952380952,43,21,22,44,54,121,-11,-0.5
1982,"Bradford City",3,46,61,68,69,-1,1.32608695652174,1.47826086956522,1.5,-0.0217391304347826,57,13,24,68,51,106,6,0.1
1982,"Brentford",3,46,64,88,77,11,1.39130434782609,1.91304347826087,1.67391304347826,0.239130434782609,53,9,24,68,64,93,-11,0.9
1982,"Brighton & Hove Albion",1,42,40,38,68,-30,0.952380952380952,0.904761904761905,1.61904761904762,-0.714285714285714,22,22,22,22,31,93,-9,-3.2
1982,"Bristol City",4,46,56,59,70,-11,1.21739130434783,1.28260869565217,1.52173913043478,-0.239130434782609,81,13,24,92,71,108,10,4.5
1982,"Bristol Rovers",3,46,75,84,58,26,1.6304347826087,1.82608695652174,1.26086956521739,0.565217391304348,51,7,24,68,49,92,2,0.5
1982,"Burnley",2,42,44,56,66,-10,1.04761904761905,1.33333333333333,1.57142857142857,-0.238095238095238,44,22,22,44,56,121,-12,-1.5
1982,"Bury",4,46,81,74,46,28,1.76086956521739,1.60869565217391,1,0.608695652173913,73,5,24,92,82,114,-9,-0.4
1982,"Cambridge United",2,42,51,42,60,-18,1.21428571428571,1,1.42857142857143,-0.428571428571429,34,12,22,44,44,41,-10,-1.1
1982,"Cardiff City",3,46,86,76,50,26,1.8695652173913,1.65217391304348,1.08695652173913,0.565217391304348,46,2,24,68,37,93,9,-2.5
1982,"Carlisle United",2,42,48,68,70,-2,1.14285714285714,1.61904761904762,1.66666666666667,-0.0476190476190476,36,14,22,44,29,84,7,-5.2
1982,"Charlton Athletic",2,42,48,63,86,-23,1.14285714285714,1.5,2.04761904761905,-0.547619047619048,37,15,22,44,33,92,4,0.4
1982,"Chelsea",2,42,47,51,61,-10,1.11904761904762,1.21428571428571,1.45238095238095,-0.238095238095238,40,18,22,44,23,104,17,2.9
1982,"Chester",4,46,56,55,60,-5,1.21739130434783,1.19565217391304,1.30434782608696,-0.108695652173913,82,14,24,92,92,67,-10,1.2
1982,"Chesterfield",3,46,37,43,68,-25,0.804347826086957,0.934782608695652,1.47826086956522,-0.543478260869565,68,24,24,68,81,100,-13,-1.4
1982,"Colchester United",4,46,81,75,55,20,1.76086956521739,1.6304347826087,1.19565217391304,0.434782608695652,74,6,24,92,76,68,-2,-0.6
1982,"Coventry City",1,42,48,48,59,-11,1.14285714285714,1.14285714285714,1.4047619047619,-0.261904761904762,19,19,22,22,18,94,1,0.5
1982,"Crewe Alexandra",4,46,41,53,71,-18,0.891304347826087,1.15217391304348,1.54347826086957,-0.391304347826087,91,23,24,92,83,96,8,1.5
1982,"Crystal Palace",2,42,48,43,52,-9,1.14285714285714,1.02380952380952,1.23809523809524,-0.214285714285714,38,16,22,44,40,93,-2,1.9
1982,"Darlington",4,46,52,61,71,-10,1.1304347826087,1.32608695652174,1.54347826086957,-0.217391304347826,85,17,24,92,84,81,1,-0.6
1982,"Derby County",2,42,49,49,58,-9,1.16666666666667,1.16666666666667,1.38095238095238,-0.214285714285714,35,13,22,44,42,121,-7,0.5
1982,"Doncaster Rovers",3,46,38,57,97,-40,0.826086956521739,1.23913043478261,2.10869565217391,-0.869565217391304,67,23,24,68,70,88,-3,-1.9
1982,"Everton",1,42,64,66,48,18,1.52380952380952,1.57142857142857,1.14285714285714,0.428571428571429,7,7,22,22,7,121,0,-0.6
1982,"Exeter City",3,46,54,81,104,-23,1.17391304347826,1.76086956521739,2.26086956521739,-0.5,62,18,24,68,68,88,-6,-0.3
1982,"Fulham",2,42,69,64,47,17,1.64285714285714,1.52380952380952,1.11904761904762,0.404761904761905,26,4,22,44,34,102,-8,-3.1
1982,"Gillingham",3,46,61,58,59,-1,1.32608695652174,1.26086956521739,1.28260869565217,-0.0217391304347826,58,14,24,68,52,88,6,-3.3
1982,"Grimsby Town",2,42,47,45,70,-25,1.11904761904762,1.07142857142857,1.66666666666667,-0.595238095238095,41,19,22,44,26,110,15,1
1982,"Halifax Town",4,46,60,59,66,-7,1.30434782608696,1.28260869565217,1.43478260869565,-0.152173913043478,79,11,24,92,88,69,-9,-1.3
1982,"Hartlepool United",4,46,48,46,76,-30,1.04347826086957,1,1.65217391304348,-0.652173913043478,90,22,24,92,91,89,-1,2.8
1982,"Hereford United",4,46,41,42,79,-37,0.891304347826087,0.91304347826087,1.71739130434783,-0.804347826086957,92,24,24,92,79,31,13,0.5
1982,"Huddersfield Town",3,46,82,84,49,35,1.78260869565217,1.82608695652174,1.06521739130435,0.760869565217391,47,3,24,68,35,99,12,-1.3
1982,"Hull City",4,46,90,75,34,41,1.95652173913043,1.6304347826087,0.739130434782609,0.891304347826087,70,2,24,92,47,104,23,0.4
1982,"Ipswich Town",1,42,58,64,50,14,1.38095238095238,1.52380952380952,1.19047619047619,0.333333333333333,10,10,22,22,12,75,-2,-0.5
1982,"Leeds United",2,42,60,51,46,5,1.42857142857143,1.21428571428571,1.0952380952381,0.119047619047619,30,8,22,44,32,93,-2,1.3
1982,"Leicester City",2,42,70,72,44,28,1.66666666666667,1.71428571428571,1.04761904761905,0.666666666666667,25,3,22,44,14,115,11,-0.2
1982,"Leyton Orient",3,46,54,64,88,-24,1.17391304347826,1.39130434782609,1.91304347826087,-0.521739130434783,63,19,24,68,55,102,8,1.1
1982,"Lincoln City",3,46,76,77,51,26,1.65217391304348,1.67391304347826,1.10869565217391,0.565217391304348,50,6,24,68,58,107,-8,-3.8
1982,"Liverpool",1,42,82,87,37,50,1.95238095238095,2.07142857142857,0.880952380952381,1.19047619047619,1,1,22,22,1,116,0,-0.5
1982,"Luton Town",1,42,49,65,84,-19,1.16666666666667,1.54761904761905,2,-0.452380952380952,18,18,22,22,15,91,3,-2.4
1982,"Manchester City",1,42,47,47,70,-23,1.11904761904762,1.11904761904762,1.66666666666667,-0.547619047619048,20,20,22,22,27,117,-7,1.1
1982,"Manchester United",1,42,70,56,38,18,1.66666666666667,1.33333333333333,0.904761904761905,0.428571428571429,3,3,22,22,3,117,0,0.2
1982,"Mansfield Town",4,46,61,61,70,-9,1.32608695652174,1.32608695652174,1.52173913043478,-0.195652173913043,78,10,24,92,87,77,-9,1
1982,"Middlesbrough",2,42,48,46,67,-21,1.14285714285714,1.0952380952381,1.5952380952381,-0.5,39,17,22,44,38,110,1,1.8
1982,"Millwall",3,46,55,64,77,-13,1.19565217391304,1.39130434782609,1.67391304347826,-0.282608695652174,61,17,24,68,53,93,8,3.2
1982,"Newcastle United",2,42,67,75,53,22,1.5952380952381,1.78571428571429,1.26190476190476,0.523809523809524,27,5,22,44,25,116,2,0.4
1982,"Newport County",3,46,78,76,54,22,1.69565217391304,1.65217391304348,1.17391304347826,0.478260869565217,48,4,24,68,57,67,-9,-3.2
1982,"Northampton Town",4,46,54,65,75,-10,1.17391304347826,1.41304347826087,1.6304347826087,-0.217391304347826,83,15,24,92,86,93,-3,-0.7
1982,"Norwich City",1,42,54,52,58,-6,1.28571428571429,1.23809523809524,1.38095238095238,-0.142857142857143,14,14,22,22,16,93,-2,1.1
1982,"Nottingham Forest",1,42,69,62,50,12,1.64285714285714,1.47619047619048,1.19047619047619,0.285714285714286,4,4,22,22,4,117,0,-1.8
1982,"Notts County",1,42,52,55,71,-16,1.23809523809524,1.30952380952381,1.69047619047619,-0.380952380952381,15,15,22,22,21,120,-6,-2.4
1982,"Oldham Athletic",2,42,61,64,47,17,1.45238095238095,1.52380952380952,1.11904761904762,0.404761904761905,29,7,22,44,41,102,-12,0.9
1982,"Oxford United",3,46,78,71,53,18,1.69565217391304,1.54347826086957,1.15217391304348,0.391304347826087,49,5,24,68,45,54,4,1.2
1982,"Peterborough United",4,46,64,58,52,6,1.39130434782609,1.26086956521739,1.1304347826087,0.130434782608696,77,9,24,92,75,60,2,4.5
1982,"Plymouth Argyle",3,46,65,61,66,-5,1.41304347826087,1.32608695652174,1.43478260869565,-0.108695652173913,52,8,24,68,63,93,-11,-0.9
1982,"Port Vale",4,46,88,67,34,33,1.91304347826087,1.45652173913043,0.739130434782609,0.717391304347826,71,3,24,92,67,107,4,2.2
1982,"Portsmouth",3,46,91,74,41,33,1.97826086956522,1.60869565217391,0.891304347826087,0.717391304347826,45,1,24,68,39,93,6,2.1
1982,"Preston North End",3,46,58,60,69,-9,1.26086956521739,1.30434782608696,1.5,-0.195652173913043,60,16,24,68,60,121,0,-0.7
1982,"Queens Park Rangers",2,42,85,77,36,41,2.02380952380952,1.83333333333333,0.857142857142857,0.976190476190476,23,1,22,44,5,93,18,1.8
1982,"Reading",3,46,53,64,79,-15,1.15217391304348,1.39130434782609,1.71739130434783,-0.326086956521739,65,21,24,68,72,93,-7,1
1982,"Rochdale",4,46,49,55,73,-18,1.06521739130435,1.19565217391304,1.58695652173913,-0.391304347826087,89,21,24,92,90,92,-1,0.8
1982,"Rotherham United",2,42,45,45,68,-23,1.07142857142857,1.07142857142857,1.61904761904762,-0.547619047619048,42,20,22,44,62,88,-20,-1.6
1982,"Scunthorpe United",4,46,83,71,42,29,1.80434782608696,1.54347826086957,0.91304347826087,0.630434782608696,72,4,24,92,65,70,7,-1.2
1982,"Sheffield United",3,46,64,62,64,-2,1.39130434782609,1.34782608695652,1.39130434782609,-0.0434782608695652,54,10,24,68,48,117,6,3.8
1982,"Sheffield Wednesday",2,42,63,60,47,13,1.5,1.42857142857143,1.11904761904762,0.30952380952381,28,6,22,44,24,117,4,2.1
1982,"Shrewsbury Town",2,42,59,48,48,0,1.4047619047619,1.14285714285714,1.14285714285714,0,31,9,22,44,30,69,1,-4.8
1982,"Southampton",1,42,57,54,58,-4,1.35714285714286,1.28571428571429,1.38095238095238,-0.0952380952380952,11,11,22,22,2,93,9,-0.7
1982,"Southend United",3,46,59,66,65,1,1.28260869565217,1.43478260869565,1.41304347826087,0.0217391304347826,59,15,24,68,66,93,-7,1.9
1982,"Stockport County",4,46,54,60,79,-19,1.17391304347826,1.30434782608696,1.71739130434783,-0.41304347826087,84,16,24,92,80,99,4,3.1
1982,"Stoke City",1,42,57,53,64,-11,1.35714285714286,1.26190476190476,1.52380952380952,-0.261904761904762,12,12,22,22,19,113,-7,-3.5
1982,"Sunderland",1,42,50,48,61,-13,1.19047619047619,1.14285714285714,1.45238095238095,-0.30952380952381,17,17,22,22,13,119,4,-2.6
1982,"Swansea City",1,42,41,51,69,-18,0.976190476190476,1.21428571428571,1.64285714285714,-0.428571428571429,21,21,22,22,43,93,-22,-3
1982,"Swindon Town",4,46,68,61,54,7,1.47826086956522,1.32608695652174,1.17391304347826,0.152173913043478,76,8,24,92,85,93,-9,4.8
1982,"Torquay United",4,46,58,56,65,-9,1.26086956521739,1.21739130434783,1.41304347826087,-0.195652173913043,80,12,24,92,77,78,3,-0.9
1982,"Tottenham Hotspur",1,42,69,65,50,15,1.64285714285714,1.54761904761905,1.19047619047619,0.357142857142857,5,5,22,22,8,101,-3,-0.3
1982,"Tranmere Rovers",4,46,50,49,71,-22,1.08695652173913,1.06521739130435,1.54347826086957,-0.478260869565217,88,20,24,92,78,89,10,6.2
1982,"Walsall",3,46,64,64,63,1,1.39130434782609,1.39130434782609,1.3695652173913,0.0217391304347826,55,11,24,68,50,100,5,-2
1982,"Watford",1,42,71,74,57,17,1.69047619047619,1.76190476190476,1.35714285714286,0.404761904761905,2,2,22,22,11,93,-9,-3.6
1982,"West Bromwich Albion",1,42,57,51,49,2,1.35714285714286,1.21428571428571,1.16666666666667,0.0476190476190476,13,13,22,22,17,121,-4,-3.7
1982,"West Ham United",1,42,64,68,62,6,1.52380952380952,1.61904761904762,1.47619047619048,0.142857142857143,8,8,22,22,10,94,-2,-1.7
1982,"Wigan Athletic",3,46,54,60,72,-12,1.17391304347826,1.30434782608696,1.56521739130435,-0.260869565217391,64,20,24,68,59,42,5,-0.5
1982,"Wimbledon",4,46,98,96,45,51,2.1304347826087,2.08695652173913,0.978260869565217,1.10869565217391,69,1,24,92,46,27,23,5.7
1982,"Wolverhampton Wanderers",2,42,75,68,44,24,1.78571428571429,1.61904761904762,1.04761904761905,0.571428571428571,24,2,22,44,22,121,2,-1
1982,"Wrexham",3,46,51,56,76,-20,1.10869565217391,1.21739130434783,1.65217391304348,-0.434782608695652,66,22,24,68,89,80,-23,-0.6
1982,"York City",4,46,79,88,58,30,1.71739130434783,1.91304347826087,1.26086956521739,0.652173913043478,75,7,24,92,69,72,6,0.1
1983,"AFC Bournemouth",3,46,55,63,73,-10,1.19565217391304,1.3695652173913,1.58695652173913,-0.217391304347826,61,17,24,68,54,90,7,-0.2
1983,"Aldershot",4,46,75,76,69,7,1.6304347826087,1.65217391304348,1.5,0.152173913043478,73,5,24,92,81,57,-8,-0.8
1983,"Arsenal",1,42,63,74,60,14,1.5,1.76190476190476,1.42857142857143,0.333333333333333,6,6,22,22,6,116,0,0.2
1983,"Aston Villa",1,42,60,59,61,-2,1.42857142857143,1.4047619047619,1.45238095238095,-0.0476190476190476,9,9,22,22,10,121,-1,-0.1
1983,"Barnsley",2,42,52,57,53,4,1.23809523809524,1.35714285714286,1.26190476190476,0.0952380952380952,36,14,22,44,33,111,3,-0.4
1983,"Birmingham City",1,42,48,39,50,-11,1.14285714285714,0.928571428571429,1.19047619047619,-0.261904761904762,20,20,22,22,24,117,-4,-2.3
1983,"Blackburn Rovers",2,42,67,57,46,11,1.5952380952381,1.35714285714286,1.0952380952381,0.261904761904762,28,6,22,44,27,121,1,2.6
1983,"Blackpool",4,46,72,70,52,18,1.56521739130435,1.52173913043478,1.1304347826087,0.391304347826087,74,6,24,92,70,112,4,0.8
1983,"Bolton Wanderers",3,46,64,56,60,-4,1.39130434782609,1.21739130434783,1.30434782608696,-0.0869565217391304,54,10,24,68,61,121,-7,1.8
1983,"Bradford City",3,46,71,73,65,8,1.54347826086957,1.58695652173913,1.41304347826087,0.173913043478261,51,7,24,68,45,106,6,-0.2
1983,"Brentford",3,46,49,69,79,-10,1.06521739130435,1.5,1.71739130434783,-0.217391304347826,64,20,24,68,57,93,7,0.3
1983,"Brighton & Hove Albion",2,42,60,69,60,9,1.42857142857143,1.64285714285714,1.42857142857143,0.214285714285714,31,9,22,44,28,93,3,-2.9
1983,"Bristol City",4,46,82,70,44,26,1.78260869565217,1.52173913043478,0.956521739130435,0.565217391304348,71,3,24,92,49,108,22,3.6
1983,"Bristol Rovers",3,46,79,68,54,14,1.71739130434783,1.47826086956522,1.17391304347826,0.304347826086957,49,5,24,68,50,92,-1,-0.5
1983,"Burnley",3,46,62,76,61,15,1.34782608695652,1.65217391304348,1.32608695652174,0.326086956521739,56,12,24,68,65,121,-9,0.4
1983,"Bury",4,46,59,61,64,-3,1.28260869565217,1.32608695652174,1.39130434782609,-0.0652173913043478,82,14,24,92,72,114,10,-0.1
1983,"Cambridge United",2,42,24,28,77,-49,0.571428571428571,0.666666666666667,1.83333333333333,-1.16666666666667,44,22,22,44,68,41,-24,-1.2
1983,"Cardiff City",2,42,51,53,66,-13,1.21428571428571,1.26190476190476,1.57142857142857,-0.30952380952381,37,15,22,44,43,93,-6,-2.8
1983,"Carlisle United",2,42,64,48,41,7,1.52380952380952,1.14285714285714,0.976190476190476,0.166666666666667,29,7,22,44,38,84,-9,-4.8
1983,"Charlton Athletic",2,42,57,53,64,-11,1.35714285714286,1.26190476190476,1.52380952380952,-0.261904761904762,33,11,22,44,39,92,-6,0
1983,"Chelsea",2,42,88,90,40,50,2.0952380952381,2.14285714285714,0.952380952380952,1.19047619047619,23,1,22,44,7,104,16,0.9
1983,"Chester",4,46,34,45,82,-37,0.739130434782609,0.978260869565217,1.78260869565217,-0.804347826086957,92,24,24,92,83,67,9,2
1983,"Chesterfield",4,46,60,59,61,-2,1.30434782608696,1.28260869565217,1.32608695652174,-0.0434782608695652,81,13,24,92,69,100,12,0.3
1983,"Colchester United",4,46,67,69,53,16,1.45652173913043,1.5,1.15217391304348,0.347826086956522,76,8,24,92,75,68,1,0.1
1983,"Coventry City",1,42,50,57,77,-20,1.19047619047619,1.35714285714286,1.83333333333333,-0.476190476190476,18,18,22,22,17,94,1,0.7
1983,"Crewe Alexandra",4,46,59,56,67,-11,1.28260869565217,1.21739130434783,1.45652173913043,-0.239130434782609,83,15,24,92,78,96,5,1
1983,"Crystal Palace",2,42,47,42,52,-10,1.11904761904762,1,1.23809523809524,-0.238095238095238,40,18,22,44,37,93,3,1.7
1983,"Darlington",4,46,59,49,50,-1,1.28260869565217,1.06521739130435,1.08695652173913,-0.0217391304347826,84,16,24,92,71,81,13,-0.5
1983,"Derby County",2,42,42,36,72,-36,1,0.857142857142857,1.71428571428571,-0.857142857142857,42,20,22,44,51,121,-9,1.4
1983,"Doncaster Rovers",4,46,85,82,54,28,1.84782608695652,1.78260869565217,1.17391304347826,0.608695652173913,70,2,24,92,58,88,12,-1.5
1983,"Everton",1,42,62,44,42,2,1.47619047619048,1.04761904761905,1,0.0476190476190476,7,7,22,22,1,121,6,-1
1983,"Exeter City",3,46,33,50,84,-34,0.717391304347826,1.08695652173913,1.82608695652174,-0.739130434782609,68,24,24,68,85,88,-17,0
1983,"Fulham",2,42,57,60,53,7,1.35714285714286,1.42857142857143,1.26190476190476,0.166666666666667,34,12,22,44,30,102,4,-3.3
1983,"Gillingham",3,46,70,74,69,5,1.52173913043478,1.60869565217391,1.5,0.108695652173913,52,8,24,68,48,88,4,-3.4
1983,"Grimsby Town",2,42,70,60,47,13,1.66666666666667,1.42857142857143,1.11904761904762,0.30952380952381,26,4,22,44,32,110,-6,-1.1
1983,"Halifax Town",4,46,48,55,89,-34,1.04347826086957,1.19565217391304,1.93478260869565,-0.739130434782609,88,20,24,92,88,69,0,1.1
1983,"Hartlepool United",4,46,40,47,85,-38,0.869565217391304,1.02173913043478,1.84782608695652,-0.826086956521739,91,23,24,92,87,89,4,2.2
1983,"Hereford United",4,46,63,54,53,1,1.3695652173913,1.17391304347826,1.15217391304348,0.0217391304347826,79,11,24,92,73,31,6,-1.1
1983,"Huddersfield Town",2,42,57,56,49,7,1.35714285714286,1.33333333333333,1.16666666666667,0.166666666666667,35,13,22,44,35,99,0,-2.2
1983,"Hull City",3,46,83,71,38,33,1.80434782608696,1.54347826086957,0.826086956521739,0.717391304347826,47,3,24,68,47,104,0,-0.8
1983,"Ipswich Town",1,42,53,55,57,-2,1.26190476190476,1.30952380952381,1.35714285714286,-0.0476190476190476,12,12,22,22,18,75,-6,-0.6
1983,"Leeds United",2,42,60,55,56,-1,1.42857142857143,1.30952380952381,1.33333333333333,-0.0238095238095238,32,10,22,44,29,93,3,2.7
1983,"Leicester City",1,42,51,65,68,-3,1.21428571428571,1.54761904761905,1.61904761904762,-0.0714285714285714,14,14,22,22,15,115,-1,-1.2
1983,"Leyton Orient",3,46,63,71,81,-10,1.3695652173913,1.54347826086957,1.76086956521739,-0.217391304347826,55,11,24,68,66,102,-11,-0.9
1983,"Lincoln City",3,46,61,59,62,-3,1.32608695652174,1.28260869565217,1.34782608695652,-0.0652173913043478,58,14,24,68,63,107,-5,-2.4
1983,"Liverpool",1,42,80,73,32,41,1.9047619047619,1.73809523809524,0.761904761904762,0.976190476190476,1,1,22,22,2,116,-1,-0.7
1983,"Luton Town",1,42,51,53,66,-13,1.21428571428571,1.26190476190476,1.57142857142857,-0.30952380952381,15,15,22,22,13,91,2,-2.7
1983,"Manchester City",2,42,70,66,48,18,1.66666666666667,1.57142857142857,1.14285714285714,0.428571428571429,27,5,22,44,25,117,2,1.2
1983,"Manchester United",1,42,74,71,41,30,1.76190476190476,1.69047619047619,0.976190476190476,0.714285714285714,3,3,22,22,4,117,-1,0.2
1983,"Mansfield Town",4,46,52,66,70,-4,1.1304347826087,1.43478260869565,1.52173913043478,-0.0869565217391304,87,19,24,92,82,77,5,0.5
1983,"Middlesbrough",2,42,49,41,47,-6,1.16666666666667,0.976190476190476,1.11904761904762,-0.142857142857143,38,16,22,44,41,110,-3,0.7
1983,"Millwall",3,46,67,71,65,6,1.45652173913043,1.54347826086957,1.41304347826087,0.130434782608696,53,9,24,68,46,93,7,2.8
1983,"Newcastle United",2,42,80,85,53,32,1.9047619047619,2.02380952380952,1.26190476190476,0.761904761904762,25,3,22,44,14,116,11,2.2
1983,"Newport County",3,46,62,58,75,-17,1.34782608695652,1.26086956521739,1.6304347826087,-0.369565217391304,57,13,24,68,62,67,-5,-1.8
1983,"Northampton Town",4,46,53,53,78,-25,1.15217391304348,1.15217391304348,1.69565217391304,-0.543478260869565,86,18,24,92,90,93,-4,-0.6
1983,"Norwich City",1,42,51,48,49,-1,1.21428571428571,1.14285714285714,1.16666666666667,-0.0238095238095238,16,16,22,22,20,93,-4,0.4
1983,"Nottingham Forest",1,42,74,76,45,31,1.76190476190476,1.80952380952381,1.07142857142857,0.738095238095238,4,4,22,22,9,117,-5,-2
1983,"Notts County",1,42,41,50,72,-22,0.976190476190476,1.19047619047619,1.71428571428571,-0.523809523809524,21,21,22,22,42,120,-21,-0.8
1983,"Oldham Athletic",2,42,47,47,73,-26,1.11904761904762,1.11904761904762,1.73809523809524,-0.619047619047619,41,19,22,44,36,102,5,2
1983,"Oxford United",3,46,95,91,50,41,2.06521739130435,1.97826086956522,1.08695652173913,0.891304347826087,45,1,24,68,23,54,22,0
1983,"Peterborough United",4,46,68,72,48,24,1.47826086956522,1.56521739130435,1.04347826086957,0.521739130434783,75,7,24,92,79,60,-4,2.9
1983,"Plymouth Argyle",3,46,51,56,62,-6,1.10869565217391,1.21739130434783,1.34782608695652,-0.130434782608696,63,19,24,68,59,93,4,1.4
1983,"Port Vale",3,46,43,51,83,-32,0.934782608695652,1.10869565217391,1.80434782608696,-0.695652173913043,67,23,24,68,80,107,-13,1.9
1983,"Portsmouth",2,42,49,73,64,9,1.16666666666667,1.73809523809524,1.52380952380952,0.214285714285714,39,17,22,44,26,93,13,0
1983,"Preston North End",3,46,56,66,66,0,1.21739130434783,1.43478260869565,1.43478260869565,0,60,16,24,68,67,121,-7,-1.5
1983,"Queens Park Rangers",1,42,73,67,37,30,1.73809523809524,1.5952380952381,0.880952380952381,0.714285714285714,5,5,22,22,19,93,-14,-0.4
1983,"Reading",4,46,82,84,56,28,1.78260869565217,1.82608695652174,1.21739130434783,0.608695652173913,72,4,24,92,52,93,20,2.5
1983,"Rochdale",4,46,46,52,80,-28,1,1.1304347826087,1.73913043478261,-0.608695652173913,90,22,24,92,86,92,4,1.1
1983,"Rotherham United",3,46,54,57,64,-7,1.17391304347826,1.23913043478261,1.39130434782609,-0.152173913043478,62,18,24,68,56,88,6,0
1983,"Scunthorpe United",3,46,46,54,73,-19,1,1.17391304347826,1.58695652173913,-0.41304347826087,65,21,24,68,77,70,-12,-1.6
1983,"Sheffield United",3,46,83,86,53,33,1.80434782608696,1.8695652173913,1.15217391304348,0.717391304347826,48,4,24,68,40,117,8,2.8
1983,"Sheffield Wednesday",2,42,88,72,34,38,2.0952380952381,1.71428571428571,0.80952380952381,0.904761904761905,24,2,22,44,8,117,16,1.7
1983,"Shrewsbury Town",2,42,61,49,53,-4,1.45238095238095,1.16666666666667,1.26190476190476,-0.0952380952380952,30,8,22,44,31,69,-1,-4.1
1983,"Southampton",1,42,77,66,38,28,1.83333333333333,1.57142857142857,0.904761904761905,0.666666666666667,2,2,22,22,5,93,-3,-1.7
1983,"Southend United",3,46,44,55,76,-21,0.956521739130435,1.19565217391304,1.65217391304348,-0.456521739130435,66,22,24,68,89,93,-23,2.8
1983,"Stockport County",4,46,62,60,64,-4,1.34782608695652,1.30434782608696,1.39130434782609,-0.0869565217391304,80,12,24,92,91,99,-11,3
1983,"Stoke City",1,42,50,44,63,-19,1.19047619047619,1.04761904761905,1.5,-0.452380952380952,19,19,22,22,22,113,-3,-1.3
1983,"Sunderland",1,42,52,42,53,-11,1.23809523809524,1,1.26190476190476,-0.261904761904762,13,13,22,22,21,119,-8,-2.1
1983,"Swansea City",2,42,29,36,85,-49,0.69047619047619,0.857142857142857,2.02380952380952,-1.16666666666667,43,21,22,44,64,93,-21,-1.6
1983,"Swindon Town",4,46,58,58,56,2,1.26086956521739,1.26086956521739,1.21739130434783,0.0434782608695652,85,17,24,92,76,93,9,6.3
1983,"Torquay United",4,46,67,59,64,-5,1.45652173913043,1.28260869565217,1.39130434782609,-0.108695652173913,77,9,24,92,92,78,-15,0.1
1983,"Tottenham Hotspur",1,42,61,64,65,-1,1.45238095238095,1.52380952380952,1.54761904761905,-0.0238095238095238,8,8,22,22,3,101,5,-0.8
1983,"Tranmere Rovers",4,46,66,53,53,0,1.43478260869565,1.15217391304348,1.15217391304348,0,78,10,24,92,74,89,4,5.1
1983,"Walsall",3,46,75,68,61,7,1.6304347826087,1.47826086956522,1.32608695652174,0.152173913043478,50,6,24,68,55,100,-5,-3
1983,"Watford",1,42,57,68,77,-9,1.35714285714286,1.61904761904762,1.83333333333333,-0.214285714285714,11,11,22,22,11,93,0,-3
1983,"West Bromwich Albion",1,42,51,48,62,-14,1.21428571428571,1.14285714285714,1.47619047619048,-0.333333333333333,17,17,22,22,12,121,5,-2.7
1983,"West Ham United",1,42,60,60,55,5,1.42857142857143,1.42857142857143,1.30952380952381,0.119047619047619,10,10,22,22,16,94,-6,-0.3
1983,"Wigan Athletic",3,46,61,46,56,-10,1.32608695652174,1,1.21739130434783,-0.217391304347826,59,15,24,68,60,42,-1,-3
1983,"Wimbledon",3,46,87,97,76,21,1.89130434782609,2.10869565217391,1.65217391304348,0.456521739130435,46,2,24,68,34,27,12,4
1983,"Wolverhampton Wanderers",1,42,29,27,80,-53,0.69047619047619,0.642857142857143,1.9047619047619,-1.26190476190476,22,22,22,22,44,121,-22,-0.8
1983,"Wrexham",4,46,48,59,74,-15,1.04347826086957,1.28260869565217,1.60869565217391,-0.326086956521739,89,21,24,92,84,80,5,3.1
1983,"York City",4,46,101,96,39,57,2.19565217391304,2.08695652173913,0.847826086956522,1.23913043478261,69,1,24,92,53,72,16,1.8
1984,"AFC Bournemouth",3,46,68,57,46,11,1.47826086956522,1.23913043478261,1,0.239130434782609,54,10,24,68,59,90,-5,-1.1
1984,"Aldershot",4,46,59,56,63,-7,1.28260869565217,1.21739130434783,1.3695652173913,-0.152173913043478,81,13,24,92,84,57,-3,0.1
1984,"Arsenal",1,42,66,61,49,12,1.57142857142857,1.45238095238095,1.16666666666667,0.285714285714286,6,6,22,22,7,116,-1,-0.6
1984,"Aston Villa",1,42,56,60,60,0,1.33333333333333,1.42857142857143,1.42857142857143,0,10,10,22,22,16,121,-6,-0.8
1984,"Barnsley",2,42,58,42,42,0,1.38095238095238,1,1,0,33,11,22,44,33,111,0,0.5
1984,"Birmingham City",2,42,82,59,33,26,1.95238095238095,1.4047619047619,0.785714285714286,0.619047619047619,24,2,22,44,21,117,3,-2.3
1984,"Blackburn Rovers",2,42,73,66,41,25,1.73809523809524,1.57142857142857,0.976190476190476,0.595238095238095,27,5,22,44,41,121,-14,2.6
1984,"Blackpool",4,46,86,73,39,34,1.8695652173913,1.58695652173913,0.847826086956522,0.739130434782609,70,2,24,92,56,112,14,1.2
1984,"Bolton Wanderers",3,46,54,69,75,-6,1.17391304347826,1.5,1.6304347826087,-0.130434782608696,61,17,24,68,61,121,0,3.6
1984,"Bradford City",3,46,94,77,45,32,2.04347826086957,1.67391304347826,0.978260869565217,0.695652173913043,45,1,24,68,35,106,10,-1.5
1984,"Brentford",3,46,62,62,64,-2,1.34782608695652,1.34782608695652,1.39130434782609,-0.0434782608695652,57,13,24,68,54,93,3,0.9
1984,"Brighton & Hove Albion",2,42,72,54,34,20,1.71428571428571,1.28571428571429,0.80952380952381,0.476190476190476,28,6,22,44,34,93,-6,-3.4
1984,"Bristol City",3,46,81,74,47,27,1.76086956521739,1.60869565217391,1.02173913043478,0.58695652173913,49,5,24,68,53,108,-4,0.4
1984,"Bristol Rovers",3,46,75,66,48,18,1.6304347826087,1.43478260869565,1.04347826086957,0.391304347826087,50,6,24,68,60,92,-10,0
1984,"Burnley",3,46,46,60,73,-13,1,1.30434782608696,1.58695652173913,-0.282608695652174,65,21,24,68,82,121,-17,2.1
1984,"Bury",4,46,84,76,50,26,1.82608695652174,1.65217391304348,1.08695652173913,0.565217391304348,72,4,24,92,64,114,8,-0.2
1984,"Cambridge United",3,46,21,37,95,-58,0.456521739130435,0.804347826086957,2.06521739130435,-1.26086956521739,68,24,24,68,87,41,-19,0.2
1984,"Cardiff City",2,42,35,47,79,-32,0.833333333333333,1.11904761904762,1.88095238095238,-0.761904761904762,43,21,22,44,66,93,-23,-2.5
1984,"Carlisle United",2,42,47,50,67,-17,1.11904761904762,1.19047619047619,1.5952380952381,-0.404761904761905,38,16,22,44,42,84,-4,-3.3
1984,"Charlton Athletic",2,42,45,51,63,-12,1.07142857142857,1.21428571428571,1.5,-0.285714285714286,39,17,22,44,24,92,15,0.2
1984,"Chelsea",1,42,66,63,48,15,1.57142857142857,1.5,1.14285714285714,0.357142857142857,7,7,22,22,6,104,1,-0.3
1984,"Chester",4,46,54,60,72,-12,1.17391304347826,1.30434782608696,1.56521739130435,-0.260869565217391,83,15,24,92,70,67,13,1.4
1984,"Chesterfield",4,46,91,64,35,29,1.97826086956522,1.39130434782609,0.760869565217391,0.630434782608696,69,1,24,92,62,100,7,-0.4
1984,"Colchester United",4,46,74,87,65,22,1.60869565217391,1.89130434782609,1.41304347826087,0.478260869565217,75,7,24,92,74,68,1,-0.1
1984,"Coventry City",1,42,50,47,64,-17,1.19047619047619,1.11904761904762,1.52380952380952,-0.404761904761905,17,17,22,22,17,94,0,0.3
1984,"Crewe Alexandra",4,46,66,65,69,-4,1.43478260869565,1.41304347826087,1.5,-0.0869565217391304,78,10,24,92,80,96,-2,2.9
1984,"Crystal Palace",2,42,48,46,65,-19,1.14285714285714,1.0952380952381,1.54761904761905,-0.452380952380952,37,15,22,44,27,93,10,1.8
1984,"Darlington",4,46,85,66,49,17,1.84782608695652,1.43478260869565,1.06521739130435,0.369565217391304,71,3,24,92,57,81,14,-0.1
1984,"Derby County",3,46,70,65,54,11,1.52173913043478,1.41304347826087,1.17391304347826,0.239130434782609,51,7,24,68,47,121,4,2
1984,"Doncaster Rovers",3,46,59,72,74,-2,1.28260869565217,1.56521739130435,1.60869565217391,-0.0434782608695652,58,14,24,68,55,88,3,-2.1
1984,"Everton",1,42,90,88,43,45,2.14285714285714,2.0952380952381,1.02380952380952,1.07142857142857,1,1,22,22,2,121,-1,-1.4
1984,"Exeter City",4,46,53,57,79,-22,1.15217391304348,1.23913043478261,1.71739130434783,-0.478260869565217,85,17,24,92,88,88,-3,-0.6
1984,"Fulham",2,42,65,68,64,4,1.54761904761905,1.61904761904762,1.52380952380952,0.0952380952380952,30,8,22,44,44,102,-14,-4.7
1984,"Gillingham",3,46,83,80,62,18,1.80434782608696,1.73913043478261,1.34782608695652,0.391304347826087,48,4,24,68,49,88,-1,-4.2
1984,"Grimsby Town",2,42,62,72,64,8,1.47619047619048,1.71428571428571,1.52380952380952,0.19047619047619,32,10,22,44,37,110,-5,0
1984,"Halifax Town",4,46,50,42,69,-27,1.08695652173913,0.91304347826087,1.5,-0.58695652173913,88,20,24,92,89,69,-1,0.2
1984,"Hartlepool United",4,46,52,54,67,-13,1.1304347826087,1.17391304347826,1.45652173913043,-0.282608695652174,87,19,24,92,75,89,12,-0.1
1984,"Hereford United",4,46,77,65,47,18,1.67391304347826,1.41304347826087,1.02173913043478,0.391304347826087,73,5,24,92,76,31,-3,-1.3
1984,"Huddersfield Town",2,42,55,52,64,-12,1.30952380952381,1.23809523809524,1.52380952380952,-0.285714285714286,35,13,22,44,38,99,-3,-1.6
1984,"Hull City",3,46,87,78,49,29,1.89130434782609,1.69565217391304,1.06521739130435,0.630434782608696,47,3,24,68,28,104,19,-0.7
1984,"Ipswich Town",1,42,50,46,57,-11,1.19047619047619,1.0952380952381,1.35714285714286,-0.261904761904762,18,18,22,22,20,75,-2,-0.4
1984,"Leeds United",2,42,69,66,43,23,1.64285714285714,1.57142857142857,1.02380952380952,0.547619047619048,29,7,22,44,36,93,-7,2.4
1984,"Leicester City",1,42,51,65,73,-8,1.21428571428571,1.54761904761905,1.73809523809524,-0.19047619047619,15,15,22,22,18,115,-3,-0.6
1984,"Leyton Orient",3,46,46,51,76,-25,1,1.10869565217391,1.65217391304348,-0.543478260869565,66,22,24,68,73,102,-7,-0.4
1984,"Lincoln City",3,46,51,50,51,-1,1.10869565217391,1.08695652173913,1.10869565217391,-0.0217391304347826,63,19,24,68,65,107,-2,-2.3
1984,"Liverpool",1,42,77,68,35,33,1.83333333333333,1.61904761904762,0.833333333333333,0.785714285714286,2,2,22,22,1,116,1,-0.2
1984,"Luton Town",1,42,54,57,61,-4,1.28571428571429,1.35714285714286,1.45238095238095,-0.0952380952380952,13,13,22,22,9,91,4,-2.5
1984,"Manchester City",2,42,74,66,40,26,1.76190476190476,1.57142857142857,0.952380952380952,0.619047619047619,25,3,22,44,15,117,10,0.8
1984,"Manchester United",1,42,76,77,47,30,1.80952380952381,1.83333333333333,1.11904761904762,0.714285714285714,4,4,22,22,4,117,0,0.2
1984,"Mansfield Town",4,46,57,41,38,3,1.23913043478261,0.891304347826087,0.826086956521739,0.0652173913043478,82,14,24,92,71,77,11,0.6
1984,"Middlesbrough",2,42,40,41,57,-16,0.952380952380952,0.976190476190476,1.35714285714286,-0.380952380952381,41,19,22,44,43,110,-2,1.8
1984,"Millwall",3,46,90,73,42,31,1.95652173913043,1.58695652173913,0.91304347826087,0.673913043478261,46,2,24,68,31,93,15,1.2
1984,"Newcastle United",1,42,52,55,70,-15,1.23809523809524,1.30952380952381,1.66666666666667,-0.357142857142857,14,14,22,22,11,116,3,0.8
1984,"Newport County",3,46,52,55,67,-12,1.1304347826087,1.19565217391304,1.45652173913043,-0.260869565217391,62,18,24,68,63,67,-1,-1.4
1984,"Northampton Town",4,46,47,53,74,-21,1.02173913043478,1.15217391304348,1.60869565217391,-0.456521739130435,90,22,24,92,77,93,13,0.3
1984,"Norwich City",1,42,49,46,64,-18,1.16666666666667,1.0952380952381,1.52380952380952,-0.428571428571429,20,20,22,22,23,93,-3,0
1984,"Nottingham Forest",1,42,64,56,48,8,1.52380952380952,1.33333333333333,1.14285714285714,0.19047619047619,9,9,22,22,8,117,1,0.6
1984,"Notts County",2,42,37,45,73,-28,0.880952380952381,1.07142857142857,1.73809523809524,-0.666666666666667,42,20,22,44,51,120,-9,-0.4
1984,"Oldham Athletic",2,42,53,49,67,-18,1.26190476190476,1.16666666666667,1.5952380952381,-0.428571428571429,36,14,22,44,30,102,6,0
1984,"Oxford United",2,42,84,84,36,48,2,2,0.857142857142857,1.14285714285714,23,1,22,44,19,54,4,-3
1984,"Peterborough United",4,46,62,54,53,1,1.34782608695652,1.17391304347826,1.15217391304348,0.0217391304347826,79,11,24,92,85,60,-6,1.8
1984,"Plymouth Argyle",3,46,59,62,65,-3,1.28260869565217,1.34782608695652,1.41304347826087,-0.0652173913043478,59,15,24,68,46,93,13,-0.8
1984,"Port Vale",4,46,60,61,59,2,1.30434782608696,1.32608695652174,1.28260869565217,0.0434782608695652,80,12,24,92,72,107,8,4.1
1984,"Portsmouth",2,42,74,69,50,19,1.76190476190476,1.64285714285714,1.19047619047619,0.452380952380952,26,4,22,44,26,93,0,-1.4
1984,"Preston North End",3,46,46,51,100,-49,1,1.10869565217391,2.17391304347826,-1.06521739130435,67,23,24,68,91,121,-24,-0.8
1984,"Queens Park Rangers",1,42,50,53,72,-19,1.19047619047619,1.26190476190476,1.71428571428571,-0.452380952380952,19,19,22,22,13,93,6,1.1
1984,"Reading",3,46,69,68,62,6,1.5,1.47826086956522,1.34782608695652,0.130434782608696,52,8,24,68,45,93,7,2.8
1984,"Rochdale",4,46,53,55,69,-14,1.15217391304348,1.19565217391304,1.5,-0.304347826086957,86,18,24,92,86,92,0,0.1
1984,"Rotherham United",3,46,65,55,55,0,1.41304347826087,1.19565217391304,1.19565217391304,0,56,12,24,68,58,88,-2,-0.7
1984,"Scunthorpe United",4,46,71,83,62,21,1.54347826086957,1.80434782608696,1.34782608695652,0.456521739130435,77,9,24,92,83,70,-6,-0.1
1984,"Sheffield United",2,42,44,54,66,-12,1.04761904761905,1.28571428571429,1.57142857142857,-0.285714285714286,40,18,22,44,29,117,11,1
1984,"Sheffield Wednesday",1,42,65,58,45,13,1.54761904761905,1.38095238095238,1.07142857142857,0.30952380952381,8,8,22,22,5,117,3,-0.5
1984,"Shrewsbury Town",2,42,65,66,53,13,1.54761904761905,1.57142857142857,1.26190476190476,0.30952380952381,31,9,22,44,39,69,-8,-3.3
1984,"Southampton",1,42,68,56,47,9,1.61904761904762,1.33333333333333,1.11904761904762,0.214285714285714,5,5,22,22,14,93,-9,-0.6
1984,"Southend United",4,46,50,58,83,-25,1.08695652173913,1.26086956521739,1.80434782608696,-0.543478260869565,89,21,24,92,78,93,11,5.4
1984,"Stockport County",4,46,47,58,79,-21,1.02173913043478,1.26086956521739,1.71739130434783,-0.456521739130435,91,23,24,92,79,99,12,3.4
1984,"Stoke City",1,42,17,24,91,-67,0.404761904761905,0.571428571428571,2.16666666666667,-1.5952380952381,22,22,22,22,32,113,-10,-1.1
1984,"Sunderland",1,42,40,40,62,-22,0.952380952380952,0.952380952380952,1.47619047619048,-0.523809523809524,21,21,22,22,40,119,-19,-2.1
1984,"Swansea City",3,46,47,53,80,-27,1.02173913043478,1.15217391304348,1.73913043478261,-0.58695652173913,64,20,24,68,67,93,-3,0.8
1984,"Swindon Town",4,46,72,62,58,4,1.56521739130435,1.34782608695652,1.26086956521739,0.0869565217391304,76,8,24,92,69,93,7,3.3
1984,"Torquay United",4,46,41,38,63,-25,0.891304347826087,0.826086956521739,1.3695652173913,-0.543478260869565,92,24,24,92,92,78,0,0.9
1984,"Tottenham Hotspur",1,42,77,78,51,27,1.83333333333333,1.85714285714286,1.21428571428571,0.642857142857143,3,3,22,22,10,101,-7,-0.4
1984,"Tranmere Rovers",4,46,75,83,66,17,1.6304347826087,1.80434782608696,1.43478260869565,0.369565217391304,74,6,24,92,90,89,-16,4.8
1984,"Walsall",3,46,67,58,52,6,1.45652173913043,1.26086956521739,1.1304347826087,0.130434782608696,55,11,24,68,50,100,5,-1.7
1984,"Watford",1,42,55,81,71,10,1.30952380952381,1.92857142857143,1.69047619047619,0.238095238095238,11,11,22,22,12,93,-1,-1.8
1984,"West Bromwich Albion",1,42,55,58,62,-4,1.30952380952381,1.38095238095238,1.47619047619048,-0.0952380952380952,12,12,22,22,22,121,-10,-2.9
1984,"West Ham United",1,42,51,51,68,-17,1.21428571428571,1.21428571428571,1.61904761904762,-0.404761904761905,16,16,22,22,3,94,13,0
1984,"Wigan Athletic",3,46,59,60,64,-4,1.28260869565217,1.30434782608696,1.39130434782609,-0.0869565217391304,60,16,24,68,48,42,12,-2.4
1984,"Wimbledon",2,42,58,71,75,-4,1.38095238095238,1.69047619047619,1.78571428571429,-0.0952380952380952,34,12,22,44,25,27,9,2.5
1984,"Wolverhampton Wanderers",2,42,33,37,79,-42,0.785714285714286,0.880952380952381,1.88095238095238,-1,44,22,22,44,68,121,-24,1.7
1984,"Wrexham",4,46,54,67,70,-3,1.17391304347826,1.45652173913043,1.52173913043478,-0.0652173913043478,84,16,24,92,81,80,3,2.5
1984,"York City",3,46,69,70,57,13,1.5,1.52173913043478,1.23913043478261,0.282608695652174,53,9,24,68,52,72,1,-0.2
1985,"AFC Bournemouth",3,46,54,65,72,-7,1.17391304347826,1.41304347826087,1.56521739130435,-0.152173913043478,59,15,24,68,45,90,14,0.1
1985,"Aldershot",4,46,58,66,74,-8,1.26086956521739,1.43478260869565,1.60869565217391,-0.173913043478261,84,16,24,92,73,57,11,-0.8
1985,"Arsenal",1,42,69,49,47,2,1.64285714285714,1.16666666666667,1.11904761904762,0.0476190476190476,7,7,22,22,4,116,3,0.3
1985,"Aston Villa",1,42,44,51,67,-16,1.04761904761905,1.21428571428571,1.5952380952381,-0.380952380952381,16,16,22,22,22,121,-6,1.1
1985,"Barnsley",2,42,56,47,50,-3,1.33333333333333,1.11904761904762,1.19047619047619,-0.0714285714285714,33,11,22,44,32,111,1,0.3
1985,"Birmingham City",1,42,29,30,73,-43,0.69047619047619,0.714285714285714,1.73809523809524,-1.02380952380952,21,21,22,22,41,117,-20,-1.4
1985,"Blackburn Rovers",2,42,49,53,62,-9,1.16666666666667,1.26190476190476,1.47619047619048,-0.214285714285714,41,19,22,44,33,121,8,3.5
1985,"Blackpool",3,46,63,66,55,11,1.3695652173913,1.43478260869565,1.19565217391304,0.239130434782609,56,12,24,68,53,112,3,0.9
1985,"Bolton Wanderers",3,46,53,54,68,-14,1.15217391304348,1.17391304347826,1.47826086956522,-0.304347826086957,61,17,24,68,65,121,-4,4.1
1985,"Bradford City",2,42,54,51,63,-12,1.28571428571429,1.21428571428571,1.5,-0.285714285714286,35,13,22,44,34,106,1,-1.4
1985,"Brentford",3,46,66,58,61,-3,1.43478260869565,1.26086956521739,1.32608695652174,-0.0652173913043478,54,10,24,68,55,93,-1,-0.5
1985,"Brighton & Hove Albion",2,42,56,64,64,0,1.33333333333333,1.52380952380952,1.52380952380952,0,34,12,22,44,44,93,-10,-3.3
1985,"Bristol City",3,46,68,69,60,9,1.47826086956522,1.5,1.30434782608696,0.195652173913043,53,9,24,68,50,108,3,-0.3
1985,"Bristol Rovers",3,46,54,51,75,-24,1.17391304347826,1.10869565217391,1.6304347826087,-0.521739130434783,60,16,24,68,63,92,-3,0.8
1985,"Burnley",4,46,59,60,65,-5,1.28260869565217,1.30434782608696,1.41304347826087,-0.108695652173913,82,14,24,92,90,121,-8,2.1
1985,"Bury",3,46,49,63,67,-4,1.06521739130435,1.3695652173913,1.45652173913043,-0.0869565217391304,64,20,24,68,60,114,4,-0.7
1985,"Cambridge United",4,46,54,65,80,-15,1.17391304347826,1.41304347826087,1.73913043478261,-0.326086956521739,87,19,24,92,79,41,8,0.3
1985,"Cardiff City",3,46,45,53,83,-30,0.978260869565217,1.15217391304348,1.80434782608696,-0.652173913043478,66,22,24,68,81,93,-15,-2.4
1985,"Carlisle United",2,42,46,47,71,-24,1.0952380952381,1.11904761904762,1.69047619047619,-0.571428571428571,42,20,22,44,66,84,-24,-2.3
1985,"Charlton Athletic",2,42,77,78,45,33,1.83333333333333,1.85714285714286,1.07142857142857,0.785714285714286,24,2,22,44,19,92,5,-0.1
1985,"Chelsea",1,42,71,57,56,1,1.69047619047619,1.35714285714286,1.33333333333333,0.0238095238095238,6,6,22,22,12,104,-6,-0.5
1985,"Chester",4,46,84,83,50,33,1.82608695652174,1.80434782608696,1.08695652173913,0.717391304347826,70,2,24,92,59,67,11,-0.7
1985,"Chesterfield",3,46,53,61,64,-3,1.15217391304348,1.32608695652174,1.39130434782609,-0.0652173913043478,62,18,24,68,61,100,1,1.1
1985,"Colchester United",4,46,70,88,63,25,1.52173913043478,1.91304347826087,1.3695652173913,0.543478260869565,74,6,24,92,74,68,0,0.2
1985,"Coventry City",1,42,43,48,71,-23,1.02380952380952,1.14285714285714,1.69047619047619,-0.547619047619048,17,17,22,22,9,94,8,0.1
1985,"Crewe Alexandra",4,46,63,54,61,-7,1.3695652173913,1.17391304347826,1.32608695652174,-0.152173913043478,80,12,24,92,84,96,-4,3
1985,"Crystal Palace",2,42,66,57,52,5,1.57142857142857,1.35714285714286,1.23809523809524,0.119047619047619,27,5,22,44,28,93,-1,0.4
1985,"Darlington",3,46,58,61,78,-17,1.26086956521739,1.32608695652174,1.69565217391304,-0.369565217391304,57,13,24,68,67,81,-10,-2.9
1985,"Derby County",3,46,84,80,41,39,1.82608695652174,1.73913043478261,0.891304347826087,0.847826086956522,47,3,24,68,23,121,24,2.5
1985,"Doncaster Rovers",3,46,64,45,52,-7,1.39130434782609,0.978260869565217,1.1304347826087,-0.152173913043478,55,11,24,68,56,88,-1,-2.6
1985,"Everton",1,42,86,87,41,46,2.04761904761905,2.07142857142857,0.976190476190476,1.0952380952381,2,2,22,22,1,121,1,-0.5
1985,"Exeter City",4,46,54,47,59,-12,1.17391304347826,1.02173913043478,1.28260869565217,-0.260869565217391,88,20,24,92,82,88,6,0.6
1985,"Fulham",2,42,36,45,69,-24,0.857142857142857,1.07142857142857,1.64285714285714,-0.571428571428571,44,22,22,44,62,102,-18,-4.1
1985,"Gillingham",3,46,79,81,54,27,1.71739130434783,1.76086956521739,1.17391304347826,0.58695652173913,49,5,24,68,49,88,0,-2.1
1985,"Grimsby Town",2,42,52,58,62,-4,1.23809523809524,1.38095238095238,1.47619047619048,-0.0952380952380952,37,15,22,44,43,110,-6,0
1985,"Halifax Town",4,46,54,60,71,-11,1.17391304347826,1.30434782608696,1.54347826086957,-0.239130434782609,89,21,24,92,83,69,6,-0.2
1985,"Hartlepool United",4,46,70,68,67,1,1.52173913043478,1.47826086956522,1.45652173913043,0.0217391304347826,75,7,24,92,86,89,-11,-1.3
1985,"Hereford United",4,46,64,74,73,1,1.39130434782609,1.60869565217391,1.58695652173913,0.0217391304347826,76,8,24,92,85,31,-9,0.2
1985,"Huddersfield Town",2,42,52,51,67,-16,1.23809523809524,1.21428571428571,1.5952380952381,-0.380952380952381,38,16,22,44,37,99,1,1
1985,"Hull City",2,42,64,65,55,10,1.52380952380952,1.54761904761905,1.30952380952381,0.238095238095238,28,6,22,44,35,104,-7,-4
1985,"Ipswich Town",1,42,41,32,55,-23,0.976190476190476,0.761904761904762,1.30952380952381,-0.547619047619048,20,20,22,22,27,75,-7,-0.7
1985,"Leeds United",2,42,53,56,72,-16,1.26190476190476,1.33333333333333,1.71428571428571,-0.380952380952381,36,14,22,44,26,93,10,2.4
1985,"Leicester City",1,42,42,54,76,-22,1,1.28571428571429,1.80952380952381,-0.523809523809524,18,18,22,22,20,115,-2,-0.8
1985,"Leyton Orient",4,46,72,79,64,15,1.56521739130435,1.71739130434783,1.39130434782609,0.326086956521739,73,5,24,92,75,102,-2,-1.6
1985,"Lincoln City",3,46,46,55,77,-22,1,1.19565217391304,1.67391304347826,-0.478260869565217,65,21,24,68,91,107,-26,-1.2
1985,"Liverpool",1,42,88,89,37,52,2.0952380952381,2.11904761904762,0.880952380952381,1.23809523809524,1,1,22,22,2,116,-1,-0.2
1985,"Luton Town",1,42,66,61,44,17,1.57142857142857,1.45238095238095,1.04761904761905,0.404761904761905,9,9,22,22,6,91,3,-3.5
1985,"Manchester City",1,42,45,43,57,-14,1.07142857142857,1.02380952380952,1.35714285714286,-0.333333333333333,15,15,22,22,21,117,-6,-0.2
1985,"Manchester United",1,42,76,70,36,34,1.80952380952381,1.66666666666667,0.857142857142857,0.80952380952381,4,4,22,22,11,117,-7,0.3
1985,"Mansfield Town",4,46,81,74,47,27,1.76086956521739,1.60869565217391,1.02173913043478,0.58695652173913,71,3,24,92,54,77,17,-1.6
1985,"Middlesbrough",2,42,45,44,53,-9,1.07142857142857,1.04761904761905,1.26190476190476,-0.214285714285714,43,21,22,44,46,110,-3,3
1985,"Millwall",2,42,59,64,65,-1,1.4047619047619,1.52380952380952,1.54761904761905,-0.0238095238095238,31,9,22,44,38,93,-7,-1
1985,"Newcastle United",1,42,63,67,72,-5,1.5,1.5952380952381,1.71428571428571,-0.119047619047619,11,11,22,22,17,116,-6,0.9
1985,"Newport County",3,46,51,52,65,-13,1.10869565217391,1.1304347826087,1.41304347826087,-0.282608695652174,63,19,24,68,68,67,-5,NA
1985,"Northampton Town",4,46,64,79,58,21,1.39130434782609,1.71739130434783,1.26086956521739,0.456521739130435,77,9,24,92,69,93,8,-0.2
1985,"Norwich City",2,42,84,84,37,47,2,2,0.880952380952381,1.11904761904762,23,1,22,44,5,93,18,-1.3
1985,"Nottingham Forest",1,42,68,69,53,16,1.61904761904762,1.64285714285714,1.26190476190476,0.380952380952381,8,8,22,22,8,117,0,-0.1
1985,"Notts County",3,46,71,71,60,11,1.54347826086957,1.54347826086957,1.30434782608696,0.239130434782609,51,7,24,68,51,120,0,0.3
1985,"Oldham Athletic",2,42,60,62,61,1,1.42857142857143,1.47619047619048,1.45238095238095,0.0238095238095238,30,8,22,44,25,102,5,-0.8
1985,"Oxford United",1,42,42,62,80,-18,1,1.47619047619048,1.9047619047619,-0.428571428571429,19,19,22,22,18,54,1,-2.7
1985,"Peterborough United",4,46,56,52,64,-12,1.21739130434783,1.1304347826087,1.39130434782609,-0.260869565217391,85,17,24,92,77,60,8,2.2
1985,"Plymouth Argyle",3,46,87,88,53,35,1.89130434782609,1.91304347826087,1.15217391304348,0.760869565217391,46,2,24,68,29,93,17,-2.7
1985,"Port Vale",4,46,79,67,37,30,1.71739130434783,1.45652173913043,0.804347826086957,0.652173913043478,72,4,24,92,57,107,15,4.1
1985,"Portsmouth",2,42,73,69,41,28,1.73809523809524,1.64285714285714,0.976190476190476,0.666666666666667,26,4,22,44,24,93,2,-1.6
1985,"Preston North End",4,46,43,54,89,-35,0.934782608695652,1.17391304347826,1.93478260869565,-0.760869565217391,91,23,24,92,70,121,21,2.2
1985,"Queens Park Rangers",1,42,52,53,64,-11,1.23809523809524,1.26190476190476,1.52380952380952,-0.261904761904762,13,13,22,22,16,93,-3,-0.6
1985,"Reading",3,46,94,67,51,16,2.04347826086957,1.45652173913043,1.10869565217391,0.347826086956522,45,1,24,68,36,93,9,0.6
1985,"Rochdale",4,46,55,57,77,-20,1.19565217391304,1.23913043478261,1.67391304347826,-0.434782608695652,86,18,24,92,88,92,-2,0.3
1985,"Rotherham United",3,46,57,61,59,2,1.23913043478261,1.32608695652174,1.28260869565217,0.0434782608695652,58,14,24,68,58,88,0,-0.2
1985,"Scunthorpe United",4,46,59,50,55,-5,1.28260869565217,1.08695652173913,1.19565217391304,-0.108695652173913,83,15,24,92,76,70,7,0.3
1985,"Sheffield United",2,42,62,64,63,1,1.47619047619048,1.52380952380952,1.5,0.0238095238095238,29,7,22,44,30,117,-1,0
1985,"Sheffield Wednesday",1,42,73,63,54,9,1.73809523809524,1.5,1.28571428571429,0.214285714285714,5,5,22,22,13,117,-8,-1
1985,"Shrewsbury Town",2,42,51,52,64,-12,1.21428571428571,1.23809523809524,1.52380952380952,-0.285714285714286,39,17,22,44,39,69,0,-2.3
1985,"Southampton",1,42,46,51,62,-11,1.0952380952381,1.21428571428571,1.47619047619048,-0.261904761904762,14,14,22,22,14,93,0,-0.4
1985,"Southend United",4,46,64,69,67,2,1.39130434782609,1.5,1.45652173913043,0.0434782608695652,78,10,24,92,71,93,7,4.5
1985,"Stockport County",4,46,64,63,71,-8,1.39130434782609,1.3695652173913,1.54347826086957,-0.173913043478261,79,11,24,92,87,99,-8,2.6
1985,"Stoke City",2,42,57,48,50,-2,1.35714285714286,1.14285714285714,1.19047619047619,-0.0476190476190476,32,10,22,44,31,113,1,0.8
1985,"Sunderland",2,42,50,47,61,-14,1.19047619047619,1.11904761904762,1.45238095238095,-0.333333333333333,40,18,22,44,42,119,-2,1.9
1985,"Swansea City",3,46,43,43,87,-44,0.934782608695652,0.934782608695652,1.89130434782609,-0.956521739130435,67,23,24,68,80,93,-13,0.1
1985,"Swindon Town",4,46,102,82,43,39,2.21739130434783,1.78260869565217,0.934782608695652,0.847826086956522,69,1,24,92,47,93,22,2.4
1985,"Torquay United",4,46,37,43,88,-45,0.804347826086957,0.934782608695652,1.91304347826087,-0.978260869565217,92,24,24,92,92,78,0,0
1985,"Tottenham Hotspur",1,42,65,74,52,22,1.54761904761905,1.76190476190476,1.23809523809524,0.523809523809524,10,10,22,22,3,101,7,0.2
1985,"Tranmere Rovers",4,46,54,74,73,1,1.17391304347826,1.60869565217391,1.58695652173913,0.0217391304347826,90,22,24,92,89,89,1,5.6
1985,"Walsall",3,46,75,90,64,26,1.6304347826087,1.95652173913043,1.39130434782609,0.565217391304348,50,6,24,68,52,100,-2,-0.5
1985,"Watford",1,42,59,69,62,7,1.4047619047619,1.64285714285714,1.47619047619048,0.166666666666667,12,12,22,22,10,93,2,-3.1
1985,"West Bromwich Albion",1,42,24,35,89,-54,0.571428571428571,0.833333333333333,2.11904761904762,-1.28571428571429,22,22,22,22,40,121,-18,-1
1985,"West Ham United",1,42,84,74,40,34,2,1.76190476190476,0.952380952380952,0.80952380952381,3,3,22,22,15,94,-12,-0.7
1985,"Wigan Athletic",3,46,83,82,48,34,1.80434782608696,1.78260869565217,1.04347826086957,0.739130434782609,48,4,24,68,48,42,0,-3
1985,"Wimbledon",2,42,76,58,37,21,1.80952380952381,1.38095238095238,0.880952380952381,0.5,25,3,22,44,7,27,18,1.1
1985,"Wolverhampton Wanderers",3,46,43,57,98,-41,0.934782608695652,1.23913043478261,2.1304347826087,-0.891304347826087,68,24,24,68,72,121,-4,2.8
1985,"Wrexham",4,46,60,68,80,-12,1.30434782608696,1.47826086956522,1.73913043478261,-0.260869565217391,81,13,24,92,78,80,3,2.7
1985,"York City",3,46,71,77,58,19,1.54347826086957,1.67391304347826,1.26086956521739,0.41304347826087,52,8,24,68,64,72,-12,-1.2
1986,"AFC Bournemouth",3,46,97,76,40,36,2.10869565217391,1.65217391304348,0.869565217391304,0.782608695652174,45,1,24,68,38,90,7,-1.5
1986,"Aldershot",4,46,70,64,57,7,1.52173913043478,1.39130434782609,1.23913043478261,0.152173913043478,73,5,24,92,64,57,9,NA
1986,"Arsenal",1,42,70,58,35,23,1.66666666666667,1.38095238095238,0.833333333333333,0.547619047619048,4,4,22,22,6,116,-2,0.2
1986,"Aston Villa",1,42,36,45,79,-34,0.857142857142857,1.07142857142857,1.88095238095238,-0.80952380952381,22,22,22,22,23,121,-1,1.7
1986,"Barnsley",2,42,55,49,52,-3,1.30952380952381,1.16666666666667,1.23809523809524,-0.0714285714285714,32,10,22,44,35,111,-3,1
1986,"Birmingham City",2,42,50,47,59,-12,1.19047619047619,1.11904761904762,1.4047619047619,-0.285714285714286,41,19,22,44,40,117,1,1.2
1986,"Blackburn Rovers",2,42,55,45,55,-10,1.30952380952381,1.07142857142857,1.30952380952381,-0.238095238095238,33,11,22,44,25,121,8,2
1986,"Blackpool",3,46,64,74,59,15,1.39130434782609,1.60869565217391,1.28260869565217,0.326086956521739,53,9,24,68,54,112,-1,0.2
1986,"Bolton Wanderers",3,46,45,46,58,-12,0.978260869565217,1,1.26086956521739,-0.260869565217391,65,21,24,68,71,121,-6,4.4
1986,"Bradford City",2,42,55,62,62,0,1.30952380952381,1.47619047619048,1.47619047619048,0,34,12,22,44,26,106,8,-0.7
1986,"Brentford",3,46,60,64,66,-2,1.30434782608696,1.39130434782609,1.43478260869565,-0.0434782608695652,55,11,24,68,56,93,-1,0.7
1986,"Brighton & Hove Albion",2,42,39,37,54,-17,0.928571428571429,0.880952380952381,1.28571428571429,-0.404761904761905,44,22,22,44,46,93,-2,-4.6
1986,"Bristol City",3,46,77,63,36,27,1.67391304347826,1.3695652173913,0.782608695652174,0.58695652173913,50,6,24,68,49,108,1,0.1
1986,"Bristol Rovers",3,46,51,49,75,-26,1.10869565217391,1.06521739130435,1.6304347826087,-0.565217391304348,63,19,24,68,52,92,11,0.2
1986,"Burnley",4,46,49,53,74,-21,1.06521739130435,1.15217391304348,1.60869565217391,-0.456521739130435,90,22,24,92,77,121,13,3.7
1986,"Bury",3,46,55,54,60,-6,1.19565217391304,1.17391304347826,1.30434782608696,-0.130434782608696,60,16,24,68,57,114,3,1.5
1986,"Cambridge United",4,46,62,60,62,-2,1.34782608695652,1.30434782608696,1.34782608695652,-0.0434782608695652,79,11,24,92,83,41,-4,0.1
1986,"Cardiff City",4,46,61,48,50,-2,1.32608695652174,1.04347826086957,1.08695652173913,-0.0434782608695652,81,13,24,92,70,93,11,0.6
1986,"Carlisle United",3,46,38,39,78,-39,0.826086956521739,0.847826086956522,1.69565217391304,-0.847826086956522,66,22,24,68,91,84,-25,-0.5
1986,"Charlton Athletic",1,42,44,45,55,-10,1.04761904761905,1.07142857142857,1.30952380952381,-0.238095238095238,19,19,22,22,16,92,3,-1.6
1986,"Chelsea",1,42,52,53,64,-11,1.23809523809524,1.26190476190476,1.52380952380952,-0.261904761904762,12,12,22,22,17,104,-5,0.6
1986,"Chester",3,46,56,61,59,2,1.21739130434783,1.32608695652174,1.28260869565217,0.0434782608695652,59,15,24,68,59,67,0,-1.5
1986,"Chesterfield",3,46,54,56,69,-13,1.17391304347826,1.21739130434783,1.5,-0.282608695652174,61,17,24,68,61,100,0,0.7
1986,"Colchester United",4,46,70,64,56,8,1.52173913043478,1.39130434782609,1.21739130434783,0.173913043478261,74,6,24,92,78,68,-4,1.2
1986,"Coventry City",1,42,63,50,45,5,1.5,1.19047619047619,1.07142857142857,0.119047619047619,9,9,22,22,9,94,0,-0.8
1986,"Crewe Alexandra",4,46,53,70,72,-2,1.15217391304348,1.52173913043478,1.56521739130435,-0.0434782608695652,84,16,24,92,85,96,-1,3.4
1986,"Crystal Palace",2,42,62,51,53,-2,1.47619047619048,1.21428571428571,1.26190476190476,-0.0476190476190476,28,6,22,44,27,93,1,0.2
1986,"Darlington",3,46,37,45,77,-32,0.804347826086957,0.978260869565217,1.67391304347826,-0.695652173913043,67,23,24,68,81,81,-14,-2
1986,"Derby County",2,42,84,64,38,26,2,1.52380952380952,0.904761904761905,0.619047619047619,23,1,22,44,15,121,8,1.3
1986,"Doncaster Rovers",3,46,57,56,62,-6,1.23913043478261,1.21739130434783,1.34782608695652,-0.130434782608696,56,12,24,68,67,88,-11,-3.1
1986,"Everton",1,42,86,76,31,45,2.04761904761905,1.80952380952381,0.738095238095238,1.07142857142857,1,1,22,22,4,121,-3,-1.3
1986,"Exeter City",4,46,56,53,49,4,1.21739130434783,1.15217391304348,1.06521739130435,0.0869565217391304,82,14,24,92,90,88,-8,-0.9
1986,"Fulham",3,46,53,59,77,-18,1.15217391304348,1.28260869565217,1.67391304347826,-0.391304347826087,62,18,24,68,53,102,9,-0.7
1986,"Gillingham",3,46,78,65,48,17,1.69565217391304,1.41304347826087,1.04347826086957,0.369565217391304,49,5,24,68,58,88,-9,-0.6
1986,"Grimsby Town",2,42,44,39,59,-20,1.04761904761905,0.928571428571429,1.4047619047619,-0.476190476190476,43,21,22,44,66,110,-23,0.1
1986,"Halifax Town",4,46,55,59,74,-15,1.19565217391304,1.28260869565217,1.60869565217391,-0.326086956521739,83,15,24,92,86,69,-3,-0.9
1986,"Hartlepool United",4,46,51,44,65,-21,1.10869565217391,0.956521739130435,1.41304347826087,-0.456521739130435,86,18,24,92,84,89,2,-0.2
1986,"Hereford United",4,46,53,60,61,-1,1.15217391304348,1.30434782608696,1.32608695652174,-0.0217391304347826,85,17,24,92,87,31,-2,-0.7
1986,"Huddersfield Town",2,42,51,54,61,-7,1.21428571428571,1.28571428571429,1.45238095238095,-0.166666666666667,37,15,22,44,44,99,-7,-0.2
1986,"Hull City",2,42,53,41,55,-14,1.26190476190476,0.976190476190476,1.30952380952381,-0.333333333333333,35,13,22,44,36,104,-1,-4.9
1986,"Ipswich Town",2,42,64,59,43,16,1.52380952380952,1.4047619047619,1.02380952380952,0.380952380952381,27,5,22,44,29,75,-2,0.3
1986,"Leeds United",2,42,68,58,44,14,1.61904761904762,1.38095238095238,1.04761904761905,0.333333333333333,26,4,22,44,28,93,-2,1.5
1986,"Leicester City",1,42,42,54,76,-22,1,1.28571428571429,1.80952380952381,-0.523809523809524,20,20,22,22,33,115,-13,1.1
1986,"Leyton Orient",4,46,69,64,61,3,1.5,1.39130434782609,1.32608695652174,0.0652173913043478,75,7,24,92,76,102,-1,-1
1986,"Lincoln City",4,46,48,45,65,-20,1.04347826086957,0.978260869565217,1.41304347826087,-0.434782608695652,91,23,24,92,78,107,13,2
1986,"Liverpool",1,42,77,72,42,30,1.83333333333333,1.71428571428571,1,0.714285714285714,2,2,22,22,1,116,1,-0.1
1986,"Luton Town",1,42,66,47,45,2,1.57142857142857,1.11904761904762,1.07142857142857,0.0476190476190476,6,6,22,22,10,91,-4,-4.1
1986,"Manchester City",1,42,39,36,57,-21,0.928571428571429,0.857142857142857,1.35714285714286,-0.5,21,21,22,22,30,117,-9,-1.3
1986,"Manchester United",1,42,56,52,45,7,1.33333333333333,1.23809523809524,1.07142857142857,0.166666666666667,11,11,22,22,2,117,9,1
1986,"Mansfield Town",3,46,61,52,55,-3,1.32608695652174,1.1304347826087,1.19565217391304,-0.0652173913043478,54,10,24,68,63,77,-9,-2.5
1986,"Middlesbrough",3,46,94,67,30,37,2.04347826086957,1.45652173913043,0.652173913043478,0.804347826086957,46,2,24,68,24,110,22,3.1
1986,"Millwall",2,42,51,39,45,-6,1.21428571428571,0.928571428571429,1.07142857142857,-0.142857142857143,38,16,22,44,22,93,16,-2
1986,"Newcastle United",1,42,47,47,65,-18,1.11904761904762,1.11904761904762,1.54761904761905,-0.428571428571429,17,17,22,22,8,116,9,1.3
1986,"Newport County",3,46,37,49,86,-37,0.804347826086957,1.06521739130435,1.8695652173913,-0.804347826086957,68,24,24,68,92,67,-24,NA
1986,"Northampton Town",4,46,99,103,53,50,2.15217391304348,2.23913043478261,1.15217391304348,1.08695652173913,69,1,24,92,50,93,19,-0.3
1986,"Norwich City",1,42,68,53,51,2,1.61904761904762,1.26190476190476,1.21428571428571,0.0476190476190476,5,5,22,22,14,93,-9,-2.8
1986,"Nottingham Forest",1,42,65,64,51,13,1.54761904761905,1.52380952380952,1.21428571428571,0.30952380952381,8,8,22,22,3,117,5,-1.2
1986,"Notts County",3,46,76,77,56,21,1.65217391304348,1.67391304347826,1.21739130434783,0.456521739130435,51,7,24,68,48,120,3,-1.6
1986,"Oldham Athletic",2,42,75,65,44,21,1.78571428571429,1.54761904761905,1.04761904761905,0.5,25,3,22,44,31,102,-6,-1.8
1986,"Oxford United",1,42,46,44,69,-25,1.0952380952381,1.04761904761905,1.64285714285714,-0.595238095238095,18,18,22,22,21,54,-3,-1.8
1986,"Peterborough United",4,46,65,57,50,7,1.41304347826087,1.23913043478261,1.08695652173913,0.152173913043478,77,9,24,92,74,60,3,1.2
1986,"Plymouth Argyle",2,42,61,62,57,5,1.45238095238095,1.47619047619048,1.35714285714286,0.119047619047619,29,7,22,44,37,93,-8,-3.4
1986,"Port Vale",3,46,57,76,70,6,1.23913043478261,1.65217391304348,1.52173913043478,0.130434782608696,57,13,24,68,55,107,2,2.9
1986,"Portsmouth",2,42,78,53,28,25,1.85714285714286,1.26190476190476,0.666666666666667,0.595238095238095,24,2,22,44,19,93,5,-0.3
1986,"Preston North End",4,46,90,72,47,25,1.95652173913043,1.56521739130435,1.02173913043478,0.543478260869565,70,2,24,92,60,121,10,1.1
1986,"Queens Park Rangers",1,42,50,48,64,-16,1.19047619047619,1.14285714285714,1.52380952380952,-0.380952380952381,16,16,22,22,5,93,11,-1.4
1986,"Reading",2,42,53,52,59,-7,1.26190476190476,1.23809523809524,1.4047619047619,-0.166666666666667,36,14,22,44,43,93,-7,-0.1
1986,"Rochdale",4,46,50,54,73,-19,1.08695652173913,1.17391304347826,1.58695652173913,-0.41304347826087,88,20,24,92,89,92,-1,0.5
1986,"Rotherham United",3,46,57,48,57,-9,1.23913043478261,1.04347826086957,1.23913043478261,-0.195652173913043,58,14,24,68,65,88,-7,-1
1986,"Scunthorpe United",4,46,66,73,57,16,1.43478260869565,1.58695652173913,1.23913043478261,0.347826086956522,76,8,24,92,72,70,4,-0.5
1986,"Sheffield United",2,42,58,50,49,1,1.38095238095238,1.19047619047619,1.16666666666667,0.0238095238095238,30,8,22,44,42,117,-12,0.5
1986,"Sheffield Wednesday",1,42,52,58,59,-1,1.23809523809524,1.38095238095238,1.4047619047619,-0.0238095238095238,13,13,22,22,11,117,2,0.6
1986,"Shrewsbury Town",2,42,51,41,53,-12,1.21428571428571,0.976190476190476,1.26190476190476,-0.285714285714286,39,17,22,44,39,69,0,-2.7
1986,"Southampton",1,42,52,69,68,1,1.23809523809524,1.64285714285714,1.61904761904762,0.0238095238095238,14,14,22,22,12,93,2,-0.4
1986,"Southend United",4,46,80,68,55,13,1.73913043478261,1.47826086956522,1.19565217391304,0.282608695652174,71,3,24,92,62,93,9,2.7
1986,"Stockport County",4,46,51,40,69,-29,1.10869565217391,0.869565217391304,1.5,-0.630434782608696,87,19,24,92,88,99,-1,4.1
1986,"Stoke City",2,42,58,63,53,10,1.38095238095238,1.5,1.26190476190476,0.238095238095238,31,9,22,44,32,113,-1,-0.1
1986,"Sunderland",2,42,48,49,59,-10,1.14285714285714,1.16666666666667,1.4047619047619,-0.238095238095238,42,20,22,44,45,119,-3,2.3
1986,"Swansea City",4,46,62,56,61,-5,1.34782608695652,1.21739130434783,1.32608695652174,-0.108695652173913,80,12,24,92,75,93,5,0.7
1986,"Swindon Town",3,46,87,77,47,30,1.89130434782609,1.67391304347826,1.02173913043478,0.652173913043478,47,3,24,68,34,93,13,0.7
1986,"Torquay United",4,46,48,56,72,-16,1.04347826086957,1.21739130434783,1.56521739130435,-0.347826086956522,92,24,24,92,73,78,19,0.3
1986,"Tottenham Hotspur",1,42,71,68,43,25,1.69047619047619,1.61904761904762,1.02380952380952,0.595238095238095,3,3,22,22,13,101,-10,-0.9
1986,"Tranmere Rovers",4,46,50,54,72,-18,1.08695652173913,1.17391304347826,1.56521739130435,-0.391304347826087,89,21,24,92,79,89,10,5.8
1986,"Walsall",3,46,75,80,67,13,1.6304347826087,1.73913043478261,1.45652173913043,0.282608695652174,52,8,24,68,47,100,5,-0.4
1986,"Watford",1,42,63,67,54,13,1.5,1.5952380952381,1.28571428571429,0.30952380952381,10,10,22,22,20,93,-10,-4.7
1986,"West Bromwich Albion",2,42,51,51,49,2,1.21428571428571,1.21428571428571,1.16666666666667,0.0476190476190476,40,18,22,44,41,121,-1,0.2
1986,"West Ham United",1,42,52,52,67,-15,1.23809523809524,1.23809523809524,1.5952380952381,-0.357142857142857,15,15,22,22,18,94,-3,-0.1
1986,"Wigan Athletic",3,46,85,83,60,23,1.84782608695652,1.80434782608696,1.30434782608696,0.5,48,4,24,68,51,42,-3,-2.2
1986,"Wimbledon",1,42,66,57,50,7,1.57142857142857,1.35714285714286,1.19047619047619,0.166666666666667,7,7,22,22,7,27,0,-0.1
1986,"Wolverhampton Wanderers",4,46,79,69,50,19,1.71739130434783,1.5,1.08695652173913,0.41304347826087,72,4,24,92,69,121,3,4.9
1986,"Wrexham",4,46,65,70,51,19,1.41304347826087,1.52173913043478,1.10869565217391,0.41304347826087,78,10,24,92,80,80,-2,2.6
1986,"York City",3,46,49,55,79,-24,1.06521739130435,1.19565217391304,1.71739130434783,-0.521739130434783,64,20,24,68,68,72,-4,0
1987,"AFC Bournemouth",2,44,49,56,68,-12,1.11363636363636,1.27272727272727,1.54545454545455,-0.272727272727273,38,17,23,44,32,90,6,-1.5
1987,"Aldershot",3,46,53,64,74,-10,1.15217391304348,1.39130434782609,1.60869565217391,-0.217391304347826,64,20,24,68,68,57,-4,NA
1987,"Arsenal",1,40,66,58,39,19,1.65,1.45,0.975,0.475,6,6,21,21,1,116,5,0.5
1987,"Aston Villa",2,44,78,68,41,27,1.77272727272727,1.54545454545455,0.931818181818182,0.613636363636364,23,2,23,44,17,121,6,1.6
1987,"Barnsley",2,44,57,61,62,-1,1.29545454545455,1.38636363636364,1.40909090909091,-0.0227272727272727,35,14,23,44,27,111,8,1.6
1987,"Birmingham City",2,44,48,41,66,-25,1.09090909090909,0.931818181818182,1.5,-0.568181818181818,40,19,23,44,43,117,-3,1.4
1987,"Blackburn Rovers",2,44,77,68,52,16,1.75,1.54545454545455,1.18181818181818,0.363636363636364,25,4,23,44,25,121,0,1.9
1987,"Blackpool",3,46,65,71,62,9,1.41304347826087,1.54347826086957,1.34782608695652,0.195652173913043,54,10,24,68,63,112,-9,-0.1
1987,"Bolton Wanderers",4,46,78,66,42,24,1.69565217391304,1.43478260869565,0.91304347826087,0.521739130434783,71,3,24,92,54,121,17,5.4
1987,"Bradford City",2,44,77,74,54,20,1.75,1.68181818181818,1.22727272727273,0.454545454545455,26,5,23,44,34,106,-8,-0.7
1987,"Brentford",3,46,62,53,59,-6,1.34782608695652,1.15217391304348,1.28260869565217,-0.130434782608696,56,12,24,68,51,93,5,-0.9
1987,"Brighton & Hove Albion",3,46,84,69,47,22,1.82608695652174,1.5,1.02173913043478,0.478260869565217,46,2,24,68,39,93,7,-4.5
1987,"Bristol City",3,46,75,77,62,15,1.6304347826087,1.67391304347826,1.34782608695652,0.326086956521739,49,5,24,68,55,108,-6,0.3
1987,"Bristol Rovers",3,46,66,68,56,12,1.43478260869565,1.47826086956522,1.21739130434783,0.260869565217391,52,8,24,68,49,92,3,0.3
1987,"Burnley",4,46,67,57,62,-5,1.45652173913043,1.23913043478261,1.34782608695652,-0.108695652173913,77,9,24,92,84,121,-7,1.3
1987,"Bury",3,46,59,58,57,1,1.28260869565217,1.26086956521739,1.23913043478261,0.0217391304347826,57,13,24,68,56,114,1,2
1987,"Cambridge United",4,46,61,50,52,-2,1.32608695652174,1.08695652173913,1.1304347826087,-0.0434782608695652,83,15,24,92,76,41,7,0
1987,"Cardiff City",4,46,85,66,41,25,1.84782608695652,1.43478260869565,0.891304347826087,0.543478260869565,70,2,24,92,60,93,10,-1.8
1987,"Carlisle United",4,46,44,57,86,-29,0.956521739130435,1.23913043478261,1.8695652173913,-0.630434782608696,91,23,24,92,80,84,11,2.4
1987,"Charlton Athletic",1,40,42,38,52,-14,1.05,0.95,1.3,-0.35,16,16,21,21,14,92,2,-0.8
1987,"Chelsea",1,40,42,50,68,-18,1.05,1.25,1.7,-0.45,17,17,21,21,21,104,-4,1.3
1987,"Chester",3,46,58,51,62,-11,1.26086956521739,1.10869565217391,1.34782608695652,-0.239130434782609,59,15,24,68,52,67,7,-2.2
1987,"Chesterfield",3,46,55,41,70,-29,1.19565217391304,0.891304347826087,1.52173913043478,-0.630434782608696,61,17,24,68,66,100,-5,0.7
1987,"Colchester United",4,46,67,47,51,-4,1.45652173913043,1.02173913043478,1.10869565217391,-0.0869565217391304,78,10,24,92,89,68,-11,1.6
1987,"Coventry City",1,40,53,46,53,-7,1.325,1.15,1.325,-0.175,9,9,21,21,7,94,2,-0.2
1987,"Crewe Alexandra",4,46,58,57,53,4,1.26086956521739,1.23913043478261,1.15217391304348,0.0869565217391304,85,17,24,92,71,96,14,5.4
1987,"Crystal Palace",2,44,75,86,59,27,1.70454545454545,1.95454545454545,1.34090909090909,0.613636363636364,27,6,23,44,23,93,4,0.7
1987,"Darlington",4,46,65,71,69,2,1.41304347826087,1.54347826086957,1.5,0.0434782608695652,81,13,24,92,92,81,-11,0.2
1987,"Derby County",1,40,43,35,45,-10,1.075,0.875,1.125,-0.25,15,15,21,21,5,121,10,0.6
1987,"Doncaster Rovers",3,46,33,40,84,-44,0.717391304347826,0.869565217391304,1.82608695652174,-0.956521739130435,67,23,24,68,91,88,-24,-2.5
1987,"Everton",1,40,70,53,27,26,1.75,1.325,0.675,0.65,4,4,21,21,8,121,-4,-1.4
1987,"Exeter City",4,46,46,53,68,-15,1,1.15217391304348,1.47826086956522,-0.326086956521739,90,22,24,92,81,88,9,0.6
1987,"Fulham",3,46,66,69,60,9,1.43478260869565,1.5,1.30434782608696,0.195652173913043,53,9,24,68,48,102,5,0.3
1987,"Gillingham",3,46,59,77,61,16,1.28260869565217,1.67391304347826,1.32608695652174,0.347826086956522,58,14,24,68,67,88,-9,0.7
1987,"Grimsby Town",3,46,50,48,58,-10,1.08695652173913,1.04347826086957,1.26086956521739,-0.217391304347826,66,22,24,68,77,110,-11,1.9
1987,"Halifax Town",4,46,56,54,59,-5,1.21739130434783,1.17391304347826,1.28260869565217,-0.108695652173913,86,18,24,92,90,69,-4,NA
1987,"Hartlepool United",4,46,59,50,57,-7,1.28260869565217,1.08695652173913,1.23913043478261,-0.152173913043478,84,16,24,92,87,89,-3,-0.1
1987,"Hereford United",4,46,54,41,59,-18,1.17391304347826,0.891304347826087,1.28260869565217,-0.391304347826087,87,19,24,92,83,31,4,0.3
1987,"Huddersfield Town",2,44,28,41,100,-59,0.636363636363636,0.931818181818182,2.27272727272727,-1.34090909090909,44,23,23,44,58,99,-14,0.8
1987,"Hull City",2,44,57,54,60,-6,1.29545454545455,1.22727272727273,1.36363636363636,-0.136363636363636,36,15,23,44,41,104,-5,-5.4
1987,"Ipswich Town",2,44,66,61,52,9,1.5,1.38636363636364,1.18181818181818,0.204545454545455,29,8,23,44,28,75,1,0.4
1987,"Leeds United",2,44,69,61,51,10,1.56818181818182,1.38636363636364,1.15909090909091,0.227272727272727,28,7,23,44,30,93,-2,2.3
1987,"Leicester City",2,44,59,62,61,1,1.34090909090909,1.40909090909091,1.38636363636364,0.0227272727272727,33,12,23,44,35,115,-2,2.3
1987,"Leyton Orient",4,46,69,85,63,22,1.5,1.84782608695652,1.3695652173913,0.478260869565217,76,8,24,92,74,102,2,0
1987,"Liverpool",1,40,90,87,24,63,2.25,2.175,0.6,1.575,1,1,21,21,2,116,-1,-0.2
1987,"Luton Town",1,40,53,57,58,-1,1.325,1.425,1.45,-0.025,10,10,21,21,16,91,-6,-5.1
1987,"Manchester City",2,44,65,80,60,20,1.47727272727273,1.81818181818182,1.36363636363636,0.454545454545455,30,9,23,44,22,117,8,-1.2
1987,"Manchester United",1,40,81,71,38,33,2.025,1.775,0.95,0.825,2,2,21,21,11,117,-9,0
1987,"Mansfield Town",3,46,54,48,59,-11,1.17391304347826,1.04347826086957,1.28260869565217,-0.239130434782609,63,19,24,68,59,77,4,-1.7
1987,"Middlesbrough",2,44,78,63,36,27,1.77272727272727,1.43181818181818,0.818181818181818,0.613636363636364,24,3,23,44,18,110,6,0.2
1987,"Millwall",2,44,82,72,52,20,1.86363636363636,1.63636363636364,1.18181818181818,0.454545454545455,22,1,23,44,9,93,13,-4
1987,"Newcastle United",1,40,56,55,53,2,1.4,1.375,1.325,0.05,8,8,21,21,20,116,-12,-0.5
1987,"Newport County",4,46,25,35,105,-70,0.543478260869565,0.760869565217391,2.28260869565217,-1.52173913043478,92,24,24,92,82,67,10,NA
1987,"Northampton Town",3,46,73,70,51,19,1.58695652173913,1.52173913043478,1.10869565217391,0.41304347826087,50,6,24,68,64,93,-14,0.2
1987,"Norwich City",1,40,45,40,52,-12,1.125,1,1.3,-0.3,14,14,21,21,4,93,10,-2.1
1987,"Nottingham Forest",1,40,73,67,39,28,1.825,1.675,0.975,0.7,3,3,21,21,3,117,0,-1.8
1987,"Notts County",3,46,81,82,49,33,1.76086956521739,1.78260869565217,1.06521739130435,0.717391304347826,48,4,24,68,53,120,-5,-2.1
1987,"Oldham Athletic",2,44,65,72,64,8,1.47727272727273,1.63636363636364,1.45454545454545,0.181818181818182,31,10,23,44,36,102,-5,-2.6
1987,"Oxford United",1,40,31,44,80,-36,0.775,1.1,2,-0.9,21,21,21,21,37,54,-16,-1.1
1987,"Peterborough United",4,46,70,52,53,-1,1.52173913043478,1.1304347826087,1.15217391304348,-0.0217391304347826,74,6,24,92,85,60,-11,-0.4
1987,"Plymouth Argyle",2,44,56,65,67,-2,1.27272727272727,1.47727272727273,1.52272727272727,-0.0454545454545455,37,16,23,44,38,93,-1,-2.9
1987,"Port Vale",3,46,65,58,56,2,1.41304347826087,1.26086956521739,1.21739130434783,0.0434782608695652,55,11,24,68,46,107,9,1.6
1987,"Portsmouth",1,40,35,36,66,-30,0.875,0.9,1.65,-0.75,19,19,21,21,40,93,-21,-2.1
1987,"Preston North End",3,46,58,48,59,-11,1.26086956521739,1.04347826086957,1.28260869565217,-0.239130434782609,60,16,24,68,50,121,10,0.1
1987,"Queens Park Rangers",1,40,67,48,38,10,1.675,1.2,0.95,0.25,5,5,21,21,10,93,-5,-3.6
1987,"Reading",2,44,42,44,70,-26,0.954545454545455,1,1.59090909090909,-0.590909090909091,43,22,23,44,61,93,-18,-0.1
1987,"Rochdale",4,46,48,47,76,-29,1.04347826086957,1.02173913043478,1.65217391304348,-0.630434782608696,89,21,24,92,86,92,3,0.3
1987,"Rotherham United",3,46,52,50,66,-16,1.1304347826087,1.08695652173913,1.43478260869565,-0.347826086956522,65,21,24,68,69,88,-4,-1.4
1987,"Scarborough",4,46,65,56,48,8,1.41304347826087,1.21739130434783,1.04347826086957,0.173913043478261,82,14,24,92,72,12,10,0.8
1987,"Scunthorpe United",4,46,77,76,51,25,1.67391304347826,1.65217391304348,1.10869565217391,0.543478260869565,72,4,24,92,73,70,-1,-0.5
1987,"Sheffield United",2,44,46,45,74,-29,1.04545454545455,1.02272727272727,1.68181818181818,-0.659090909090909,42,21,23,44,47,117,-5,1.5
1987,"Sheffield Wednesday",1,40,53,52,66,-14,1.325,1.3,1.65,-0.35,11,11,21,21,15,117,-4,-0.3
1987,"Shrewsbury Town",2,44,49,42,54,-12,1.11363636363636,0.954545454545455,1.22727272727273,-0.272727272727273,39,18,23,44,42,69,-3,-4.3
1987,"Southampton",1,40,50,49,53,-4,1.25,1.225,1.325,-0.1,12,12,21,21,13,93,-1,0
1987,"Southend United",3,46,55,65,83,-18,1.19565217391304,1.41304347826087,1.80434782608696,-0.391304347826087,62,18,24,68,65,93,-3,-0.6
1987,"Stockport County",4,46,51,44,58,-14,1.10869565217391,0.956521739130435,1.26086956521739,-0.304347826086957,88,20,24,92,88,99,0,6
1987,"Stoke City",2,44,62,50,57,-7,1.40909090909091,1.13636363636364,1.29545454545455,-0.159090909090909,32,11,23,44,33,113,-1,-1.1
1987,"Sunderland",3,46,93,92,48,44,2.02173913043478,2,1.04347826086957,0.956521739130435,45,1,24,68,31,119,14,2.2
1987,"Swansea City",4,46,70,62,56,6,1.52173913043478,1.34782608695652,1.21739130434783,0.130434782608696,75,7,24,92,57,93,18,-1.4
1987,"Swindon Town",2,44,59,73,60,13,1.34090909090909,1.65909090909091,1.36363636363636,0.295454545454545,34,13,23,44,26,93,8,-0.4
1987,"Torquay United",4,46,77,66,41,25,1.67391304347826,1.43478260869565,0.891304347826087,0.543478260869565,73,5,24,92,82,78,-9,0
1987,"Tottenham Hotspur",1,40,47,38,48,-10,1.175,0.95,1.2,-0.25,13,13,21,21,6,101,7,-0.2
1987,"Tranmere Rovers",4,46,66,61,53,8,1.43478260869565,1.32608695652174,1.15217391304348,0.173913043478261,79,11,24,92,70,89,9,4.5
1987,"Walsall",3,46,82,68,50,18,1.78260869565217,1.47826086956522,1.08695652173913,0.391304347826087,47,3,24,68,44,100,3,-1.6
1987,"Watford",1,40,32,27,51,-24,0.8,0.675,1.275,-0.6,20,20,21,21,24,93,-4,-2.5
1987,"West Bromwich Albion",2,44,47,50,69,-19,1.06818181818182,1.13636363636364,1.56818181818182,-0.431818181818182,41,20,23,44,29,121,12,1.1
1987,"West Ham United",1,40,42,40,52,-12,1.05,1,1.3,-0.3,18,18,21,21,19,94,-1,1
1987,"Wigan Athletic",3,46,72,70,61,9,1.56521739130435,1.52173913043478,1.32608695652174,0.195652173913043,51,7,24,68,62,42,-11,-0.5
1987,"Wimbledon",1,40,57,58,47,11,1.425,1.45,1.175,0.275,7,7,21,21,12,27,-5,-0.9
1987,"Wolverhampton Wanderers",4,46,90,82,43,39,1.95652173913043,1.78260869565217,0.934782608695652,0.847826086956522,69,1,24,92,45,121,24,4
1987,"Wrexham",4,46,66,69,58,11,1.43478260869565,1.5,1.26086956521739,0.239130434782609,80,12,24,92,75,80,5,2.8
1987,"York City",3,46,33,48,91,-43,0.717391304347826,1.04347826086957,1.97826086956522,-0.934782608695652,68,24,24,68,79,72,-11,0.8
1988,"AFC Bournemouth",2,46,62,53,62,-9,1.34782608695652,1.15217391304348,1.34782608695652,-0.195652173913043,32,12,24,44,42,90,-10,-1.8
1988,"Aldershot",3,46,37,48,78,-30,0.804347826086957,1.04347826086957,1.69565217391304,-0.652173913043478,68,24,24,68,90,57,-22,NA
1988,"Arsenal",1,38,76,73,36,37,2,1.92105263157895,0.947368421052632,0.973684210526316,1,1,20,20,4,116,-3,-0.1
1988,"Aston Villa",1,38,40,45,56,-11,1.05263157894737,1.18421052631579,1.47368421052632,-0.289473684210526,17,17,20,20,2,121,15,1.1
1988,"Barnsley",2,46,74,66,58,8,1.60869565217391,1.43478260869565,1.26086956521739,0.173913043478261,27,7,24,44,37,111,-10,-0.5
1988,"Birmingham City",2,46,35,31,76,-45,0.760869565217391,0.673913043478261,1.65217391304348,-0.978260869565217,43,23,24,44,51,117,-8,1.9
1988,"Blackburn Rovers",2,46,77,74,59,15,1.67391304347826,1.60869565217391,1.28260869565217,0.326086956521739,25,5,24,44,24,121,1,0.6
1988,"Blackpool",3,46,55,56,59,-3,1.19565217391304,1.21739130434783,1.28260869565217,-0.0652173913043478,63,19,24,68,67,112,-4,0.6
1988,"Bolton Wanderers",3,46,64,58,54,4,1.39130434782609,1.26086956521739,1.17391304347826,0.0869565217391304,54,10,24,68,50,121,4,2.8
1988,"Bradford City",2,46,56,52,59,-7,1.21739130434783,1.1304347826087,1.28260869565217,-0.152173913043478,34,14,24,44,43,106,-9,1.2
1988,"Brentford",3,46,68,66,61,5,1.47826086956522,1.43478260869565,1.32608695652174,0.108695652173913,51,7,24,68,57,93,-6,-1.8
1988,"Brighton & Hove Albion",2,46,51,57,66,-9,1.10869565217391,1.23913043478261,1.43478260869565,-0.195652173913043,39,19,24,44,38,93,1,-4.6
1988,"Bristol City",3,46,63,53,55,-2,1.3695652173913,1.15217391304348,1.19565217391304,-0.0434782608695652,55,11,24,68,46,108,9,1.1
1988,"Bristol Rovers",3,46,74,67,51,16,1.60869565217391,1.45652173913043,1.10869565217391,0.347826086956522,49,5,24,68,45,92,4,-0.9
1988,"Burnley",4,46,55,52,61,-9,1.19565217391304,1.1304347826087,1.32608695652174,-0.195652173913043,84,16,24,92,84,121,0,2.5
1988,"Bury",3,46,61,55,67,-12,1.32608695652174,1.19565217391304,1.45652173913043,-0.260869565217391,56,12,24,68,49,114,7,1.7
1988,"Cambridge United",4,46,68,71,62,9,1.47826086956522,1.54347826086957,1.34782608695652,0.195652173913043,76,8,24,92,73,41,3,0.6
1988,"Cardiff City",3,46,57,44,56,-12,1.23913043478261,0.956521739130435,1.21739130434783,-0.260869565217391,60,16,24,68,65,93,-5,-1.1
1988,"Carlisle United",4,46,60,53,52,1,1.30434782608696,1.15217391304348,1.1304347826087,0.0217391304347826,80,12,24,92,75,84,5,-1.1
1988,"Charlton Athletic",1,38,42,44,58,-14,1.10526315789474,1.15789473684211,1.52631578947368,-0.368421052631579,14,14,20,20,19,92,-5,-0.4
1988,"Chelsea",2,46,99,96,50,46,2.15217391304348,2.08695652173913,1.08695652173913,1,21,1,24,44,5,104,16,1.8
1988,"Chester",3,46,68,64,61,3,1.47826086956522,1.39130434782609,1.32608695652174,0.0652173913043478,52,8,24,68,60,67,-8,-3
1988,"Chesterfield",3,46,49,51,86,-35,1.06521739130435,1.10869565217391,1.8695652173913,-0.760869565217391,66,22,24,68,76,100,-10,1.3
1988,"Colchester United",4,46,50,60,78,-18,1.08695652173913,1.30434782608696,1.69565217391304,-0.391304347826087,89,21,24,92,92,68,-3,2.8
1988,"Coventry City",1,38,55,47,42,5,1.44736842105263,1.23684210526316,1.10526315789474,0.131578947368421,7,7,20,20,12,94,-5,-0.8
1988,"Crewe Alexandra",4,46,78,67,48,19,1.69565217391304,1.45652173913043,1.04347826086957,0.41304347826087,71,3,24,92,56,96,15,3.3
1988,"Crystal Palace",2,46,81,71,49,22,1.76086956521739,1.54347826086957,1.06521739130435,0.478260869565217,23,3,24,44,13,93,10,-1.1
1988,"Darlington",4,46,42,53,76,-23,0.91304347826087,1.15217391304348,1.65217391304348,-0.5,92,24,24,92,69,81,23,2
1988,"Derby County",1,38,58,40,38,2,1.52631578947368,1.05263157894737,1,0.0526315789473684,5,5,20,20,16,121,-11,-0.3
1988,"Doncaster Rovers",4,46,49,49,78,-29,1.06521739130435,1.06521739130435,1.69565217391304,-0.630434782608696,91,23,24,92,88,88,3,2.2
1988,"Everton",1,38,54,50,45,5,1.42105263157895,1.31578947368421,1.18421052631579,0.131578947368421,8,8,20,20,6,121,2,-0.6
1988,"Exeter City",4,46,60,65,68,-3,1.30434782608696,1.41304347826087,1.47826086956522,-0.0652173913043478,81,13,24,92,69,88,12,0.1
1988,"Fulham",3,46,75,69,67,2,1.6304347826087,1.5,1.45652173913043,0.0434782608695652,48,4,24,68,64,102,-16,0.3
1988,"Gillingham",3,46,40,47,81,-34,0.869565217391304,1.02173913043478,1.76086956521739,-0.739130434782609,67,23,24,68,82,88,-15,1.9
1988,"Grimsby Town",4,46,66,65,59,6,1.43478260869565,1.41304347826087,1.28260869565217,0.130434782608696,77,9,24,92,70,110,7,4.7
1988,"Halifax Town",4,46,50,69,75,-6,1.08695652173913,1.5,1.6304347826087,-0.130434782608696,90,22,24,92,91,69,-1,NA
1988,"Hartlepool United",4,46,52,50,78,-28,1.1304347826087,1.08695652173913,1.69565217391304,-0.608695652173913,87,19,24,92,85,89,2,-0.3
1988,"Hereford United",4,46,58,66,72,-6,1.26086956521739,1.43478260869565,1.56521739130435,-0.130434782608696,83,15,24,92,86,31,-3,1.2
1988,"Huddersfield Town",3,46,60,63,73,-10,1.30434782608696,1.3695652173913,1.58695652173913,-0.217391304347826,58,14,24,68,52,99,6,2.7
1988,"Hull City",2,46,47,52,68,-16,1.02173913043478,1.1304347826087,1.47826086956522,-0.347826086956522,41,21,24,44,34,104,7,-4.7
1988,"Ipswich Town",2,46,73,71,61,10,1.58695652173913,1.54347826086957,1.32608695652174,0.217391304347826,28,8,24,44,29,75,-1,0.5
1988,"Leeds United",2,46,67,59,50,9,1.45652173913043,1.28260869565217,1.08695652173913,0.195652173913043,30,10,24,44,21,93,9,2.6
1988,"Leicester City",2,46,55,56,63,-7,1.19565217391304,1.21739130434783,1.3695652173913,-0.152173913043478,35,15,24,44,33,115,2,2.5
1988,"Leyton Orient",4,46,75,86,50,36,1.6304347826087,1.8695652173913,1.08695652173913,0.782608695652174,74,6,24,92,58,102,16,0
1988,"Lincoln City",4,46,64,64,60,4,1.39130434782609,1.39130434782609,1.30434782608696,0.0869565217391304,78,10,24,92,77,107,1,1.1
1988,"Liverpool",1,38,76,65,28,37,2,1.71052631578947,0.736842105263158,0.973684210526316,2,2,20,20,1,116,1,-0.5
1988,"Luton Town",1,38,41,42,52,-10,1.07894736842105,1.10526315789474,1.36842105263158,-0.263157894736842,16,16,20,20,17,91,-1,-4
1988,"Manchester City",2,46,82,77,53,24,1.78260869565217,1.67391304347826,1.15217391304348,0.521739130434783,22,2,24,44,14,117,8,-2.5
1988,"Manchester United",1,38,51,45,35,10,1.34210526315789,1.18421052631579,0.921052631578947,0.263157894736842,11,11,20,20,15,117,-4,1
1988,"Mansfield Town",3,46,59,48,52,-4,1.28260869565217,1.04347826086957,1.1304347826087,-0.0869565217391304,59,15,24,68,59,77,0,-1.7
1988,"Middlesbrough",1,38,39,44,61,-17,1.02631578947368,1.15789473684211,1.60526315789474,-0.447368421052632,18,18,20,20,41,110,-23,0.9
1988,"Millwall",1,38,53,47,52,-5,1.39473684210526,1.23684210526316,1.36842105263158,-0.131578947368421,9,9,20,20,20,93,-11,-4.5
1988,"Newcastle United",1,38,31,32,63,-31,0.815789473684211,0.842105263157895,1.65789473684211,-0.815789473684211,20,20,20,20,23,116,-3,0.8
1988,"Northampton Town",3,46,54,66,76,-10,1.17391304347826,1.43478260869565,1.65217391304348,-0.217391304347826,64,20,24,68,66,93,-2,-0.2
1988,"Norwich City",1,38,62,48,45,3,1.63157894736842,1.26315789473684,1.18421052631579,0.0789473684210526,4,4,20,20,10,93,-6,-2.5
1988,"Nottingham Forest",1,38,64,64,43,21,1.68421052631579,1.68421052631579,1.13157894736842,0.552631578947368,3,3,20,20,9,117,-6,-1.7
1988,"Notts County",3,46,67,64,54,10,1.45652173913043,1.39130434782609,1.17391304347826,0.217391304347826,53,9,24,68,47,120,6,-0.7
1988,"Oldham Athletic",2,46,54,75,72,3,1.17391304347826,1.6304347826087,1.56521739130435,0.0652173913043478,36,16,24,44,28,102,8,-2.7
1988,"Oxford United",2,46,54,62,70,-8,1.17391304347826,1.34782608695652,1.52173913043478,-0.173913043478261,37,17,24,44,39,54,-2,-0.6
1988,"Peterborough United",4,46,54,52,74,-22,1.17391304347826,1.1304347826087,1.60869565217391,-0.478260869565217,85,17,24,92,78,60,7,0.7
1988,"Plymouth Argyle",2,46,54,55,66,-11,1.17391304347826,1.19565217391304,1.43478260869565,-0.239130434782609,38,18,24,44,36,93,2,-4.3
1988,"Port Vale",3,46,84,78,48,30,1.82608695652174,1.69565217391304,1.04347826086957,0.652173913043478,46,2,24,68,31,107,15,0.6
1988,"Portsmouth",2,46,51,53,62,-9,1.10869565217391,1.15217391304348,1.34782608695652,-0.195652173913043,40,20,24,44,32,93,8,-0.1
1988,"Preston North End",3,46,72,79,60,19,1.56521739130435,1.71739130434783,1.30434782608696,0.41304347826087,50,6,24,68,63,121,-13,0.1
1988,"Queens Park Rangers",1,38,53,43,37,6,1.39473684210526,1.13157894736842,0.973684210526316,0.157894736842105,10,10,20,20,11,93,-1,-3.2
1988,"Reading",3,46,56,68,72,-4,1.21739130434783,1.47826086956522,1.56521739130435,-0.0869565217391304,61,17,24,68,53,93,8,0.6
1988,"Rochdale",4,46,53,56,82,-26,1.15217391304348,1.21739130434783,1.78260869565217,-0.565217391304348,86,18,24,92,79,92,7,0
1988,"Rotherham United",4,46,82,76,35,41,1.78260869565217,1.65217391304348,0.760869565217391,0.891304347826087,69,1,24,92,54,88,15,-0.4
1988,"Scarborough",4,46,77,67,52,15,1.67391304347826,1.45652173913043,1.1304347826087,0.326086956521739,72,4,24,92,87,12,-15,-2
1988,"Scunthorpe United",4,46,77,77,57,20,1.67391304347826,1.67391304347826,1.23913043478261,0.434782608695652,73,5,24,92,80,70,-7,0.1
1988,"Sheffield United",3,46,84,93,54,39,1.82608695652174,2.02173913043478,1.17391304347826,0.847826086956522,47,3,24,68,22,117,25,1.9
1988,"Sheffield Wednesday",1,38,42,34,51,-17,1.10526315789474,0.894736842105263,1.34210526315789,-0.447368421052632,15,15,20,20,18,117,-3,0.2
1988,"Shrewsbury Town",2,46,42,40,67,-27,0.91304347826087,0.869565217391304,1.45652173913043,-0.58695652173913,42,22,24,44,55,69,-13,-4.1
1988,"Southampton",1,38,45,52,66,-14,1.18421052631579,1.36842105263158,1.73684210526316,-0.368421052631579,13,13,20,20,7,93,6,-0.4
1988,"Southend United",3,46,54,56,75,-19,1.17391304347826,1.21739130434783,1.6304347826087,-0.41304347826087,65,21,24,68,71,93,-6,-2.2
1988,"Stockport County",4,46,51,54,52,2,1.10869565217391,1.17391304347826,1.1304347826087,0.0434782608695652,88,20,24,92,72,99,16,5.2
1988,"Stoke City",2,46,59,57,72,-15,1.28260869565217,1.23913043478261,1.56521739130435,-0.326086956521739,33,13,24,44,44,113,-11,-1.9
1988,"Sunderland",2,46,63,60,60,0,1.3695652173913,1.30434782608696,1.30434782608696,0,31,11,24,44,25,119,6,1
1988,"Swansea City",3,46,61,51,53,-2,1.32608695652174,1.10869565217391,1.15217391304348,-0.0434782608695652,57,13,24,68,61,93,-4,-1.8
1988,"Swindon Town",2,46,76,68,53,15,1.65217391304348,1.47826086956522,1.15217391304348,0.326086956521739,26,6,24,44,26,93,0,-1.1
1988,"Torquay United",4,46,59,45,60,-15,1.28260869565217,0.978260869565217,1.30434782608696,-0.326086956521739,82,14,24,92,83,78,-1,-0.7
1988,"Tottenham Hotspur",1,38,57,60,46,14,1.5,1.57894736842105,1.21052631578947,0.368421052631579,6,6,20,20,3,101,3,-0.5
1988,"Tranmere Rovers",4,46,80,62,43,19,1.73913043478261,1.34782608695652,0.934782608695652,0.41304347826087,70,2,24,92,48,89,22,3.5
1988,"Walsall",2,46,31,41,80,-39,0.673913043478261,0.891304347826087,1.73913043478261,-0.847826086956522,44,24,24,44,68,100,-24,-0.2
1988,"Watford",2,46,78,74,48,26,1.69565217391304,1.60869565217391,1.04347826086957,0.565217391304348,24,4,24,44,35,93,-11,-0.1
1988,"West Bromwich Albion",2,46,72,65,41,24,1.56521739130435,1.41304347826087,0.891304347826087,0.521739130434783,29,9,24,44,40,121,-11,-0.4
1988,"West Ham United",1,38,38,37,62,-25,1,0.973684210526316,1.63157894736842,-0.657894736842105,19,19,20,20,27,94,-8,1.4
1988,"Wigan Athletic",3,46,56,55,53,2,1.21739130434783,1.19565217391304,1.15217391304348,0.0434782608695652,62,18,24,68,62,42,0,1.1
1988,"Wimbledon",1,38,51,50,46,4,1.34210526315789,1.31578947368421,1.21052631578947,0.105263157894737,12,12,20,20,8,27,4,-0.4
1988,"Wolverhampton Wanderers",3,46,92,96,49,47,2,2.08695652173913,1.06521739130435,1.02173913043478,45,1,24,68,30,121,15,1.8
1988,"Wrexham",4,46,71,77,63,14,1.54347826086957,1.67391304347826,1.3695652173913,0.304347826086957,75,7,24,92,89,80,-14,1.4
1988,"York City",4,46,64,62,63,-1,1.39130434782609,1.34782608695652,1.3695652173913,-0.0217391304347826,79,11,24,92,81,72,-2,1.4
1989,"AFC Bournemouth",2,46,48,57,76,-19,1.04347826086957,1.23913043478261,1.65217391304348,-0.41304347826087,42,22,24,44,52,90,-10,-1.7
1989,"Aldershot",4,46,50,49,69,-20,1.08695652173913,1.06521739130435,1.5,-0.434782608695652,90,22,24,92,91,57,-1,NA
1989,"Arsenal",1,38,62,54,38,16,1.63157894736842,1.42105263157895,1,0.421052631578947,4,4,20,20,1,116,3,0.2
1989,"Aston Villa",1,38,70,57,38,19,1.84210526315789,1.5,1,0.5,2,2,20,20,17,121,-15,-0.4
1989,"Barnsley",2,46,54,49,71,-22,1.17391304347826,1.06521739130435,1.54347826086957,-0.478260869565217,37,17,24,44,27,111,10,1.3
1989,"Birmingham City",3,46,66,60,59,1,1.43478260869565,1.30434782608696,1.28260869565217,0.0217391304347826,51,7,24,68,56,117,-5,2.6
1989,"Blackburn Rovers",2,46,74,74,59,15,1.60869565217391,1.60869565217391,1.28260869565217,0.326086956521739,24,4,24,44,39,121,-15,-0.7
1989,"Blackpool",3,46,46,49,73,-24,1,1.06521739130435,1.58695652173913,-0.521739130434783,67,23,24,68,73,112,-6,0.1
1989,"Bolton Wanderers",3,46,69,59,48,11,1.5,1.28260869565217,1.04347826086957,0.239130434782609,50,6,24,68,47,121,3,2.4
1989,"Bradford City",2,46,41,44,68,-24,0.891304347826087,0.956521739130435,1.47826086956522,-0.521739130434783,43,23,24,44,53,106,-10,2.6
1989,"Brentford",3,46,61,66,66,0,1.32608695652174,1.43478260869565,1.43478260869565,0,57,13,24,68,50,93,7,-0.4
1989,"Brighton & Hove Albion",2,46,54,56,72,-16,1.17391304347826,1.21739130434783,1.56521739130435,-0.347826086956522,38,18,24,44,26,93,12,-4.1
1989,"Bristol City",3,46,91,76,40,36,1.97826086956522,1.65217391304348,0.869565217391304,0.782608695652174,46,2,24,68,29,108,17,-0.7
1989,"Bristol Rovers",3,46,93,71,35,36,2.02173913043478,1.54347826086957,0.760869565217391,0.782608695652174,45,1,24,68,32,92,13,-0.6
1989,"Burnley",4,46,56,45,55,-10,1.21739130434783,0.978260869565217,1.19565217391304,-0.217391304347826,84,16,24,92,74,121,10,3.8
1989,"Bury",3,46,74,70,49,21,1.60869565217391,1.52173913043478,1.06521739130435,0.456521739130435,49,5,24,68,51,114,-2,-1.1
1989,"Cambridge United",4,46,73,76,66,10,1.58695652173913,1.65217391304348,1.43478260869565,0.217391304347826,73,5,24,92,45,41,28,1
1989,"Cardiff City",3,46,50,51,70,-19,1.08695652173913,1.10869565217391,1.52173913043478,-0.41304347826087,65,21,24,68,81,93,-16,0
1989,"Carlisle United",4,46,71,61,60,1,1.54347826086957,1.32608695652174,1.30434782608696,0.0217391304347826,75,7,24,92,88,84,-13,-1.6
1989,"Charlton Athletic",1,38,30,31,57,-26,0.789473684210526,0.815789473684211,1.5,-0.684210526315789,19,19,20,20,36,92,-17,-0.2
1989,"Chelsea",1,38,60,58,50,8,1.57894736842105,1.52631578947368,1.31578947368421,0.210526315789474,5,5,20,20,10,104,-5,0
1989,"Chester",3,46,54,43,55,-12,1.17391304347826,0.934782608695652,1.19565217391304,-0.260869565217391,60,16,24,68,63,67,-3,-3.2
1989,"Chesterfield",4,46,71,63,50,13,1.54347826086957,1.3695652173913,1.08695652173913,0.282608695652174,76,8,24,92,84,100,-8,0.8
1989,"Colchester United",4,46,43,48,75,-27,0.934782608695652,1.04347826086957,1.6304347826087,-0.58695652173913,92,24,24,92,80,68,12,3.3
1989,"Coventry City",1,38,49,39,59,-20,1.28947368421053,1.02631578947368,1.55263157894737,-0.526315789473684,12,12,20,20,16,94,-4,-0.2
1989,"Crewe Alexandra",3,46,62,56,53,3,1.34782608695652,1.21739130434783,1.15217391304348,0.0652173913043478,56,12,24,68,66,96,-10,1.8
1989,"Crystal Palace",1,38,48,42,66,-24,1.26315789473684,1.10526315789474,1.73684210526316,-0.631578947368421,13,13,20,20,3,93,10,-2.2
1989,"Derby County",1,38,46,43,40,3,1.21052631578947,1.13157894736842,1.05263157894737,0.0789473684210526,16,16,20,20,20,121,-4,0
1989,"Doncaster Rovers",4,46,51,53,60,-7,1.10869565217391,1.15217391304348,1.30434782608696,-0.152173913043478,88,20,24,92,79,88,9,3.4
1989,"Everton",1,38,59,57,46,11,1.55263157894737,1.5,1.21052631578947,0.289473684210526,6,6,20,20,9,121,-3,-0.7
1989,"Exeter City",4,46,89,83,48,35,1.93478260869565,1.80434782608696,1.04347826086957,0.760869565217391,69,1,24,92,60,88,9,-2
1989,"Fulham",3,46,51,55,66,-11,1.10869565217391,1.19565217391304,1.43478260869565,-0.239130434782609,64,20,24,68,65,102,-1,3.5
1989,"Gillingham",4,46,62,46,48,-2,1.34782608695652,1,1.04347826086957,-0.0434782608695652,82,14,24,92,83,88,-1,3.5
1989,"Grimsby Town",4,46,79,70,47,23,1.71739130434783,1.52173913043478,1.02173913043478,0.5,70,2,24,92,48,110,22,3.1
1989,"Halifax Town",4,46,49,57,65,-8,1.06521739130435,1.23913043478261,1.41304347826087,-0.173913043478261,91,23,24,92,89,69,2,NA
1989,"Hartlepool United",4,46,55,66,88,-22,1.19565217391304,1.43478260869565,1.91304347826087,-0.478260869565217,85,17,24,92,70,89,15,1
1989,"Hereford United",4,46,55,56,62,-6,1.19565217391304,1.21739130434783,1.34782608695652,-0.130434782608696,86,18,24,92,85,31,1,1.8
1989,"Huddersfield Town",3,46,65,61,62,-1,1.41304347826087,1.32608695652174,1.34782608695652,-0.0217391304347826,52,8,24,68,55,99,-3,2.5
1989,"Hull City",2,46,58,58,65,-7,1.26086956521739,1.26086956521739,1.41304347826087,-0.152173913043478,34,14,24,44,44,104,-10,-4.8
1989,"Ipswich Town",2,46,69,67,66,1,1.5,1.45652173913043,1.43478260869565,0.0217391304347826,29,9,24,44,34,75,-5,0.6
1989,"Leeds United",2,46,85,79,52,27,1.84782608695652,1.71739130434783,1.1304347826087,0.58695652173913,21,1,24,44,4,93,17,1.8
1989,"Leicester City",2,46,59,67,79,-12,1.28260869565217,1.45652173913043,1.71739130434783,-0.260869565217391,33,13,24,44,41,115,-8,2.5
1989,"Leyton Orient",3,46,58,52,56,-4,1.26086956521739,1.1304347826087,1.21739130434783,-0.0869565217391304,58,14,24,68,57,102,1,-2.9
1989,"Lincoln City",4,46,68,48,48,0,1.47826086956522,1.04347826086957,1.04347826086957,0,77,9,24,92,82,107,-5,-0.6
1989,"Liverpool",1,38,79,78,37,41,2.07894736842105,2.05263157894737,0.973684210526316,1.07894736842105,1,1,20,20,2,116,-1,-0.3
1989,"Luton Town",1,38,43,43,57,-14,1.13157894736842,1.13157894736842,1.5,-0.368421052631579,17,17,20,20,18,91,-1,-3.9
1989,"Maidstone United",4,46,73,77,61,16,1.58695652173913,1.67391304347826,1.32608695652174,0.347826086956522,74,6,24,92,87,3,-13,NA
1989,"Manchester City",1,38,48,43,52,-9,1.26315789473684,1.13157894736842,1.36842105263158,-0.236842105263158,14,14,20,20,5,117,9,-0.8
1989,"Manchester United",1,38,48,46,47,-1,1.26315789473684,1.21052631578947,1.23684210526316,-0.0263157894736842,15,15,20,20,6,117,9,1.4
1989,"Mansfield Town",3,46,55,50,65,-15,1.19565217391304,1.08695652173913,1.41304347826087,-0.326086956521739,59,15,24,68,68,77,-9,-2.5
1989,"Middlesbrough",2,46,50,52,63,-11,1.08695652173913,1.1304347826087,1.3695652173913,-0.239130434782609,41,21,24,44,28,110,13,3
1989,"Millwall",1,38,26,39,65,-26,0.684210526315789,1.02631578947368,1.71052631578947,-0.684210526315789,20,20,20,20,25,93,-5,-2.9
1989,"Newcastle United",2,46,80,80,55,25,1.73913043478261,1.73913043478261,1.19565217391304,0.543478260869565,23,3,24,44,31,116,-8,1.1
1989,"Northampton Town",3,46,47,51,68,-17,1.02173913043478,1.10869565217391,1.47826086956522,-0.369565217391304,66,22,24,68,78,93,-12,-0.5
1989,"Norwich City",1,38,53,44,42,2,1.39473684210526,1.15789473684211,1.10526315789474,0.0526315789473684,10,10,20,20,14,93,-4,-2.2
1989,"Nottingham Forest",1,38,54,55,47,8,1.42105263157895,1.44736842105263,1.23684210526316,0.210526315789474,9,9,20,20,8,117,1,-2.5
1989,"Notts County",3,46,87,73,53,20,1.89130434782609,1.58695652173913,1.15217391304348,0.434782608695652,47,3,24,68,24,120,23,-0.5
1989,"Oldham Athletic",2,46,71,70,57,13,1.54347826086957,1.52173913043478,1.23913043478261,0.282608695652174,28,8,24,44,21,102,7,-3
1989,"Oxford United",2,46,54,57,66,-9,1.17391304347826,1.23913043478261,1.43478260869565,-0.195652173913043,39,19,24,44,30,54,9,-2.5
1989,"Peterborough United",4,46,68,59,46,13,1.47826086956522,1.28260869565217,1,0.282608695652174,78,10,24,92,72,60,6,0.5
1989,"Plymouth Argyle",2,46,55,58,63,-5,1.19565217391304,1.26086956521739,1.3695652173913,-0.108695652173913,36,16,24,44,37,93,-1,-4.4
1989,"Port Vale",2,46,61,62,57,5,1.32608695652174,1.34782608695652,1.23913043478261,0.108695652173913,31,11,24,44,35,107,-4,-1.2
1989,"Portsmouth",2,46,61,62,65,-3,1.32608695652174,1.34782608695652,1.41304347826087,-0.0652173913043478,32,12,24,44,38,93,-6,-0.8
1989,"Preston North End",3,46,52,65,79,-14,1.1304347826087,1.41304347826087,1.71739130434783,-0.304347826086957,63,19,24,68,61,121,2,1.8
1989,"Queens Park Rangers",1,38,50,45,44,1,1.31578947368421,1.18421052631579,1.15789473684211,0.0263157894736842,11,11,20,20,12,93,-1,-1.9
1989,"Reading",3,46,64,57,53,4,1.39130434782609,1.23913043478261,1.15217391304348,0.0869565217391304,53,9,24,68,59,93,-6,-0.1
1989,"Rochdale",4,46,66,52,55,-3,1.43478260869565,1.1304347826087,1.19565217391304,-0.0652173913043478,79,11,24,92,80,92,-1,0.1
1989,"Rotherham United",3,46,64,71,62,9,1.39130434782609,1.54347826086957,1.34782608695652,0.195652173913043,54,10,24,68,67,88,-13,-1.6
1989,"Scarborough",4,46,55,60,73,-13,1.19565217391304,1.30434782608696,1.58695652173913,-0.282608695652174,87,19,24,92,77,12,10,NA
1989,"Scunthorpe United",4,46,66,69,54,15,1.43478260869565,1.5,1.17391304347826,0.326086956521739,80,12,24,92,76,70,4,1.3
1989,"Sheffield United",2,46,85,78,58,20,1.84782608695652,1.69565217391304,1.26086956521739,0.434782608695652,22,2,24,44,13,117,9,-1.4
1989,"Sheffield Wednesday",1,38,43,35,51,-16,1.13157894736842,0.921052631578947,1.34210526315789,-0.421052631578947,18,18,20,20,23,117,-5,-0.1
1989,"Shrewsbury Town",3,46,63,59,54,5,1.3695652173913,1.28260869565217,1.17391304347826,0.108695652173913,55,11,24,68,62,69,-7,-3.5
1989,"Southampton",1,38,55,71,63,8,1.44736842105263,1.86842105263158,1.65789473684211,0.210526315789474,7,7,20,20,15,93,-8,-0.8
1989,"Southend United",4,46,75,61,48,13,1.6304347826087,1.32608695652174,1.04347826086957,0.282608695652174,71,3,24,92,46,93,25,-1.4
1989,"Stockport County",4,46,74,68,62,6,1.60869565217391,1.47826086956522,1.34782608695652,0.130434782608696,72,4,24,92,71,99,1,3.5
1989,"Stoke City",2,46,37,35,63,-28,0.804347826086957,0.760869565217391,1.3695652173913,-0.608695652173913,44,24,24,44,58,113,-14,-0.6
1989,"Sunderland",2,46,74,70,64,6,1.60869565217391,1.52173913043478,1.39130434782609,0.130434782608696,25,5,24,44,19,119,6,1.8
1989,"Swansea City",3,46,54,45,63,-18,1.17391304347826,0.978260869565217,1.3695652173913,-0.391304347826087,61,17,24,68,64,93,-3,-0.8
1989,"Swindon Town",2,46,74,79,59,20,1.60869565217391,1.71739130434783,1.28260869565217,0.434782608695652,26,6,24,44,42,93,-16,-1.8
1989,"Torquay United",4,46,57,53,66,-13,1.23913043478261,1.15217391304348,1.43478260869565,-0.282608695652174,83,15,24,92,75,78,8,0.6
1989,"Tottenham Hotspur",1,38,63,59,47,12,1.65789473684211,1.55263157894737,1.23684210526316,0.315789473684211,3,3,20,20,11,101,-8,-0.7
1989,"Tranmere Rovers",3,46,80,86,49,37,1.73913043478261,1.8695652173913,1.06521739130435,0.804347826086957,48,4,24,68,49,89,-1,1.5
1989,"Walsall",3,46,41,40,72,-32,0.891304347826087,0.869565217391304,1.56521739130435,-0.695652173913043,68,24,24,68,86,100,-18,2.6
1989,"Watford",2,46,57,58,60,-2,1.23913043478261,1.26086956521739,1.30434782608696,-0.0434782608695652,35,15,24,44,40,93,-5,1.5
1989,"West Bromwich Albion",2,46,51,67,71,-4,1.10869565217391,1.45652173913043,1.54347826086957,-0.0869565217391304,40,20,24,44,43,121,-3,-0.1
1989,"West Ham United",2,46,72,80,57,23,1.56521739130435,1.73913043478261,1.23913043478261,0.5,27,7,24,44,22,94,5,1.8
1989,"Wigan Athletic",3,46,53,48,64,-16,1.15217391304348,1.04347826086957,1.39130434782609,-0.347826086956522,62,18,24,68,54,42,8,1.4
1989,"Wimbledon",1,38,55,47,40,7,1.44736842105263,1.23684210526316,1.05263157894737,0.184210526315789,8,8,20,20,7,27,1,-1
1989,"Wolverhampton Wanderers",2,46,67,67,60,7,1.45652173913043,1.45652173913043,1.30434782608696,0.152173913043478,30,10,24,44,33,121,-3,0.2
1989,"Wrexham",4,46,51,51,67,-16,1.10869565217391,1.10869565217391,1.45652173913043,-0.347826086956522,89,21,24,92,92,80,-3,3.4
1989,"York City",4,46,64,55,53,2,1.39130434782609,1.19565217391304,1.15217391304348,0.0434782608695652,81,13,24,92,90,72,-9,-0.7
1990,"AFC Bournemouth",3,46,70,58,58,0,1.52173913043478,1.26086956521739,1.26086956521739,0,52,8,24,68,53,90,-1,0.1
1990,"Aldershot",4,46,41,61,101,-40,0.891304347826087,1.32608695652174,2.19565217391304,-0.869565217391304,91,23,24,92,85,57,6,NA
1990,"Arsenal",1,38,85,74,18,56,2.23684210526316,1.94736842105263,0.473684210526316,1.47368421052632,1,1,20,20,4,116,-3,-0.1
1990,"Aston Villa",1,38,41,46,58,-12,1.07894736842105,1.21052631578947,1.52631578947368,-0.315789473684211,17,17,20,20,7,121,10,0.9
1990,"Barnsley",2,46,69,63,48,15,1.5,1.3695652173913,1.04347826086957,0.326086956521739,27,7,24,44,38,111,-11,-0.8
1990,"Birmingham City",3,46,65,45,49,-4,1.41304347826087,0.978260869565217,1.06521739130435,-0.0869565217391304,56,12,24,68,48,117,8,3.2
1990,"Blackburn Rovers",2,46,52,51,66,-15,1.1304347826087,1.10869565217391,1.43478260869565,-0.326086956521739,39,19,24,44,27,121,12,1.7
1990,"Blackpool",4,46,79,78,47,31,1.71739130434783,1.69565217391304,1.02173913043478,0.673913043478261,73,5,24,92,74,112,-1,-0.2
1990,"Bolton Wanderers",3,46,83,64,50,14,1.80434782608696,1.39130434782609,1.08695652173913,0.304347826086957,47,3,24,68,59,121,-12,2.4
1990,"Bradford City",3,46,70,62,54,8,1.52173913043478,1.34782608695652,1.17391304347826,0.173913043478261,53,9,24,68,62,106,-9,3.3
1990,"Brentford",3,46,76,59,47,12,1.65217391304348,1.28260869565217,1.02173913043478,0.260869565217391,50,6,24,68,47,93,3,-0.6
1990,"Brighton & Hove Albion",2,46,70,63,69,-6,1.52173913043478,1.3695652173913,1.5,-0.130434782608696,26,6,24,44,45,93,-19,-4.3
1990,"Bristol City",2,46,67,68,71,-3,1.45652173913043,1.47826086956522,1.54347826086957,-0.0652173913043478,29,9,24,44,39,108,-10,-2.4
1990,"Bristol Rovers",2,46,58,56,59,-3,1.26086956521739,1.21739130434783,1.28260869565217,-0.0652173913043478,32,12,24,44,34,92,-2,-3.3
1990,"Burnley",4,46,79,70,51,19,1.71739130434783,1.52173913043478,1.10869565217391,0.41304347826087,74,6,24,92,71,121,3,4.7
1990,"Bury",3,46,73,67,56,11,1.58695652173913,1.45652173913043,1.21739130434783,0.239130434782609,51,7,24,68,67,114,-16,-0.8
1990,"Cambridge United",3,46,86,75,45,30,1.8695652173913,1.6304347826087,0.978260869565217,0.652173913043478,45,1,24,68,28,41,17,-1.8
1990,"Cardiff City",4,46,60,43,54,-11,1.30434782608696,0.934782608695652,1.17391304347826,-0.239130434782609,81,13,24,92,79,93,2,1
1990,"Carlisle United",4,46,48,47,89,-42,1.04347826086957,1.02173913043478,1.93478260869565,-0.91304347826087,88,20,24,92,92,84,-4,-0.2
1990,"Charlton Athletic",2,46,56,57,61,-4,1.21739130434783,1.23913043478261,1.32608695652174,-0.0869565217391304,36,16,24,44,29,92,7,2.7
1990,"Chelsea",1,38,49,58,69,-11,1.28947368421053,1.52631578947368,1.81578947368421,-0.289473684210526,10,10,20,20,12,104,-2,0.4
1990,"Chester",3,46,51,46,58,-12,1.10869565217391,1,1.26086956521739,-0.260869565217391,63,19,24,68,64,67,-1,-2.4
1990,"Chesterfield",4,46,53,47,62,-15,1.15217391304348,1.02173913043478,1.34782608695652,-0.326086956521739,84,16,24,92,83,100,1,1.4
1990,"Coventry City",1,38,44,42,49,-7,1.15789473684211,1.10526315789474,1.28947368421053,-0.184210526315789,16,16,20,20,19,94,-3,-0.2
1990,"Crewe Alexandra",3,46,44,62,80,-18,0.956521739130435,1.34782608695652,1.73913043478261,-0.391304347826087,66,22,24,68,76,96,-10,3.4
1990,"Crystal Palace",1,38,69,50,41,9,1.81578947368421,1.31578947368421,1.07894736842105,0.236842105263158,3,3,20,20,9,93,-6,-3.7
1990,"Darlington",4,46,83,68,38,30,1.80434782608696,1.47826086956522,0.826086956521739,0.652173913043478,69,1,24,92,70,81,-1,-1.9
1990,"Derby County",1,38,24,37,75,-38,0.631578947368421,0.973684210526316,1.97368421052632,-1,20,20,20,20,25,121,-5,0.6
1990,"Doncaster Rovers",4,46,65,56,46,10,1.41304347826087,1.21739130434783,1,0.217391304347826,79,11,24,92,91,88,-12,2.8
1990,"Everton",1,38,51,50,46,4,1.34210526315789,1.31578947368421,1.21052631578947,0.105263157894737,9,9,20,20,13,121,-4,-0.6
1990,"Exeter City",3,46,57,58,52,6,1.23913043478261,1.26086956521739,1.1304347826087,0.130434782608696,60,16,24,68,66,88,-6,-2.7
1990,"Fulham",3,46,46,41,56,-15,1,0.891304347826087,1.21739130434783,-0.326086956521739,65,21,24,68,55,102,10,4.4
1990,"Gillingham",4,46,54,57,60,-3,1.17391304347826,1.23913043478261,1.30434782608696,-0.0652173913043478,83,15,24,92,81,88,2,5
1990,"Grimsby Town",3,46,83,66,34,32,1.80434782608696,1.43478260869565,0.739130434782609,0.695652173913043,48,4,24,68,40,110,8,1
1990,"Halifax Town",4,46,46,59,79,-20,1,1.28260869565217,1.71739130434783,-0.434782608695652,89,21,24,92,90,69,-1,NA
1990,"Hartlepool United",4,46,82,67,48,19,1.78260869565217,1.45652173913043,1.04347826086957,0.41304347826087,70,2,24,92,56,89,14,-0.2
1990,"Hereford United",4,46,53,53,58,-5,1.15217391304348,1.15217391304348,1.26086956521739,-0.108695652173913,85,17,24,92,87,31,-2,0.1
1990,"Huddersfield Town",3,46,67,57,51,6,1.45652173913043,1.23913043478261,1.10869565217391,0.130434782608696,55,11,24,68,49,99,6,1.3
1990,"Hull City",2,46,45,57,85,-28,0.978260869565217,1.23913043478261,1.84782608695652,-0.608695652173913,44,24,24,44,60,104,-16,-3
1990,"Ipswich Town",2,46,57,60,68,-8,1.23913043478261,1.30434782608696,1.47826086956522,-0.173913043478261,34,14,24,44,23,75,11,2.9
1990,"Leeds United",1,38,64,65,47,18,1.68421052631579,1.71052631578947,1.23684210526316,0.473684210526316,4,4,20,20,1,93,3,0
1990,"Leicester City",2,46,50,60,83,-23,1.08695652173913,1.30434782608696,1.80434782608696,-0.5,41,21,24,44,26,115,15,2.8
1990,"Leyton Orient",3,46,64,55,58,-3,1.39130434782609,1.19565217391304,1.26086956521739,-0.0652173913043478,57,13,24,68,57,102,0,-1.6
1990,"Lincoln City",4,46,59,50,61,-11,1.28260869565217,1.08695652173913,1.32608695652174,-0.239130434782609,82,14,24,92,80,107,2,-0.4
1990,"Liverpool",1,38,76,77,40,37,2,2.02631578947368,1.05263157894737,0.973684210526316,2,2,20,20,6,116,-4,-0.1
1990,"Luton Town",1,38,37,42,61,-19,0.973684210526316,1.10526315789474,1.60526315789474,-0.5,18,18,20,20,20,91,-2,-4.8
1990,"Maidstone United",4,46,51,66,71,-5,1.10869565217391,1.43478260869565,1.54347826086957,-0.108695652173913,87,19,24,92,88,3,-1,NA
1990,"Manchester City",1,38,62,64,53,11,1.63157894736842,1.68421052631579,1.39473684210526,0.289473684210526,5,5,20,20,5,117,0,-1.4
1990,"Manchester United",1,38,60,58,45,13,1.57894736842105,1.52631578947368,1.18421052631579,0.342105263157895,6,6,20,20,2,117,4,0.5
1990,"Mansfield Town",3,46,38,42,63,-21,0.826086956521739,0.91304347826087,1.3695652173913,-0.456521739130435,68,24,24,68,72,77,-4,-1.2
1990,"Middlesbrough",2,46,69,66,47,19,1.5,1.43478260869565,1.02173913043478,0.41304347826087,28,8,24,44,24,110,4,1.2
1990,"Millwall",2,46,73,70,51,19,1.58695652173913,1.52173913043478,1.10869565217391,0.41304347826087,25,5,24,44,36,93,-11,-2
1990,"Newcastle United",2,46,59,49,56,-7,1.28260869565217,1.06521739130435,1.21739130434783,-0.152173913043478,31,11,24,44,42,116,-11,2
1990,"Northampton Town",4,46,67,57,58,-1,1.45652173913043,1.23913043478261,1.26086956521739,-0.0217391304347826,78,10,24,92,86,93,-8,1.6
1990,"Norwich City",1,38,45,41,64,-23,1.18421052631579,1.07894736842105,1.68421052631579,-0.605263157894737,14,14,20,20,18,93,-4,-2.2
1990,"Nottingham Forest",1,38,54,65,50,15,1.42105263157895,1.71052631578947,1.31578947368421,0.394736842105263,8,8,20,20,8,117,0,-2.2
1990,"Notts County",2,46,80,76,55,21,1.73913043478261,1.65217391304348,1.19565217391304,0.456521739130435,24,4,24,44,21,120,3,-2.8
1990,"Oldham Athletic",2,46,88,83,53,30,1.91304347826087,1.80434782608696,1.15217391304348,0.652173913043478,21,1,24,44,17,102,4,-3.9
1990,"Oxford United",2,46,61,69,66,3,1.32608695652174,1.5,1.43478260869565,0.0652173913043478,30,10,24,44,43,54,-13,-3.8
1990,"Peterborough United",4,46,80,67,45,22,1.73913043478261,1.45652173913043,0.978260869565217,0.478260869565217,72,4,24,92,52,60,20,1.5
1990,"Plymouth Argyle",2,46,53,54,68,-14,1.15217391304348,1.17391304347826,1.47826086956522,-0.304347826086957,37,17,24,44,44,93,-7,-4.4
1990,"Port Vale",2,46,57,56,64,-8,1.23913043478261,1.21739130434783,1.39130434782609,-0.173913043478261,35,15,24,44,46,107,-11,-2
1990,"Portsmouth",2,46,53,58,70,-12,1.15217391304348,1.26086956521739,1.52173913043478,-0.260869565217391,38,18,24,44,30,93,8,-0.3
1990,"Preston North End",3,46,56,54,67,-13,1.21739130434783,1.17391304347826,1.45652173913043,-0.282608695652174,61,17,24,68,63,121,-2,3.6
1990,"Queens Park Rangers",1,38,46,44,53,-9,1.21052631578947,1.15789473684211,1.39473684210526,-0.236842105263158,12,12,20,20,11,93,1,-3.1
1990,"Reading",3,46,59,53,66,-13,1.28260869565217,1.15217391304348,1.43478260869565,-0.282608695652174,59,15,24,68,58,93,1,1.2
1990,"Rochdale",4,46,62,50,53,-3,1.34782608695652,1.08695652173913,1.15217391304348,-0.0652173913043478,80,12,24,92,78,92,2,0.4
1990,"Rotherham United",3,46,42,50,87,-37,0.91304347826087,1.08695652173913,1.89130434782609,-0.804347826086957,67,23,24,68,73,88,-6,2.1
1990,"Scarborough",4,46,69,59,56,3,1.5,1.28260869565217,1.21739130434783,0.0652173913043478,77,9,24,92,82,12,-5,NA
1990,"Scunthorpe United",4,46,71,71,62,9,1.54347826086957,1.54347826086957,1.34782608695652,0.195652173913043,76,8,24,92,75,70,1,-0.2
1990,"Sheffield United",1,38,46,36,55,-19,1.21052631578947,0.947368421052632,1.44736842105263,-0.5,13,13,20,20,10,117,3,-1.8
1990,"Sheffield Wednesday",2,46,82,80,51,29,1.78260869565217,1.73913043478261,1.10869565217391,0.630434782608696,23,3,24,44,3,117,20,-1.4
1990,"Shrewsbury Town",3,46,52,61,68,-7,1.1304347826087,1.32608695652174,1.47826086956522,-0.152173913043478,62,18,24,68,68,69,-6,-2.1
1990,"Southampton",1,38,45,58,69,-11,1.18421052631579,1.52631578947368,1.81578947368421,-0.289473684210526,15,15,20,20,15,93,0,0.5
1990,"Southend United",3,46,85,67,51,16,1.84782608695652,1.45652173913043,1.10869565217391,0.347826086956522,46,2,24,68,35,93,11,-3.3
1990,"Stockport County",4,46,82,84,47,37,1.78260869565217,1.82608695652174,1.02173913043478,0.804347826086957,71,3,24,92,51,99,20,3.2
1990,"Stoke City",3,46,60,55,59,-4,1.30434782608696,1.19565217391304,1.28260869565217,-0.0869565217391304,58,14,24,68,50,113,8,0.9
1990,"Sunderland",1,38,34,38,60,-22,0.894736842105263,1,1.57894736842105,-0.578947368421053,19,19,20,20,41,119,-22,1.2
1990,"Swansea City",3,46,48,49,72,-23,1.04347826086957,1.06521739130435,1.56521739130435,-0.5,64,20,24,68,65,93,-1,-0.3
1990,"Swindon Town",2,46,50,65,73,-8,1.08695652173913,1.41304347826087,1.58695652173913,-0.173913043478261,42,22,24,44,31,93,11,-2.2
1990,"Torquay United",4,46,72,64,47,17,1.56521739130435,1.39130434782609,1.02173913043478,0.369565217391304,75,7,24,92,69,78,6,-1.4
1990,"Tottenham Hotspur",1,38,49,51,50,1,1.28947368421053,1.34210526315789,1.31578947368421,0.0263157894736842,11,11,20,20,16,101,-5,-0.1
1990,"Tranmere Rovers",3,46,78,64,46,18,1.69565217391304,1.39130434782609,1,0.391304347826087,49,5,24,68,37,89,12,0.5
1990,"Walsall",4,46,53,48,51,-3,1.15217391304348,1.04347826086957,1.10869565217391,-0.0652173913043478,86,18,24,92,85,100,1,3.8
1990,"Watford",2,46,51,45,59,-14,1.10869565217391,0.978260869565217,1.28260869565217,-0.304347826086957,40,20,24,44,32,93,8,1.2
1990,"West Bromwich Albion",2,46,48,52,61,-9,1.04347826086957,1.1304347826087,1.32608695652174,-0.195652173913043,43,23,24,44,54,121,-11,1.7
1990,"West Ham United",2,46,87,60,34,26,1.89130434782609,1.30434782608696,0.739130434782609,0.565217391304348,22,2,24,44,22,94,0,0.5
1990,"Wigan Athletic",3,46,69,71,54,17,1.5,1.54347826086957,1.17391304347826,0.369565217391304,54,10,24,68,61,42,-7,0.4
1990,"Wimbledon",1,38,56,53,46,7,1.47368421052632,1.39473684210526,1.21052631578947,0.184210526315789,7,7,20,20,14,27,-7,-2.2
1990,"Wolverhampton Wanderers",2,46,58,63,63,0,1.26086956521739,1.3695652173913,1.3695652173913,0,33,13,24,44,33,121,0,-0.1
1990,"Wrexham",4,46,40,48,74,-26,0.869565217391304,1.04347826086957,1.60869565217391,-0.565217391304348,92,24,24,92,84,80,8,3.8
1990,"York City",4,46,46,45,57,-12,1,0.978260869565217,1.23913043478261,-0.260869565217391,90,22,24,92,89,72,1,0.5
1991,"AFC Bournemouth",3,46,71,52,48,4,1.54347826086957,1.1304347826087,1.04347826086957,0.0869565217391304,53,7,24,70,63,90,-10,-1.2
1991,"Arsenal",1,42,72,81,46,35,1.71428571428571,1.92857142857143,1.0952380952381,0.833333333333333,4,4,22,22,10,116,-6,0.3
1991,"Aston Villa",1,42,60,48,44,4,1.42857142857143,1.14285714285714,1.04761904761905,0.0952380952380952,7,7,22,22,2,121,5,-0.1
1991,"Barnet",4,42,69,81,61,20,1.64285714285714,1.92857142857143,1.45238095238095,0.476190476190476,77,7,22,92,73,21,4,-0.6
1991,"Barnsley",2,46,59,46,57,-11,1.28260869565217,1,1.23913043478261,-0.239130434782609,38,16,24,46,35,111,3,-0.5
1991,"Birmingham City",3,46,81,69,52,17,1.76086956521739,1.5,1.1304347826087,0.369565217391304,48,2,24,70,41,117,7,2.3
1991,"Blackburn Rovers",2,46,74,70,53,17,1.60869565217391,1.52173913043478,1.15217391304348,0.369565217391304,27,5,24,46,4,121,23,1.7
1991,"Blackpool",4,42,76,71,45,26,1.80952380952381,1.69047619047619,1.07142857142857,0.619047619047619,74,4,22,92,64,112,10,1.4
1991,"Bolton Wanderers",3,46,59,57,56,1,1.28260869565217,1.23913043478261,1.21739130434783,0.0217391304347826,59,13,24,70,48,121,11,4.3
1991,"Bradford City",3,46,58,62,61,1,1.26086956521739,1.34782608695652,1.32608695652174,0.0217391304347826,62,16,24,70,56,106,6,2.7
1991,"Brentford",3,46,82,81,55,26,1.78260869565217,1.76086956521739,1.19565217391304,0.565217391304348,47,1,24,70,44,93,3,0
1991,"Brighton & Hove Albion",2,46,47,56,77,-21,1.02173913043478,1.21739130434783,1.67391304347826,-0.456521739130435,45,23,24,46,54,93,-9,0
1991,"Bristol City",2,46,54,55,71,-16,1.17391304347826,1.19565217391304,1.54347826086957,-0.347826086956522,39,17,24,46,36,108,3,-1.2
1991,"Bristol Rovers",2,46,62,60,63,-3,1.34782608695652,1.30434782608696,1.3695652173913,-0.0652173913043478,34,12,24,46,46,92,-12,-5.7
1991,"Burnley",4,42,83,79,43,36,1.97619047619048,1.88095238095238,1.02380952380952,0.857142857142857,71,1,22,92,59,121,12,4.5
1991,"Bury",3,46,51,55,74,-19,1.10869565217391,1.19565217391304,1.60869565217391,-0.41304347826087,67,21,24,70,77,114,-10,0.1
1991,"Cambridge United",2,46,74,65,47,18,1.60869565217391,1.41304347826087,1.02173913043478,0.391304347826087,28,6,24,46,45,41,-17,-4
1991,"Cardiff City",4,42,66,66,53,13,1.57142857142857,1.57142857142857,1.26190476190476,0.30952380952381,79,9,22,92,71,93,8,3.1
1991,"Carlisle United",4,42,34,41,67,-26,0.80952380952381,0.976190476190476,1.5952380952381,-0.619047619047619,92,22,22,92,88,84,4,0.7
1991,"Charlton Athletic",2,46,71,54,48,6,1.54347826086957,1.17391304347826,1.04347826086957,0.130434782608696,29,7,24,46,33,92,-4,1.6
1991,"Chelsea",1,42,53,50,60,-10,1.26190476190476,1.19047619047619,1.42857142857143,-0.238095238095238,12,12,22,22,11,104,1,0.6
1991,"Chester",3,46,56,56,59,-3,1.21739130434783,1.21739130434783,1.28260869565217,-0.0652173913043478,64,18,24,70,70,67,-6,-2
1991,"Chesterfield",4,42,53,49,61,-12,1.26190476190476,1.16666666666667,1.45238095238095,-0.285714285714286,83,13,22,92,82,100,1,2.1
1991,"Coventry City",1,42,44,35,44,-9,1.04761904761905,0.833333333333333,1.04761904761905,-0.214285714285714,19,19,22,22,14,94,5,-1.1
1991,"Crewe Alexandra",4,42,70,66,51,15,1.66666666666667,1.57142857142857,1.21428571428571,0.357142857142857,76,6,22,92,76,96,0,3.5
1991,"Crystal Palace",1,42,57,53,61,-8,1.35714285714286,1.26190476190476,1.45238095238095,-0.19047619047619,9,9,22,22,19,93,-10,-2.2
1991,"Darlington",3,46,37,56,90,-34,0.804347826086957,1.21739130434783,1.95652173913043,-0.739130434782609,70,24,24,70,85,81,-15,-1.3
1991,"Derby County",2,46,78,69,51,18,1.69565217391304,1.5,1.10869565217391,0.391304347826087,25,3,24,46,30,121,-5,0.6
1991,"Doncaster Rovers",4,42,35,40,65,-25,0.833333333333333,0.952380952380952,1.54761904761905,-0.595238095238095,91,21,22,92,86,88,5,3.6
1991,"Everton",1,42,53,52,51,1,1.26190476190476,1.23809523809524,1.21428571428571,0.0238095238095238,13,13,22,22,13,121,0,-0.2
1991,"Exeter City",3,46,53,57,80,-23,1.15217391304348,1.23913043478261,1.73913043478261,-0.5,66,20,24,70,65,88,1,-1.8
1991,"Fulham",3,46,70,57,53,4,1.52173913043478,1.23913043478261,1.15217391304348,0.0869565217391304,55,9,24,70,57,102,-2,4.1
1991,"Gillingham",4,42,57,63,53,10,1.35714285714286,1.5,1.26190476190476,0.238095238095238,81,11,22,92,91,88,-10,4.9
1991,"Grimsby Town",2,46,53,47,62,-15,1.15217391304348,1.02173913043478,1.34782608695652,-0.326086956521739,40,18,24,46,31,110,9,0.1
1991,"Halifax Town",4,42,38,34,75,-41,0.904761904761905,0.80952380952381,1.78571428571429,-0.976190476190476,90,20,22,92,92,69,-2,NA
1991,"Hartlepool United",3,46,65,57,57,0,1.41304347826087,1.23913043478261,1.23913043478261,0,56,10,24,70,62,89,-6,-1.9
1991,"Hereford United",4,42,44,44,57,-13,1.04761904761905,1.04761904761905,1.35714285714286,-0.30952380952381,87,17,22,92,87,31,0,0.3
1991,"Huddersfield Town",3,46,78,59,38,21,1.69565217391304,1.28260869565217,0.826086956521739,0.456521739130435,49,3,24,70,60,99,-11,-0.1
1991,"Hull City",3,46,59,54,54,0,1.28260869565217,1.17391304347826,1.17391304347826,0,60,14,24,70,66,104,-6,-1.9
1991,"Ipswich Town",2,46,84,70,50,20,1.82608695652174,1.52173913043478,1.08695652173913,0.434782608695652,23,1,24,46,15,75,8,0.5
1991,"Leeds United",1,42,82,74,37,37,1.95238095238095,1.76190476190476,0.880952380952381,0.880952380952381,1,1,22,22,17,93,-16,-0.4
1991,"Leicester City",2,46,77,62,55,7,1.67391304347826,1.34782608695652,1.19565217391304,0.152173913043478,26,4,24,46,27,115,-1,0.6
1991,"Leyton Orient",3,46,65,62,52,10,1.41304347826087,1.34782608695652,1.1304347826087,0.217391304347826,57,11,24,70,52,102,5,-2.9
1991,"Lincoln City",4,42,62,50,44,6,1.47619047619048,1.19047619047619,1.04761904761905,0.142857142857143,80,10,22,92,78,107,2,-1
1991,"Liverpool",1,42,64,47,40,7,1.52380952380952,1.11904761904762,0.952380952380952,0.166666666666667,6,6,22,22,6,116,0,0.4
1991,"Luton Town",1,42,42,38,71,-33,1,0.904761904761905,1.69047619047619,-0.785714285714286,20,20,22,22,42,91,-22,-5
1991,"Maidstone United",4,42,42,45,56,-11,1,1.07142857142857,1.33333333333333,-0.261904761904762,88,18,22,92,NA,3,NA,NA
1991,"Manchester City",1,42,70,61,48,13,1.66666666666667,1.45238095238095,1.14285714285714,0.30952380952381,5,5,22,22,9,117,-4,-1.6
1991,"Manchester United",1,42,78,63,33,30,1.85714285714286,1.5,0.785714285714286,0.714285714285714,2,2,22,22,1,117,1,-0.1
1991,"Mansfield Town",4,42,77,75,53,22,1.83333333333333,1.78571428571429,1.26190476190476,0.523809523809524,72,2,22,92,68,77,4,0.1
1991,"Middlesbrough",2,46,80,58,41,17,1.73913043478261,1.26086956521739,0.891304347826087,0.369565217391304,24,2,24,46,21,110,3,1.3
1991,"Millwall",2,46,61,64,71,-7,1.32608695652174,1.39130434782609,1.54347826086957,-0.152173913043478,36,14,24,46,29,93,7,1.2
1991,"Newcastle United",2,46,52,66,84,-18,1.1304347826087,1.43478260869565,1.82608695652174,-0.391304347826087,42,20,24,46,23,116,19,3.8
1991,"Northampton Town",4,42,46,46,57,-11,1.0952380952381,1.0952380952381,1.35714285714286,-0.261904761904762,86,16,22,92,90,93,-4,2.2
1991,"Norwich City",1,42,45,47,63,-16,1.07142857142857,1.11904761904762,1.5,-0.380952380952381,18,18,22,22,3,93,15,-0.9
1991,"Nottingham Forest",1,42,59,60,58,2,1.4047619047619,1.42857142857143,1.38095238095238,0.0476190476190476,8,8,22,22,22,117,-14,-2.8
1991,"Notts County",1,42,40,40,62,-22,0.952380952380952,0.952380952380952,1.47619047619048,-0.523809523809524,21,21,22,22,39,120,-18,-4.2
1991,"Oldham Athletic",1,42,51,63,67,-4,1.21428571428571,1.5,1.5952380952381,-0.0952380952380952,17,17,22,22,20,102,-3,-3.6
1991,"Oxford United",2,46,50,66,73,-7,1.08695652173913,1.43478260869565,1.58695652173913,-0.152173913043478,43,21,24,46,37,54,6,-4.6
1991,"Peterborough United",3,46,74,65,58,7,1.60869565217391,1.41304347826087,1.26086956521739,0.152173913043478,52,6,24,70,32,60,20,-0.9
1991,"Plymouth Argyle",2,46,48,42,64,-22,1.04347826086957,0.91304347826087,1.39130434782609,-0.478260869565217,44,22,24,46,61,93,-17,-2.5
1991,"Port Vale",2,46,45,42,59,-17,0.978260869565217,0.91304347826087,1.28260869565217,-0.369565217391304,46,24,24,46,49,107,-3,-1.2
1991,"Portsmouth",2,46,69,65,51,14,1.5,1.41304347826087,1.10869565217391,0.304347826086957,30,8,24,46,24,93,6,-0.7
1991,"Preston North End",3,46,57,61,72,-11,1.23913043478261,1.32608695652174,1.56521739130435,-0.239130434782609,63,17,24,70,67,121,-4,3.5
1991,"Queens Park Rangers",1,42,54,48,47,1,1.28571428571429,1.14285714285714,1.11904761904762,0.0238095238095238,11,11,22,22,5,93,6,-4.1
1991,"Reading",3,46,61,59,62,-3,1.32608695652174,1.28260869565217,1.34782608695652,-0.0652173913043478,58,12,24,70,55,93,3,1.2
1991,"Rochdale",4,42,67,57,53,4,1.5952380952381,1.35714285714286,1.26190476190476,0.0952380952380952,78,8,22,92,81,92,-3,0.5
1991,"Rotherham United",4,42,77,70,37,33,1.83333333333333,1.66666666666667,0.880952380952381,0.785714285714286,73,3,22,92,58,88,15,3.1
1991,"Scarborough",4,42,57,64,68,-4,1.35714285714286,1.52380952380952,1.61904761904762,-0.0952380952380952,82,12,22,92,83,12,-1,NA
1991,"Scunthorpe United",4,42,72,64,59,5,1.71428571428571,1.52380952380952,1.4047619047619,0.119047619047619,75,5,22,92,84,70,-9,-0.1
1991,"Sheffield United",1,42,57,65,63,2,1.35714285714286,1.54761904761905,1.5,0.0476190476190476,10,10,22,22,16,117,-6,-2.3
1991,"Sheffield Wednesday",1,42,75,62,49,13,1.78571428571429,1.47619047619048,1.16666666666667,0.30952380952381,3,3,22,22,7,117,-4,-3.7
1991,"Shrewsbury Town",3,46,47,53,68,-15,1.02173913043478,1.15217391304348,1.47826086956522,-0.326086956521739,68,22,24,70,79,69,-11,-0.9
1991,"Southampton",1,42,52,39,55,-16,1.23809523809524,0.928571428571429,1.30952380952381,-0.380952380952381,15,15,22,22,18,93,-3,0.3
1991,"Southend United",2,46,62,63,63,0,1.34782608695652,1.3695652173913,1.3695652173913,0,35,13,24,46,40,93,-5,-4.6
1991,"Stockport County",3,46,76,75,51,24,1.65217391304348,1.6304347826087,1.10869565217391,0.521739130434783,51,5,24,70,53,99,-2,0.7
1991,"Stoke City",3,46,77,69,49,20,1.67391304347826,1.5,1.06521739130435,0.434782608695652,50,4,24,70,47,113,3,0.1
1991,"Sunderland",2,46,53,61,65,-4,1.15217391304348,1.32608695652174,1.41304347826087,-0.0869565217391304,41,19,24,46,43,119,-2,2.4
1991,"Swansea City",3,46,56,55,65,-10,1.21739130434783,1.19565217391304,1.41304347826087,-0.217391304347826,65,19,24,70,51,93,14,-2.2
1991,"Swindon Town",2,46,69,69,55,14,1.5,1.5,1.19565217391304,0.304347826086957,31,9,24,46,28,93,3,-2.6
1991,"Torquay United",3,46,47,42,68,-26,1.02173913043478,0.91304347826087,1.47826086956522,-0.565217391304348,69,23,24,70,89,78,-20,-1.9
1991,"Tottenham Hotspur",1,42,52,58,63,-5,1.23809523809524,1.38095238095238,1.5,-0.119047619047619,16,16,22,22,8,101,8,0.7
1991,"Tranmere Rovers",2,46,61,56,56,0,1.32608695652174,1.21739130434783,1.21739130434783,0,37,15,24,46,26,89,11,-1.9
1991,"Walsall",4,42,49,48,58,-10,1.16666666666667,1.14285714285714,1.38095238095238,-0.238095238095238,85,15,22,92,75,100,10,4.7
1991,"Watford",2,46,65,51,48,3,1.41304347826087,1.10869565217391,1.04347826086957,0.0652173913043478,32,10,24,46,38,93,-6,-0.2
1991,"West Bromwich Albion",3,46,71,64,49,15,1.54347826086957,1.39130434782609,1.06521739130435,0.326086956521739,54,8,24,70,50,121,4,3.2
1991,"West Ham United",1,42,38,37,59,-22,0.904761904761905,0.880952380952381,1.4047619047619,-0.523809523809524,22,22,22,22,25,94,-3,1.5
1991,"Wigan Athletic",3,46,59,58,64,-6,1.28260869565217,1.26086956521739,1.39130434782609,-0.130434782608696,61,15,24,70,69,42,-8,0.7
1991,"Wimbledon",1,42,53,53,53,0,1.26190476190476,1.26190476190476,1.26190476190476,0,14,14,22,22,12,27,2,-1.5
1991,"Wolverhampton Wanderers",2,46,64,61,54,7,1.39130434782609,1.32608695652174,1.17391304347826,0.152173913043478,33,11,24,46,34,121,-1,1
1991,"Wrexham",4,42,51,52,73,-21,1.21428571428571,1.23809523809524,1.73809523809524,-0.5,84,14,22,92,72,80,12,1.7
1991,"York City",4,42,40,42,58,-16,0.952380952380952,1,1.38095238095238,-0.380952380952381,89,19,22,92,74,72,15,0.7
1992,"AFC Bournemouth",3,46,53,45,52,-7,1.15217391304348,0.978260869565217,1.1304347826087,-0.152173913043478,63,17,24,70,63,90,0,-0.9
1992,"Arsenal",1,42,56,40,38,2,1.33333333333333,0.952380952380952,0.904761904761905,0.0476190476190476,10,10,22,22,4,116,6,0.8
1992,"Aston Villa",1,42,74,57,40,17,1.76190476190476,1.35714285714286,0.952380952380952,0.404761904761905,2,2,22,22,10,121,-8,-1.4
1992,"Barnet",4,42,79,66,48,18,1.88095238095238,1.57142857142857,1.14285714285714,0.428571428571429,73,3,22,92,70,21,3,-0.9
1992,"Barnsley",2,46,60,56,60,-4,1.30434782608696,1.21739130434783,1.30434782608696,-0.0869565217391304,35,13,24,46,40,111,-5,-2.7
1992,"Birmingham City",2,46,51,50,72,-22,1.10869565217391,1.08695652173913,1.56521739130435,-0.478260869565217,41,19,24,46,43,117,-2,2.8
1992,"Blackburn Rovers",1,42,71,68,46,22,1.69047619047619,1.61904761904762,1.0952380952381,0.523809523809524,4,4,22,22,2,121,2,-0.2
1992,"Blackpool",3,46,51,63,75,-12,1.10869565217391,1.3695652173913,1.6304347826087,-0.260869565217391,64,18,24,70,66,112,-2,0.9
1992,"Bolton Wanderers",3,46,90,80,41,39,1.95652173913043,1.73913043478261,0.891304347826087,0.847826086956522,48,2,24,70,36,121,12,3.1
1992,"Bradford City",3,46,68,69,67,2,1.47826086956522,1.5,1.45652173913043,0.0434782608695652,56,10,24,70,53,106,3,1.8
1992,"Brentford",2,46,49,52,71,-19,1.06521739130435,1.1304347826087,1.54347826086957,-0.41304347826087,44,22,24,46,61,93,-17,-1.6
1992,"Brighton & Hove Albion",3,46,69,63,59,4,1.5,1.3695652173913,1.28260869565217,0.0869565217391304,54,8,24,70,60,93,-6,1.1
1992,"Bristol City",2,46,56,49,67,-18,1.21739130434783,1.06521739130435,1.45652173913043,-0.391304347826087,36,14,24,46,35,108,1,-1.1
1992,"Bristol Rovers",2,46,41,55,87,-32,0.891304347826087,1.19565217391304,1.89130434782609,-0.695652173913043,46,24,24,46,54,92,-8,-4.2
1992,"Burnley",3,46,61,57,59,-2,1.32608695652174,1.23913043478261,1.28260869565217,-0.0434782608695652,59,13,24,70,52,121,7,2.3
1992,"Bury",4,42,63,63,55,8,1.5,1.5,1.30952380952381,0.19047619047619,77,7,22,92,83,114,-6,0.3
1992,"Cambridge United",2,46,49,48,69,-21,1.06521739130435,1.04347826086957,1.5,-0.456521739130435,45,23,24,46,56,41,-11,-3.5
1992,"Cardiff City",4,42,83,77,47,30,1.97619047619048,1.83333333333333,1.11904761904762,0.714285714285714,71,1,22,92,65,93,6,2.1
1992,"Carlisle United",4,42,44,51,65,-14,1.04761904761905,1.21428571428571,1.54761904761905,-0.333333333333333,88,18,22,92,77,84,11,-0.1
1992,"Charlton Athletic",2,46,61,49,46,3,1.32608695652174,1.06521739130435,1,0.0652173913043478,33,11,24,46,33,92,0,2.2
1992,"Chelsea",1,42,56,51,54,-3,1.33333333333333,1.21428571428571,1.28571428571429,-0.0714285714285714,11,11,22,22,14,104,-3,0.7
1992,"Chester",3,46,29,49,102,-53,0.630434782608696,1.06521739130435,2.21739130434783,-1.15217391304348,70,24,24,70,72,67,-2,-1.6
1992,"Chesterfield",4,42,56,59,63,-4,1.33333333333333,1.4047619047619,1.5,-0.0952380952380952,82,12,22,92,78,100,4,1.8
1992,"Colchester United",4,42,59,67,76,-9,1.4047619047619,1.5952380952381,1.80952380952381,-0.214285714285714,80,10,22,92,87,68,-7,2.4
1992,"Coventry City",1,42,52,52,57,-5,1.23809523809524,1.23809523809524,1.35714285714286,-0.119047619047619,14,14,22,22,11,94,3,-2.6
1992,"Crewe Alexandra",4,42,70,75,56,19,1.66666666666667,1.78571428571429,1.33333333333333,0.452380952380952,76,6,22,92,73,96,3,3
1992,"Crystal Palace",1,42,49,48,61,-13,1.16666666666667,1.14285714285714,1.45238095238095,-0.30952380952381,19,19,22,22,23,93,-4,-1.5
1992,"Darlington",4,42,50,48,53,-5,1.19047619047619,1.14285714285714,1.26190476190476,-0.119047619047619,85,15,22,92,91,81,-6,0.2
1992,"Derby County",2,46,66,68,57,11,1.43478260869565,1.47826086956522,1.23913043478261,0.239130434782609,30,8,24,46,28,121,2,-0.9
1992,"Doncaster Rovers",4,42,47,42,57,-15,1.11904761904762,1,1.35714285714286,-0.357142857142857,86,16,22,92,85,88,1,3.7
1992,"Everton",1,42,53,53,55,-2,1.26190476190476,1.26190476190476,1.30952380952381,-0.0476190476190476,13,13,22,22,17,121,-4,0.6
1992,"Exeter City",3,46,50,54,69,-15,1.08695652173913,1.17391304347826,1.5,-0.326086956521739,65,19,24,70,68,88,-3,-2.6
1992,"Fulham",3,46,65,57,55,2,1.41304347826087,1.23913043478261,1.19565217391304,0.0434782608695652,57,11,24,70,67,102,-10,4.3
1992,"Gillingham",4,42,40,48,64,-16,0.952380952380952,1.14285714285714,1.52380952380952,-0.380952380952381,91,21,22,92,86,88,5,6
1992,"Grimsby Town",2,46,64,58,57,1,1.39130434782609,1.26086956521739,1.23913043478261,0.0217391304347826,31,9,24,46,37,110,-6,-1.3
1992,"Halifax Town",4,42,36,45,68,-23,0.857142857142857,1.07142857142857,1.61904761904762,-0.547619047619048,92,22,22,92,77,69,15,NA
1992,"Hartlepool United",3,46,54,42,60,-18,1.17391304347826,0.91304347826087,1.30434782608696,-0.391304347826087,62,16,24,70,69,89,-7,-0.8
1992,"Hereford United",4,42,45,47,60,-13,1.07142857142857,1.11904761904762,1.42857142857143,-0.30952380952381,87,17,22,92,90,31,-3,-0.4
1992,"Huddersfield Town",3,46,60,54,61,-7,1.30434782608696,1.17391304347826,1.32608695652174,-0.152173913043478,60,14,24,70,57,99,3,-0.6
1992,"Hull City",3,46,50,46,69,-23,1.08695652173913,1,1.5,-0.5,66,20,24,70,55,104,11,-1.5
1992,"Ipswich Town",1,42,52,50,55,-5,1.23809523809524,1.19047619047619,1.30952380952381,-0.119047619047619,15,15,22,22,18,75,-3,-1.2
1992,"Leeds United",1,42,51,57,62,-5,1.21428571428571,1.35714285714286,1.47619047619048,-0.119047619047619,17,17,22,22,5,93,12,0.2
1992,"Leicester City",2,46,76,71,64,7,1.65217391304348,1.54347826086957,1.39130434782609,0.152173913043478,27,5,24,46,26,115,1,0.5
1992,"Leyton Orient",3,46,72,69,53,16,1.56521739130435,1.5,1.15217391304348,0.347826086956522,52,6,24,70,64,102,-12,-3.4
1992,"Lincoln City",4,42,63,57,53,4,1.5,1.35714285714286,1.26190476190476,0.0952380952380952,78,8,22,92,88,107,-10,0.3
1992,"Liverpool",1,42,59,62,55,7,1.4047619047619,1.47619047619048,1.30952380952381,0.166666666666667,6,6,22,22,8,116,-2,0.1
1992,"Luton Town",2,46,51,48,62,-14,1.10869565217391,1.04347826086957,1.34782608695652,-0.304347826086957,42,20,24,46,42,91,0,-1
1992,"Manchester City",1,42,57,56,51,5,1.35714285714286,1.33333333333333,1.21428571428571,0.119047619047619,9,9,22,22,15,117,-6,0
1992,"Manchester United",1,42,84,67,31,36,2,1.5952380952381,0.738095238095238,0.857142857142857,1,1,22,22,1,117,0,0
1992,"Mansfield Town",3,46,44,52,80,-28,0.956521739130435,1.1304347826087,1.73913043478261,-0.608695652173913,68,22,24,70,82,77,-14,0.1
1992,"Middlesbrough",1,42,44,54,75,-21,1.04761904761905,1.28571428571429,1.78571428571429,-0.5,21,21,22,22,31,110,-10,0.9
1992,"Millwall",2,46,70,65,53,12,1.52173913043478,1.41304347826087,1.15217391304348,0.260869565217391,29,7,24,46,25,93,4,0
1992,"Newcastle United",2,46,96,92,38,54,2.08695652173913,2,0.826086956521739,1.17391304347826,23,1,24,46,3,116,20,2
1992,"Northampton Town",4,42,41,48,74,-26,0.976190476190476,1.14285714285714,1.76190476190476,-0.619047619047619,90,20,22,92,92,93,-2,2.2
1992,"Norwich City",1,42,72,61,65,-4,1.71428571428571,1.45238095238095,1.54761904761905,-0.0952380952380952,3,3,22,22,12,93,-9,-2.5
1992,"Nottingham Forest",1,42,40,41,62,-21,0.952380952380952,0.976190476190476,1.47619047619048,-0.5,22,22,22,22,24,117,-2,-0.4
1992,"Notts County",2,46,52,55,70,-15,1.1304347826087,1.19565217391304,1.52173913043478,-0.326086956521739,39,17,24,46,29,120,10,-1.9
1992,"Oldham Athletic",1,42,49,63,74,-11,1.16666666666667,1.5,1.76190476190476,-0.261904761904762,20,20,22,22,21,102,-1,-2.9
1992,"Oxford United",2,46,56,53,56,-3,1.21739130434783,1.15217391304348,1.21739130434783,-0.0652173913043478,37,15,24,46,45,54,-8,-3.9
1992,"Peterborough United",2,46,62,55,63,-8,1.34782608695652,1.19565217391304,1.3695652173913,-0.173913043478261,32,10,24,46,46,60,-14,-2.5
1992,"Plymouth Argyle",3,46,60,59,64,-5,1.30434782608696,1.28260869565217,1.39130434782609,-0.108695652173913,61,15,24,70,49,93,12,0.8
1992,"Port Vale",3,46,89,79,44,35,1.93478260869565,1.71739130434783,0.956521739130435,0.760869565217391,49,3,24,70,48,107,1,-1.2
1992,"Portsmouth",2,46,88,80,46,34,1.91304347826087,1.73913043478261,1,0.739130434782609,24,2,24,46,39,93,-15,0.3
1992,"Preston North End",3,46,47,65,94,-29,1.02173913043478,1.41304347826087,2.04347826086957,-0.630434782608696,67,21,24,70,75,121,-8,3.5
1992,"Queens Park Rangers",1,42,63,63,55,8,1.5,1.5,1.30952380952381,0.19047619047619,5,5,22,22,9,93,-4,-4.3
1992,"Reading",3,46,69,66,51,15,1.5,1.43478260869565,1.10869565217391,0.326086956521739,55,9,24,70,47,93,8,3.1
1992,"Rochdale",4,42,58,70,70,0,1.38095238095238,1.66666666666667,1.66666666666667,0,81,11,22,92,79,92,2,-0.6
1992,"Rotherham United",3,46,65,60,60,0,1.41304347826087,1.30434782608696,1.30434782608696,0,58,12,24,70,62,88,-4,2.3
1992,"Scarborough",4,42,54,66,71,-5,1.28571428571429,1.57142857142857,1.69047619047619,-0.119047619047619,83,13,22,92,84,12,-1,NA
1992,"Scunthorpe United",4,42,54,57,54,3,1.28571428571429,1.35714285714286,1.28571428571429,0.0714285714285714,84,14,22,92,81,70,3,1.1
1992,"Sheffield United",1,42,52,54,53,1,1.23809523809524,1.28571428571429,1.26190476190476,0.0238095238095238,16,16,22,22,20,117,-4,-0.7
1992,"Sheffield Wednesday",1,42,59,55,51,4,1.4047619047619,1.30952380952381,1.21428571428571,0.0952380952380952,7,7,22,22,7,117,0,-3.5
1992,"Shrewsbury Town",4,42,62,57,52,5,1.47619047619048,1.35714285714286,1.23809523809524,0.119047619047619,79,9,22,92,71,69,8,-1.3
1992,"Southampton",1,42,50,54,61,-7,1.19047619047619,1.28571428571429,1.45238095238095,-0.166666666666667,18,18,22,22,19,93,-1,1
1992,"Southend United",2,46,52,54,64,-10,1.1304347826087,1.17391304347826,1.39130434782609,-0.217391304347826,40,18,24,46,38,93,2,-4.5
1992,"Stockport County",3,46,72,81,57,24,1.56521739130435,1.76086956521739,1.23913043478261,0.521739130434783,53,7,24,70,50,99,3,-0.6
1992,"Stoke City",3,46,93,73,34,39,2.02173913043478,1.58695652173913,0.739130434782609,0.847826086956522,47,1,24,70,32,113,15,0.6
1992,"Sunderland",2,46,50,50,64,-14,1.08695652173913,1.08695652173913,1.39130434782609,-0.304347826086957,43,21,24,46,34,119,9,2.3
1992,"Swansea City",3,46,73,65,47,18,1.58695652173913,1.41304347826087,1.02173913043478,0.391304347826087,51,5,24,70,59,93,-8,-3.9
1992,"Swindon Town",2,46,76,74,59,15,1.65217391304348,1.60869565217391,1.28260869565217,0.326086956521739,28,6,24,46,22,93,6,-2.6
1992,"Torquay United",4,42,43,45,67,-22,1.02380952380952,1.07142857142857,1.5952380952381,-0.523809523809524,89,19,22,92,76,78,13,1.2
1992,"Tottenham Hotspur",1,42,59,60,66,-6,1.4047619047619,1.42857142857143,1.57142857142857,-0.142857142857143,8,8,22,22,16,101,-8,-0.2
1992,"Tranmere Rovers",2,46,79,72,56,16,1.71739130434783,1.56521739130435,1.21739130434783,0.347826086956522,26,4,24,46,27,89,-1,-2.5
1992,"Walsall",4,42,73,76,61,15,1.73809523809524,1.80952380952381,1.45238095238095,0.357142857142857,75,5,22,92,80,100,-5,3.8
1992,"Watford",2,46,55,57,71,-14,1.19565217391304,1.23913043478261,1.54347826086957,-0.304347826086957,38,16,24,46,41,93,-3,0.5
1992,"West Bromwich Albion",3,46,85,88,54,34,1.84782608695652,1.91304347826087,1.17391304347826,0.739130434782609,50,4,24,70,44,121,6,3.1
1992,"West Ham United",2,46,88,81,41,40,1.91304347826087,1.76086956521739,0.891304347826087,0.869565217391304,25,3,24,46,13,94,12,0.7
1992,"Wigan Athletic",3,46,41,43,72,-29,0.891304347826087,0.934782608695652,1.56521739130435,-0.630434782608696,69,23,24,70,89,42,-20,2.4
1992,"Wimbledon",1,42,54,56,55,1,1.28571428571429,1.33333333333333,1.30952380952381,0.0238095238095238,12,12,22,22,6,27,6,-1.8
1992,"Wolverhampton Wanderers",2,46,61,57,56,1,1.32608695652174,1.23913043478261,1.21739130434783,0.0217391304347826,34,12,24,46,30,121,4,0.9
1992,"Wrexham",4,42,80,75,52,23,1.9047619047619,1.78571428571429,1.23809523809524,0.547619047619048,72,2,22,92,58,80,14,0.1
1992,"York City",4,42,75,72,45,27,1.78571428571429,1.71428571428571,1.07142857142857,0.642857142857143,74,4,22,92,51,72,23,-0.4
1993,"AFC Bournemouth",3,46,57,51,59,-8,1.23913043478261,1.10869565217391,1.28260869565217,-0.173913043478261,63,17,24,70,65,90,-2,1
1993,"Arsenal",1,42,71,53,28,25,1.69047619047619,1.26190476190476,0.666666666666667,0.595238095238095,4,4,22,22,12,116,-8,0.3
1993,"Aston Villa",1,42,57,46,50,-4,1.35714285714286,1.0952380952381,1.19047619047619,-0.0952380952380952,10,10,22,22,18,121,-8,0.5
1993,"Barnet",3,46,28,41,86,-45,0.608695652173913,0.891304347826087,1.8695652173913,-0.978260869565217,70,24,24,70,81,21,-11,-0.9
1993,"Barnsley",2,46,55,55,67,-12,1.19565217391304,1.19565217391304,1.45652173913043,-0.260869565217391,40,18,24,46,28,111,12,-1.6
1993,"Birmingham City",2,46,51,52,69,-17,1.10869565217391,1.1304347826087,1.5,-0.369565217391304,43,21,24,46,47,117,-4,3.3
1993,"Blackburn Rovers",1,42,84,63,36,27,2,1.5,0.857142857142857,0.642857142857143,2,2,22,22,1,121,1,-1.3
1993,"Blackpool",3,46,53,63,75,-12,1.15217391304348,1.3695652173913,1.6304347826087,-0.260869565217391,66,20,24,70,58,112,8,0.8
1993,"Bolton Wanderers",2,46,59,63,64,-1,1.28260869565217,1.3695652173913,1.39130434782609,-0.0217391304347826,36,14,24,46,25,121,11,2.9
1993,"Bradford City",3,46,70,61,53,8,1.52173913043478,1.32608695652174,1.15217391304348,0.173913043478261,53,7,24,70,60,106,-7,1
1993,"Brentford",3,46,58,57,55,2,1.26086956521739,1.23913043478261,1.19565217391304,0.0434782608695652,61,15,24,70,48,93,13,0.1
1993,"Brighton & Hove Albion",3,46,59,60,67,-7,1.28260869565217,1.30434782608696,1.45652173913043,-0.152173913043478,60,14,24,70,62,93,-2,1.2
1993,"Bristol City",2,46,64,47,50,-3,1.39130434782609,1.02173913043478,1.08695652173913,-0.0652173913043478,35,13,24,46,45,108,-10,-1.2
1993,"Bristol Rovers",3,46,70,60,59,1,1.52173913043478,1.30434782608696,1.28260869565217,0.0217391304347826,54,8,24,70,50,92,4,-2.9
1993,"Burnley",3,46,73,79,58,21,1.58695652173913,1.71739130434783,1.26086956521739,0.456521739130435,52,6,24,70,44,121,8,1.4
1993,"Bury",4,42,53,55,56,-1,1.26190476190476,1.30952380952381,1.33333333333333,-0.0238095238095238,83,13,22,92,74,114,9,0.3
1993,"Cambridge United",3,46,66,79,73,6,1.43478260869565,1.71739130434783,1.58695652173913,0.130434782608696,56,10,24,70,66,41,-10,-2.5
1993,"Cardiff City",3,46,54,66,79,-13,1.17391304347826,1.43478260869565,1.71739130434783,-0.282608695652174,65,19,24,70,68,93,-3,3.3
1993,"Carlisle United",4,42,64,57,42,15,1.52380952380952,1.35714285714286,1,0.357142857142857,77,7,22,92,71,84,6,-1.4
1993,"Charlton Athletic",2,46,65,61,58,3,1.41304347826087,1.32608695652174,1.26086956521739,0.0652173913043478,33,11,24,46,37,92,-4,2.5
1993,"Chelsea",1,42,51,49,53,-4,1.21428571428571,1.16666666666667,1.26190476190476,-0.0952380952380952,14,14,22,22,10,104,4,1.2
1993,"Chester",4,42,74,69,46,23,1.76190476190476,1.64285714285714,1.0952380952381,0.547619047619048,72,2,22,92,69,67,3,-1.8
1993,"Chesterfield",4,42,62,55,48,7,1.47619047619048,1.30952380952381,1.14285714285714,0.166666666666667,78,8,22,92,73,100,5,1.4
1993,"Colchester United",4,42,49,56,71,-15,1.16666666666667,1.33333333333333,1.69047619047619,-0.357142857142857,87,17,22,92,80,68,7,3.2
1993,"Coventry City",1,42,56,43,45,-2,1.33333333333333,1.02380952380952,1.07142857142857,-0.0476190476190476,11,11,22,22,14,94,-3,-2.2
1993,"Crewe Alexandra",4,42,73,80,61,19,1.73809523809524,1.9047619047619,1.45238095238095,0.452380952380952,73,3,22,92,49,96,24,3.4
1993,"Crystal Palace",2,46,90,73,46,27,1.95652173913043,1.58695652173913,1,0.58695652173913,23,1,24,46,19,93,4,-0.2
1993,"Darlington",4,42,41,42,64,-22,0.976190476190476,1,1.52380952380952,-0.523809523809524,91,21,22,92,89,81,2,0.5
1993,"Derby County",2,46,71,73,68,5,1.54347826086957,1.58695652173913,1.47826086956522,0.108695652173913,28,6,24,46,31,121,-3,-1.2
1993,"Doncaster Rovers",4,42,52,44,57,-13,1.23809523809524,1.04761904761905,1.35714285714286,-0.30952380952381,85,15,22,92,79,88,6,5.2
1993,"Everton",1,42,44,42,63,-21,1.04761904761905,1,1.5,-0.5,17,17,22,22,15,121,2,0
1993,"Exeter City",3,46,45,52,83,-31,0.978260869565217,1.1304347826087,1.80434782608696,-0.673913043478261,68,22,24,70,91,88,-23,-0.2
1993,"Fulham",3,46,52,50,63,-13,1.1304347826087,1.08695652173913,1.3695652173913,-0.282608695652174,67,21,24,70,77,102,-10,5.8
1993,"Gillingham",4,42,51,44,51,-7,1.21428571428571,1.04761904761905,1.21428571428571,-0.166666666666667,86,16,22,92,90,88,-4,4.5
1993,"Grimsby Town",2,46,59,52,47,5,1.28260869565217,1.1304347826087,1.02173913043478,0.108695652173913,37,15,24,46,32,110,5,-2.8
1993,"Hartlepool United",3,46,36,41,87,-46,0.782608695652174,0.891304347826087,1.89130434782609,-1,69,23,24,70,88,89,-19,2
1993,"Hereford United",4,42,42,60,79,-19,1,1.42857142857143,1.88095238095238,-0.452380952380952,90,20,22,92,86,31,4,NA
1993,"Huddersfield Town",3,46,65,58,61,-3,1.41304347826087,1.26086956521739,1.32608695652174,-0.0652173913043478,57,11,24,70,51,99,6,-1.4
1993,"Hull City",3,46,68,62,54,8,1.47826086956522,1.34782608695652,1.17391304347826,0.173913043478261,55,9,24,70,54,104,1,-1.5
1993,"Ipswich Town",1,42,43,35,58,-23,1.02380952380952,0.833333333333333,1.38095238095238,-0.547619047619048,18,18,22,22,22,75,-4,-0.8
1993,"Leeds United",1,42,70,65,39,26,1.66666666666667,1.54761904761905,0.928571428571429,0.619047619047619,5,5,22,22,5,93,0,-1.3
1993,"Leicester City",2,46,73,72,59,13,1.58695652173913,1.56521739130435,1.28260869565217,0.282608695652174,26,4,24,46,21,115,5,0.7
1993,"Leyton Orient",3,46,56,57,71,-14,1.21739130434783,1.23913043478261,1.54347826086957,-0.304347826086957,64,18,24,70,70,102,-6,-2.3
1993,"Lincoln City",4,42,47,52,63,-11,1.11904761904762,1.23809523809524,1.5,-0.261904761904762,88,18,22,92,82,107,6,1.3
1993,"Liverpool",1,42,60,59,55,4,1.42857142857143,1.4047619047619,1.30952380952381,0.0952380952380952,8,8,22,22,4,116,4,0.4
1993,"Luton Town",2,46,53,56,60,-4,1.15217391304348,1.21739130434783,1.30434782608696,-0.0869565217391304,42,20,24,46,38,91,4,-1.2
1993,"Manchester City",1,42,45,38,49,-11,1.07142857142857,0.904761904761905,1.16666666666667,-0.261904761904762,15,15,22,22,17,117,-2,-0.1
1993,"Manchester United",1,42,92,80,38,42,2.19047619047619,1.9047619047619,0.904761904761905,1,1,1,22,22,2,117,-1,-0.2
1993,"Mansfield Town",4,42,55,53,62,-9,1.30952380952381,1.26190476190476,1.47619047619048,-0.214285714285714,82,12,22,92,76,77,6,0.9
1993,"Middlesbrough",2,46,67,66,54,12,1.45652173913043,1.43478260869565,1.17391304347826,0.260869565217391,31,9,24,46,23,110,8,2
1993,"Millwall",2,46,74,58,49,9,1.60869565217391,1.26086956521739,1.06521739130435,0.195652173913043,25,3,24,46,34,93,-9,-0.5
1993,"Newcastle United",1,42,77,82,41,41,1.83333333333333,1.95238095238095,0.976190476190476,0.976190476190476,3,3,22,22,6,116,-3,-0.3
1993,"Northampton Town",4,42,38,44,66,-22,0.904761904761905,1.04761904761905,1.57142857142857,-0.523809523809524,92,22,22,92,87,93,5,1.8
1993,"Norwich City",1,42,53,65,61,4,1.26190476190476,1.54761904761905,1.45238095238095,0.0952380952380952,12,12,22,22,20,93,-8,-0.9
1993,"Nottingham Forest",2,46,83,74,49,25,1.80434782608696,1.60869565217391,1.06521739130435,0.543478260869565,24,2,24,46,3,117,21,-1
1993,"Notts County",2,46,68,65,69,-4,1.47826086956522,1.41304347826087,1.5,-0.0869565217391304,29,7,24,46,46,120,-17,-3.8
1993,"Oldham Athletic",1,42,40,42,68,-26,0.952380952380952,1,1.61904761904762,-0.619047619047619,21,21,22,22,36,102,-15,-3.8
1993,"Oxford United",2,46,49,54,75,-21,1.06521739130435,1.17391304347826,1.6304347826087,-0.456521739130435,45,23,24,46,53,54,-8,-3.2
1993,"Peterborough United",2,46,37,48,76,-28,0.804347826086957,1.04347826086957,1.65217391304348,-0.608695652173913,46,24,24,46,61,60,-15,-1.6
1993,"Plymouth Argyle",3,46,85,88,56,32,1.84782608695652,1.91304347826087,1.21739130434783,0.695652173913043,49,3,24,70,67,93,-18,0.4
1993,"Port Vale",3,46,88,79,46,33,1.91304347826087,1.71739130434783,1,0.717391304347826,48,2,24,70,39,107,9,-0.2
1993,"Portsmouth",2,46,58,52,58,-6,1.26086956521739,1.1304347826087,1.26086956521739,-0.130434782608696,39,17,24,46,40,93,-1,2.6
1993,"Preston North End",4,42,67,79,60,19,1.5952380952381,1.88095238095238,1.42857142857143,0.452380952380952,75,5,22,92,75,121,0,4
1993,"Queens Park Rangers",1,42,60,62,61,1,1.42857142857143,1.47619047619048,1.45238095238095,0.0238095238095238,9,9,22,22,8,93,1,-3.7
1993,"Reading",3,46,89,81,44,37,1.93478260869565,1.76086956521739,0.956521739130435,0.804347826086957,47,1,24,70,24,93,23,1.8
1993,"Rochdale",4,42,60,63,51,12,1.42857142857143,1.5,1.21428571428571,0.285714285714286,79,9,22,92,85,92,-6,-1
1993,"Rotherham United",3,46,58,63,60,3,1.26086956521739,1.3695652173913,1.30434782608696,0.0652173913043478,62,16,24,70,63,88,-1,2.5
1993,"Scarborough",4,42,53,55,61,-6,1.26190476190476,1.30952380952381,1.45238095238095,-0.142857142857143,84,14,22,92,92,12,-8,NA
1993,"Scunthorpe United",4,42,59,64,56,8,1.4047619047619,1.52380952380952,1.33333333333333,0.19047619047619,81,11,22,92,78,70,3,-0.9
1993,"Sheffield United",1,42,42,42,60,-18,1,1,1.42857142857143,-0.428571428571429,20,20,22,22,30,117,-10,-0.7
1993,"Sheffield Wednesday",1,42,64,76,54,22,1.52380952380952,1.80952380952381,1.28571428571429,0.523809523809524,7,7,22,22,13,117,-6,-5.4
1993,"Shrewsbury Town",4,42,79,63,39,24,1.88095238095238,1.5,0.928571428571429,0.571428571428571,71,1,22,92,64,69,7,-1.8
1993,"Southampton",1,42,43,49,66,-17,1.02380952380952,1.16666666666667,1.57142857142857,-0.404761904761905,19,19,22,22,11,93,8,0.7
1993,"Southend United",2,46,59,63,67,-4,1.28260869565217,1.3695652173913,1.45652173913043,-0.0869565217391304,38,16,24,46,35,93,3,-4.7
1993,"Stockport County",3,46,85,74,44,30,1.84782608695652,1.60869565217391,0.956521739130435,0.652173913043478,50,4,24,70,57,99,-7,-1.3
1993,"Stoke City",2,46,67,57,59,-2,1.45652173913043,1.23913043478261,1.28260869565217,-0.0434782608695652,32,10,24,46,33,113,-1,0.1
1993,"Sunderland",2,46,65,54,57,-3,1.41304347826087,1.17391304347826,1.23913043478261,-0.0652173913043478,34,12,24,46,42,119,-8,1.1
1993,"Swansea City",3,46,60,56,58,-2,1.30434782608696,1.21739130434783,1.26086956521739,-0.0434782608695652,59,13,24,70,56,93,3,-2
1993,"Swindon Town",1,42,30,47,100,-53,0.714285714285714,1.11904761904762,2.38095238095238,-1.26190476190476,22,22,22,22,43,93,-21,-2.9
1993,"Torquay United",4,42,67,64,56,8,1.5952380952381,1.52380952380952,1.33333333333333,0.19047619047619,76,6,22,92,83,78,-7,0.4
1993,"Tottenham Hotspur",1,42,45,54,59,-5,1.07142857142857,1.28571428571429,1.4047619047619,-0.119047619047619,16,16,22,22,7,101,9,0.2
1993,"Tranmere Rovers",2,46,72,69,53,16,1.56521739130435,1.5,1.15217391304348,0.347826086956522,27,5,24,46,26,89,1,-2.5
1993,"Walsall",4,42,60,48,53,-5,1.42857142857143,1.14285714285714,1.26190476190476,-0.119047619047619,80,10,22,92,72,100,8,3.8
1993,"Watford",2,46,54,66,80,-14,1.17391304347826,1.43478260869565,1.73913043478261,-0.304347826086957,41,19,24,46,29,93,12,0.5
1993,"West Bromwich Albion",2,46,51,60,69,-9,1.10869565217391,1.30434782608696,1.5,-0.195652173913043,44,22,24,46,41,121,3,2.2
1993,"West Ham United",1,42,52,47,58,-11,1.23809523809524,1.11904761904762,1.38095238095238,-0.261904761904762,13,13,22,22,16,94,-3,-1.1
1993,"Wigan Athletic",4,42,45,51,70,-19,1.07142857142857,1.21428571428571,1.66666666666667,-0.452380952380952,89,19,22,92,84,42,5,6.1
1993,"Wimbledon",1,42,65,56,53,3,1.54761904761905,1.33333333333333,1.26190476190476,0.0714285714285714,6,6,22,22,9,27,-3,-3.8
1993,"Wolverhampton Wanderers",2,46,68,60,47,13,1.47826086956522,1.30434782608696,1.02173913043478,0.282608695652174,30,8,24,46,27,121,3,1
1993,"Wrexham",3,46,62,66,77,-11,1.34782608695652,1.43478260869565,1.67391304347826,-0.239130434782609,58,12,24,70,59,80,-1,0.1
1993,"Wycombe Wanderers",4,42,70,67,53,14,1.66666666666667,1.5952380952381,1.26190476190476,0.333333333333333,74,4,22,92,52,27,22,0.6
1993,"York City",3,46,75,64,40,24,1.6304347826087,1.39130434782609,0.869565217391304,0.521739130434783,51,5,24,70,55,72,-4,-4.1
1994,"AFC Bournemouth",3,46,50,49,69,-20,1.08695652173913,1.06521739130435,1.5,-0.434782608695652,65,19,24,70,58,90,7,1.4
1994,"Arsenal",1,42,51,52,49,3,1.21428571428571,1.23809523809524,1.16666666666667,0.0714285714285714,12,12,22,22,4,116,8,1
1994,"Aston Villa",1,42,48,51,56,-5,1.14285714285714,1.21428571428571,1.33333333333333,-0.119047619047619,18,18,22,22,5,121,13,0.8
1994,"Barnet",4,42,56,56,63,-7,1.33333333333333,1.33333333333333,1.5,-0.166666666666667,81,11,22,92,76,21,5,-0.6
1994,"Barnsley",2,46,72,63,52,11,1.56521739130435,1.3695652173913,1.1304347826087,0.239130434782609,28,6,24,46,30,111,-2,-2.9
1994,"Birmingham City",3,46,89,84,37,47,1.93478260869565,1.82608695652174,0.804347826086957,1.02173913043478,47,1,24,70,35,117,12,3.5
1994,"Blackburn Rovers",1,42,89,80,39,41,2.11904761904762,1.9047619047619,0.928571428571429,0.976190476190476,1,1,22,22,6,121,-5,-1.4
1994,"Blackpool",3,46,64,64,69,-5,1.39130434782609,1.39130434782609,1.5,-0.108695652173913,58,12,24,70,47,112,11,-0.2
1994,"Bolton Wanderers",2,46,77,67,45,22,1.67391304347826,1.45652173913043,0.978260869565217,0.478260869565217,25,3,24,46,20,121,5,2
1994,"Bradford City",3,46,60,57,64,-7,1.30434782608696,1.23913043478261,1.39130434782609,-0.152173913043478,60,14,24,70,49,106,11,0.5
1994,"Brentford",3,46,85,81,39,42,1.84782608695652,1.76086956521739,0.847826086956522,0.91304347826087,48,2,24,70,59,93,-11,0
1994,"Brighton & Hove Albion",3,46,59,54,53,1,1.28260869565217,1.17391304347826,1.15217391304348,0.0217391304347826,62,16,24,70,67,93,-5,2.2
1994,"Bristol City",2,46,45,42,63,-21,0.978260869565217,0.91304347826087,1.3695652173913,-0.456521739130435,45,23,24,46,56,108,-11,-0.7
1994,"Bristol Rovers",3,46,82,70,40,30,1.78260869565217,1.52173913043478,0.869565217391304,0.652173913043478,50,4,24,70,52,92,-2,-3
1994,"Burnley",2,46,46,49,74,-25,1,1.06521739130435,1.60869565217391,-0.543478260869565,44,22,24,46,61,121,-17,1.1
1994,"Bury",4,42,80,73,36,37,1.9047619047619,1.73809523809524,0.857142857142857,0.880952380952381,74,4,22,92,71,114,3,-1.1
1994,"Cambridge United",3,46,48,52,69,-17,1.04347826086957,1.1304347826087,1.5,-0.369565217391304,66,20,24,70,84,41,-18,-2.5
1994,"Cardiff City",3,46,38,46,74,-28,0.826086956521739,1,1.60869565217391,-0.608695652173913,68,22,24,70,90,93,-22,3.2
1994,"Carlisle United",4,42,91,67,31,36,2.16666666666667,1.5952380952381,0.738095238095238,0.857142857142857,71,1,22,92,65,84,6,0.2
1994,"Charlton Athletic",2,46,59,58,66,-8,1.28260869565217,1.26086956521739,1.43478260869565,-0.173913043478261,37,15,24,46,25,92,12,2.6
1994,"Chelsea",1,42,54,50,55,-5,1.28571428571429,1.19047619047619,1.30952380952381,-0.119047619047619,10,10,22,22,11,104,-1,0.9
1994,"Chester",3,46,29,37,84,-47,0.630434782608696,0.804347826086957,1.82608695652174,-1.02173913043478,69,23,24,70,77,67,-8,-2.3
1994,"Chesterfield",4,42,81,62,37,25,1.92857142857143,1.47619047619048,0.880952380952381,0.595238095238095,73,3,22,92,51,100,22,1.2
1994,"Colchester United",4,42,58,56,64,-8,1.38095238095238,1.33333333333333,1.52380952380952,-0.19047619047619,80,10,22,92,75,68,5,2.1
1994,"Coventry City",1,42,50,44,62,-18,1.19047619047619,1.04761904761905,1.47619047619048,-0.428571428571429,14,14,22,22,16,94,-2,-2.4
1994,"Crewe Alexandra",3,46,83,80,68,12,1.80434782608696,1.73913043478261,1.47826086956522,0.260869565217391,49,3,24,70,50,96,-1,0.8
1994,"Crystal Palace",1,42,45,34,49,-15,1.07142857142857,0.80952380952381,1.16666666666667,-0.357142857142857,19,19,22,22,23,93,-4,0.1
1994,"Darlington",4,42,41,43,57,-14,0.976190476190476,1.02380952380952,1.35714285714286,-0.333333333333333,89,19,22,92,72,81,17,1.5
1994,"Derby County",2,46,66,66,51,15,1.43478260869565,1.43478260869565,1.10869565217391,0.326086956521739,31,9,24,46,22,121,9,0.7
1994,"Doncaster Rovers",4,42,61,58,43,15,1.45238095238095,1.38095238095238,1.02380952380952,0.357142857142857,79,9,22,92,81,88,-2,4.7
1994,"Everton",1,42,50,44,51,-7,1.19047619047619,1.04761904761905,1.21428571428571,-0.166666666666667,15,15,22,22,7,121,8,1.1
1994,"Exeter City",4,42,34,36,70,-34,0.80952380952381,0.857142857142857,1.66666666666667,-0.80952380952381,91,21,22,92,82,88,9,2.9
1994,"Fulham",4,42,62,60,54,6,1.47619047619048,1.42857142857143,1.28571428571429,0.142857142857143,77,7,22,92,85,102,-8,6.4
1994,"Gillingham",4,42,41,46,64,-18,0.976190476190476,1.0952380952381,1.52380952380952,-0.428571428571429,90,20,22,92,70,88,20,4.8
1994,"Grimsby Town",2,46,65,62,56,6,1.41304347826087,1.34782608695652,1.21739130434783,0.130434782608696,32,10,24,46,37,110,-5,-5.4
1994,"Hartlepool United",4,42,43,43,69,-26,1.02380952380952,1.02380952380952,1.64285714285714,-0.619047619047619,88,18,22,92,88,89,0,3.8
1994,"Hereford United",4,42,49,45,62,-17,1.16666666666667,1.07142857142857,1.47619047619048,-0.404761904761905,86,16,22,92,74,31,12,NA
1994,"Huddersfield Town",3,46,81,79,49,30,1.76086956521739,1.71739130434783,1.06521739130435,0.652173913043478,51,5,24,70,28,99,23,-0.2
1994,"Hull City",3,46,74,70,57,13,1.60869565217391,1.52173913043478,1.23913043478261,0.282608695652174,54,8,24,70,68,104,-14,0.8
1994,"Ipswich Town",1,42,27,36,93,-57,0.642857142857143,0.857142857142857,2.21428571428571,-1.35714285714286,22,22,22,22,27,75,-5,-0.1
1994,"Leeds United",1,42,73,59,38,21,1.73809523809524,1.4047619047619,0.904761904761905,0.5,5,5,22,22,12,93,-7,-2.9
1994,"Leicester City",1,42,29,45,80,-35,0.69047619047619,1.07142857142857,1.9047619047619,-0.833333333333333,21,21,22,22,26,115,-5,-1.4
1994,"Leyton Orient",3,46,26,30,75,-45,0.565217391304348,0.652173913043478,1.6304347826087,-0.978260869565217,70,24,24,70,89,102,-19,-0.9
1994,"Lincoln City",4,42,56,54,55,-1,1.33333333333333,1.28571428571429,1.30952380952381,-0.0238095238095238,82,12,22,92,86,107,-4,0.7
1994,"Liverpool",1,42,74,65,37,28,1.76190476190476,1.54761904761905,0.880952380952381,0.666666666666667,4,4,22,22,3,116,1,-0.2
1994,"Luton Town",2,46,58,61,64,-3,1.26086956521739,1.32608695652174,1.39130434782609,-0.0652173913043478,38,16,24,46,44,91,-6,-0.7
1994,"Manchester City",1,42,49,53,64,-11,1.16666666666667,1.26190476190476,1.52380952380952,-0.261904761904762,17,17,22,22,17,117,0,0.9
1994,"Manchester United",1,42,88,77,28,49,2.0952380952381,1.83333333333333,0.666666666666667,1.16666666666667,2,2,22,22,1,117,1,-0.1
1994,"Mansfield Town",4,42,65,84,59,25,1.54761904761905,2,1.4047619047619,0.595238095238095,76,6,22,92,87,77,-11,-0.6
1994,"Middlesbrough",2,46,82,67,40,27,1.78260869565217,1.45652173913043,0.869565217391304,0.58695652173913,23,1,24,46,13,110,10,1.6
1994,"Millwall",2,46,62,60,60,0,1.34782608695652,1.30434782608696,1.30434782608696,0,34,12,24,46,41,93,-7,0.5
1994,"Newcastle United",1,42,72,67,47,20,1.71428571428571,1.5952380952381,1.11904761904762,0.476190476190476,6,6,22,22,2,116,4,-0.8
1994,"Northampton Town",4,42,44,45,67,-22,1.04761904761905,1.07142857142857,1.5952380952381,-0.523809523809524,87,17,22,92,79,93,8,1.1
1994,"Norwich City",1,42,43,37,54,-17,1.02380952380952,0.880952380952381,1.28571428571429,-0.404761904761905,20,20,22,22,36,93,-16,0.1
1994,"Nottingham Forest",1,42,77,72,43,29,1.83333333333333,1.71428571428571,1.02380952380952,0.69047619047619,3,3,22,22,9,117,-6,-4
1994,"Notts County",2,46,40,45,66,-21,0.869565217391304,0.978260869565217,1.43478260869565,-0.456521739130435,46,24,24,46,48,120,-2,-4.2
1994,"Oldham Athletic",2,46,61,60,60,0,1.32608695652174,1.30434782608696,1.30434782608696,0,36,14,24,46,38,102,-2,-2.8
1994,"Oxford United",3,46,75,65,52,13,1.6304347826087,1.41304347826087,1.1304347826087,0.282608695652174,53,7,24,70,46,54,7,-3
1994,"Peterborough United",3,46,60,54,69,-15,1.30434782608696,1.17391304347826,1.5,-0.326086956521739,61,15,24,70,63,60,-2,-0.6
1994,"Plymouth Argyle",3,46,46,45,83,-38,1,0.978260869565217,1.80434782608696,-0.826086956521739,67,21,24,70,73,93,-6,3
1994,"Port Vale",2,46,58,58,64,-6,1.26086956521739,1.26086956521739,1.39130434782609,-0.130434782608696,39,17,24,46,31,107,8,-2.3
1994,"Portsmouth",2,46,58,53,63,-10,1.26086956521739,1.15217391304348,1.3695652173913,-0.217391304347826,40,18,24,46,42,93,-2,2.4
1994,"Preston North End",4,42,67,58,41,17,1.5952380952381,1.38095238095238,0.976190476190476,0.404761904761905,75,5,22,92,69,121,6,5
1994,"Queens Park Rangers",1,42,60,61,59,2,1.42857142857143,1.45238095238095,1.4047619047619,0.0476190476190476,8,8,22,22,19,93,-11,-2.3
1994,"Reading",2,46,79,58,44,14,1.71739130434783,1.26086956521739,0.956521739130435,0.304347826086957,24,2,24,46,39,93,-15,-0.3
1994,"Rochdale",4,42,50,44,67,-23,1.19047619047619,1.04761904761905,1.5952380952381,-0.547619047619048,85,15,22,92,83,92,2,0.8
1994,"Rotherham United",3,46,56,57,61,-4,1.21739130434783,1.23913043478261,1.32608695652174,-0.0869565217391304,63,17,24,70,60,88,3,1.9
1994,"Scarborough",4,42,34,49,70,-21,0.80952380952381,1.16666666666667,1.66666666666667,-0.5,92,22,22,92,91,12,1,NA
1994,"Scunthorpe United",4,42,62,68,63,5,1.47619047619048,1.61904761904762,1.5,0.119047619047619,78,8,22,92,80,70,-2,0.8
1994,"Sheffield United",2,46,68,74,55,19,1.47826086956522,1.60869565217391,1.19565217391304,0.41304347826087,30,8,24,46,29,117,1,0.2
1994,"Sheffield Wednesday",1,42,51,49,57,-8,1.21428571428571,1.16666666666667,1.35714285714286,-0.19047619047619,13,13,22,22,15,117,-2,-3.6
1994,"Shrewsbury Town",3,46,53,54,62,-8,1.15217391304348,1.17391304347826,1.34782608695652,-0.173913043478261,64,18,24,70,62,69,2,-1.5
1994,"Southampton",1,42,54,61,63,-2,1.28571428571429,1.45238095238095,1.5,-0.0476190476190476,11,11,22,22,18,93,-7,-0.9
1994,"Southend United",2,46,62,54,73,-19,1.34782608695652,1.17391304347826,1.58695652173913,-0.41304347826087,35,13,24,46,33,93,2,-3.7
1994,"Stockport County",3,46,65,63,60,3,1.41304347826087,1.3695652173913,1.30434782608696,0.0652173913043478,57,11,24,70,53,99,4,-1.1
1994,"Stoke City",2,46,63,50,53,-3,1.3695652173913,1.08695652173913,1.15217391304348,-0.0652173913043478,33,11,24,46,24,113,9,0.1
1994,"Sunderland",2,46,54,41,45,-4,1.17391304347826,0.891304347826087,0.978260869565217,-0.0869565217391304,42,20,24,46,21,119,21,2.1
1994,"Swansea City",3,46,71,57,45,12,1.54347826086957,1.23913043478261,0.978260869565217,0.260869565217391,56,10,24,70,66,93,-10,-1.5
1994,"Swindon Town",2,46,48,54,73,-19,1.04347826086957,1.17391304347826,1.58695652173913,-0.41304347826087,43,21,24,46,45,93,-2,-1.3
1994,"Torquay United",4,42,55,54,57,-3,1.30952380952381,1.28571428571429,1.35714285714286,-0.0714285714285714,83,13,22,92,92,78,-9,1.7
1994,"Tottenham Hotspur",1,42,62,66,58,8,1.47619047619048,1.57142857142857,1.38095238095238,0.19047619047619,7,7,22,22,8,101,-1,-0.2
1994,"Tranmere Rovers",2,46,76,67,58,9,1.65217391304348,1.45652173913043,1.26086956521739,0.195652173913043,26,4,24,46,34,89,-8,-2.1
1994,"Walsall",4,42,83,75,40,35,1.97619047619048,1.78571428571429,0.952380952380952,0.833333333333333,72,2,22,92,55,100,17,1.4
1994,"Watford",2,46,70,52,46,6,1.52173913043478,1.1304347826087,1,0.130434782608696,29,7,24,46,43,93,-14,-1
1994,"West Bromwich Albion",2,46,58,51,57,-6,1.26086956521739,1.10869565217391,1.23913043478261,-0.130434782608696,41,19,24,46,32,121,9,2.4
1994,"West Ham United",1,42,50,44,48,-4,1.19047619047619,1.04761904761905,1.14285714285714,-0.0952380952380952,16,16,22,22,10,94,6,-1
1994,"Wigan Athletic",4,42,52,53,60,-7,1.23809523809524,1.26190476190476,1.42857142857143,-0.166666666666667,84,14,22,92,78,42,6,6.2
1994,"Wimbledon",1,42,56,48,65,-17,1.33333333333333,1.14285714285714,1.54761904761905,-0.404761904761905,9,9,22,22,14,27,-5,NA
1994,"Wolverhampton Wanderers",2,46,76,77,61,16,1.65217391304348,1.67391304347826,1.32608695652174,0.347826086956522,27,5,24,46,40,121,-13,-0.3
1994,"Wrexham",3,46,63,65,64,1,1.3695652173913,1.41304347826087,1.39130434782609,0.0217391304347826,59,13,24,70,54,80,5,-0.4
1994,"Wycombe Wanderers",3,46,78,60,46,14,1.69565217391304,1.30434782608696,1,0.304347826086957,52,6,24,70,57,27,-5,-2.6
1994,"York City",3,46,72,67,51,16,1.56521739130435,1.45652173913043,1.10869565217391,0.347826086956522,55,9,24,70,64,72,-9,-3
1995,"AFC Bournemouth",3,46,58,51,70,-19,1.26086956521739,1.10869565217391,1.52173913043478,-0.41304347826087,58,14,24,68,60,90,-2,-0.3
1995,"Arsenal",1,38,63,49,32,17,1.65789473684211,1.28947368421053,0.842105263157895,0.447368421052632,4,4,20,20,2,116,2,0
1995,"Aston Villa",1,38,63,52,35,17,1.65789473684211,1.36842105263158,0.921052631578947,0.447368421052632,5,5,20,20,5,121,0,-1.1
1995,"Barnet",4,46,70,65,45,20,1.52173913043478,1.41304347826087,0.978260869565217,0.434782608695652,76,8,24,92,82,21,-6,-1.3
1995,"Barnsley",2,46,60,60,66,-6,1.30434782608696,1.30434782608696,1.43478260869565,-0.130434782608696,30,10,24,44,22,111,8,-1.9
1995,"Birmingham City",2,46,58,61,64,-3,1.26086956521739,1.32608695652174,1.39130434782609,-0.0652173913043478,35,15,24,44,29,117,6,1.7
1995,"Blackburn Rovers",1,38,61,61,47,14,1.60526315789474,1.60526315789474,1.23684210526316,0.368421052631579,6,6,20,20,13,121,-7,0
1995,"Blackpool",3,46,82,67,40,27,1.78260869565217,1.45652173913043,0.869565217391304,0.58695652173913,47,3,24,68,51,112,-4,-1.6
1995,"Bolton Wanderers",1,38,29,39,71,-32,0.763157894736842,1.02631578947368,1.86842105263158,-0.842105263157895,20,20,20,20,21,121,-1,1.2
1995,"Bradford City",3,46,73,71,69,2,1.58695652173913,1.54347826086957,1.5,0.0434782608695652,49,5,24,68,41,106,8,-0.6
1995,"Brentford",3,46,58,43,49,-6,1.26086956521739,0.934782608695652,1.06521739130435,-0.130434782608696,59,15,24,68,48,93,11,1.2
1995,"Brighton & Hove Albion",3,46,40,46,69,-23,0.869565217391304,1,1.5,-0.5,67,23,24,68,90,93,-23,2.3
1995,"Bristol City",3,46,60,55,60,-5,1.30434782608696,1.19565217391304,1.30434782608696,-0.108695652173913,56,12,24,68,49,108,7,0.3
1995,"Bristol Rovers",3,46,70,57,60,-3,1.52173913043478,1.23913043478261,1.30434782608696,-0.0652173913043478,52,8,24,68,61,92,-9,-2.8
1995,"Burnley",3,46,55,56,68,-12,1.19565217391304,1.21739130434783,1.47826086956522,-0.260869565217391,61,17,24,68,53,121,8,2.5
1995,"Bury",4,46,79,66,48,18,1.71739130434783,1.43478260869565,1.04347826086957,0.391304347826087,71,3,24,92,45,114,26,-1.6
1995,"Cambridge United",4,46,54,61,71,-10,1.17391304347826,1.32608695652174,1.54347826086957,-0.217391304347826,84,16,24,92,78,41,6,-0.3
1995,"Cardiff City",4,46,45,41,64,-23,0.978260869565217,0.891304347826087,1.39130434782609,-0.5,90,22,24,92,75,93,15,5.9
1995,"Carlisle United",3,46,49,57,72,-15,1.06521739130435,1.23913043478261,1.56521739130435,-0.326086956521739,65,21,24,68,71,84,-6,1.3
1995,"Charlton Athletic",2,46,71,57,45,12,1.54347826086957,1.23913043478261,0.978260869565217,0.260869565217391,25,5,24,44,35,92,-10,1.2
1995,"Chelsea",1,38,50,46,44,2,1.31578947368421,1.21052631578947,1.15789473684211,0.0526315789473684,11,11,20,20,6,104,5,1
1995,"Chester",4,46,70,72,53,19,1.52173913043478,1.56521739130435,1.15217391304348,0.41304347826087,77,9,24,92,74,67,3,NA
1995,"Chesterfield",3,46,72,56,51,5,1.56521739130435,1.21739130434783,1.10869565217391,0.108695652173913,51,7,24,68,54,100,-3,-0.8
1995,"Colchester United",4,46,72,61,51,10,1.56521739130435,1.32608695652174,1.10869565217391,0.217391304347826,75,7,24,92,76,68,-1,2.9
1995,"Coventry City",1,38,38,42,60,-18,1,1.10526315789474,1.57894736842105,-0.473684210526316,16,16,20,20,17,94,-1,-1.2
1995,"Crewe Alexandra",3,46,73,77,60,17,1.58695652173913,1.67391304347826,1.30434782608696,0.369565217391304,50,6,24,68,50,96,0,0.8
1995,"Crystal Palace",2,46,75,67,48,19,1.6304347826087,1.45652173913043,1.04347826086957,0.41304347826087,23,3,24,44,26,93,-3,-0.3
1995,"Darlington",4,46,78,60,42,18,1.69565217391304,1.30434782608696,0.91304347826087,0.391304347826087,72,4,24,92,86,81,-14,-0.4
1995,"Derby County",2,46,79,71,51,20,1.71739130434783,1.54347826086957,1.10869565217391,0.434782608695652,22,2,24,44,10,121,12,-1.8
1995,"Doncaster Rovers",4,46,59,49,60,-11,1.28260869565217,1.06521739130435,1.30434782608696,-0.239130434782609,81,13,24,92,87,88,-6,4
1995,"Everton",1,38,61,64,44,20,1.60526315789474,1.68421052631579,1.15789473684211,0.526315789473684,7,7,20,20,14,121,-7,-0.4
1995,"Exeter City",4,46,57,46,53,-7,1.23913043478261,1,1.15217391304348,-0.152173913043478,82,14,24,92,91,88,-9,3.1
1995,"Fulham",4,46,53,57,63,-6,1.15217391304348,1.23913043478261,1.3695652173913,-0.130434782608696,85,17,24,92,69,102,16,7.3
1995,"Gillingham",4,46,83,49,20,29,1.80434782608696,1.06521739130435,0.434782608695652,0.630434782608696,70,2,24,92,55,88,15,1.4
1995,"Grimsby Town",2,46,56,55,69,-14,1.21739130434783,1.19565217391304,1.5,-0.304347826086957,37,17,24,44,42,110,-5,-3.5
1995,"Hartlepool United",4,46,49,47,67,-20,1.06521739130435,1.02173913043478,1.45652173913043,-0.434782608695652,88,20,24,92,88,89,0,2.3
1995,"Hereford United",4,46,74,65,47,18,1.60869565217391,1.41304347826087,1.02173913043478,0.391304347826087,74,6,24,92,92,31,-18,NA
1995,"Huddersfield Town",2,46,63,61,58,3,1.3695652173913,1.32608695652174,1.26086956521739,0.0652173913043478,28,8,24,44,39,99,-11,-2
1995,"Hull City",3,46,31,36,78,-42,0.673913043478261,0.782608695652174,1.69565217391304,-0.91304347826087,68,24,24,68,84,104,-16,3
1995,"Ipswich Town",2,46,69,79,69,10,1.5,1.71739130434783,1.5,0.217391304347826,27,7,24,44,24,75,3,-0.7
1995,"Leeds United",1,38,43,40,57,-17,1.13157894736842,1.05263157894737,1.5,-0.447368421052632,12,12,20,20,11,93,1,-1.3
1995,"Leicester City",2,46,71,66,60,6,1.54347826086957,1.43478260869565,1.30434782608696,0.130434782608696,26,6,24,44,9,115,17,-1.1
1995,"Leyton Orient",4,46,47,44,63,-19,1.02173913043478,0.956521739130435,1.3695652173913,-0.41304347826087,89,21,24,92,85,102,4,1.8
1995,"Lincoln City",4,46,53,57,73,-16,1.15217391304348,1.23913043478261,1.58695652173913,-0.347826086956522,86,18,24,92,77,107,9,1.1
1995,"Liverpool",1,38,71,70,34,36,1.86842105263158,1.84210526315789,0.894736842105263,0.947368421052632,3,3,20,20,3,116,0,0
1995,"Luton Town",2,46,45,40,64,-24,0.978260869565217,0.869565217391304,1.39130434782609,-0.521739130434783,44,24,24,44,47,91,-3,1.4
1995,"Manchester City",1,38,38,33,58,-25,1,0.868421052631579,1.52631578947368,-0.657894736842105,17,17,20,20,34,117,-17,0.2
1995,"Manchester United",1,38,82,73,35,38,2.15789473684211,1.92105263157895,0.921052631578947,1,1,1,20,20,1,117,0,-0.1
1995,"Mansfield Town",4,46,53,54,64,-10,1.15217391304348,1.17391304347826,1.39130434782609,-0.217391304347826,87,19,24,92,79,77,8,0.1
1995,"Middlesbrough",1,38,43,35,50,-15,1.13157894736842,0.921052631578947,1.31578947368421,-0.394736842105263,13,13,20,20,15,110,-2,-0.1
1995,"Millwall",2,46,52,43,63,-20,1.1304347826087,0.934782608695652,1.3695652173913,-0.434782608695652,41,21,24,44,58,93,-17,-0.2
1995,"Newcastle United",1,38,78,66,37,29,2.05263157894737,1.73684210526316,0.973684210526316,0.763157894736842,2,2,20,20,4,116,-2,-0.5
1995,"Northampton Town",4,46,67,51,44,7,1.45652173913043,1.10869565217391,0.956521739130435,0.152173913043478,79,11,24,92,72,93,7,0.9
1995,"Norwich City",2,46,57,59,55,4,1.23913043478261,1.28260869565217,1.19565217391304,0.0869565217391304,36,16,24,44,33,93,3,0.7
1995,"Nottingham Forest",1,38,58,50,54,-4,1.52631578947368,1.31578947368421,1.42105263157895,-0.105263157894737,9,9,20,20,20,117,-11,-4.3
1995,"Notts County",3,46,78,63,39,24,1.69565217391304,1.3695652173913,0.847826086956522,0.521739130434783,48,4,24,68,67,120,-19,-4
1995,"Oldham Athletic",2,46,56,54,50,4,1.21739130434783,1.17391304347826,1.08695652173913,0.0869565217391304,38,18,24,44,43,102,-5,-1.6
1995,"Oxford United",3,46,83,76,39,37,1.80434782608696,1.65217391304348,0.847826086956522,0.804347826086957,46,2,24,68,36,54,10,-4.5
1995,"Peterborough United",3,46,52,59,66,-7,1.1304347826087,1.28260869565217,1.43478260869565,-0.152173913043478,63,19,24,68,65,60,-2,-1.4
1995,"Plymouth Argyle",4,46,78,68,49,19,1.69565217391304,1.47826086956522,1.06521739130435,0.41304347826087,73,5,24,92,63,93,10,3.8
1995,"Port Vale",2,46,60,59,66,-7,1.30434782608696,1.28260869565217,1.43478260869565,-0.152173913043478,31,11,24,44,28,107,3,-2.6
1995,"Portsmouth",2,46,52,61,69,-8,1.1304347826087,1.32608695652174,1.5,-0.173913043478261,42,22,24,44,27,93,15,2.5
1995,"Preston North End",4,46,86,78,38,40,1.8695652173913,1.69565217391304,0.826086956521739,0.869565217391304,69,1,24,92,59,121,10,4.5
1995,"Queens Park Rangers",1,38,33,38,57,-19,0.868421052631579,1,1.5,-0.5,19,19,20,20,30,93,-11,-2.2
1995,"Reading",2,46,56,54,63,-9,1.21739130434783,1.17391304347826,1.3695652173913,-0.195652173913043,39,19,24,44,37,93,2,1.8
1995,"Rochdale",4,46,55,57,61,-4,1.19565217391304,1.23913043478261,1.32608695652174,-0.0869565217391304,83,15,24,92,83,92,0,0.1
1995,"Rotherham United",3,46,56,54,62,-8,1.21739130434783,1.17391304347826,1.34782608695652,-0.173913043478261,60,16,24,68,68,88,-8,-0.4
1995,"Scarborough",4,46,40,39,69,-30,0.869565217391304,0.847826086956522,1.5,-0.652173913043478,91,23,24,92,80,12,11,NA
1995,"Scunthorpe United",4,46,60,67,61,6,1.30434782608696,1.45652173913043,1.32608695652174,0.130434782608696,80,12,24,92,81,70,-1,2.2
1995,"Sheffield United",2,46,62,57,54,3,1.34782608695652,1.23913043478261,1.17391304347826,0.0652173913043478,29,9,24,44,25,117,4,0.7
1995,"Sheffield Wednesday",1,38,40,48,61,-13,1.05263157894737,1.26315789473684,1.60526315789474,-0.342105263157895,15,15,20,20,7,117,8,-2.4
1995,"Shrewsbury Town",3,46,53,58,70,-12,1.15217391304348,1.26086956521739,1.52173913043478,-0.260869565217391,62,18,24,68,66,69,-4,-1.3
1995,"Southampton",1,38,38,34,52,-18,1,0.894736842105263,1.36842105263158,-0.473684210526316,18,18,20,20,18,93,0,-1.4
1995,"Southend United",2,46,59,52,61,-9,1.28260869565217,1.1304347826087,1.32608695652174,-0.195652173913043,33,13,24,44,44,93,-11,-1.2
1995,"Stockport County",3,46,70,61,47,14,1.52173913043478,1.32608695652174,1.02173913043478,0.304347826086957,53,9,24,68,46,99,7,-3.6
1995,"Stoke City",2,46,73,60,49,11,1.58695652173913,1.30434782608696,1.06521739130435,0.239130434782609,24,4,24,44,32,113,-8,-0.9
1995,"Sunderland",2,46,83,59,33,26,1.80434782608696,1.28260869565217,0.717391304347826,0.565217391304348,21,1,24,44,19,119,2,0.1
1995,"Swansea City",3,46,47,43,79,-36,1.02173913043478,0.934782608695652,1.71739130434783,-0.782608695652174,66,22,24,68,73,93,-7,1.6
1995,"Swindon Town",3,46,92,71,34,37,2,1.54347826086957,0.739130434782609,0.804347826086957,45,1,24,68,40,93,5,-2.2
1995,"Torquay United",4,46,29,30,84,-54,0.630434782608696,0.652173913043478,1.82608695652174,-1.17391304347826,92,24,24,92,89,78,3,0.2
1995,"Tottenham Hotspur",1,38,61,50,38,12,1.60526315789474,1.31578947368421,1,0.315789473684211,8,8,20,20,12,101,-4,0.3
1995,"Tranmere Rovers",2,46,59,64,60,4,1.28260869565217,1.39130434782609,1.30434782608696,0.0869565217391304,34,14,24,44,31,89,3,-2.8
1995,"Walsall",3,46,69,60,45,15,1.5,1.30434782608696,0.978260869565217,0.326086956521739,55,11,24,68,56,100,-1,-1.3
1995,"Watford",2,46,48,62,70,-8,1.04347826086957,1.34782608695652,1.52173913043478,-0.173913043478261,43,23,24,44,57,93,-14,2
1995,"West Bromwich Albion",2,46,60,60,68,-8,1.30434782608696,1.30434782608696,1.47826086956522,-0.173913043478261,32,12,24,44,38,121,-6,1.3
1995,"West Ham United",1,38,51,43,52,-9,1.34210526315789,1.13157894736842,1.36842105263158,-0.236842105263158,10,10,20,20,16,94,-6,0.1
1995,"Wigan Athletic",4,46,70,62,56,6,1.52173913043478,1.34782608695652,1.21739130434783,0.130434782608696,78,10,24,92,70,42,8,6.8
1995,"Wimbledon",1,38,41,55,70,-15,1.07894736842105,1.44736842105263,1.84210526315789,-0.394736842105263,14,14,20,20,8,27,6,NA
1995,"Wolverhampton Wanderers",2,46,55,56,62,-6,1.19565217391304,1.21739130434783,1.34782608695652,-0.130434782608696,40,20,24,44,23,121,17,1.3
1995,"Wrexham",3,46,70,76,55,21,1.52173913043478,1.65217391304348,1.19565217391304,0.456521739130435,54,10,24,68,52,80,2,-2.7
1995,"Wycombe Wanderers",3,46,60,63,59,4,1.30434782608696,1.3695652173913,1.28260869565217,0.0869565217391304,57,13,24,68,62,27,-5,-1.7
1995,"York City",3,46,52,58,73,-15,1.1304347826087,1.26086956521739,1.58695652173913,-0.326086956521739,64,20,24,68,64,72,0,-1.1
1996,"AFC Bournemouth",3,46,60,43,45,-2,1.30434782608696,0.934782608695652,0.978260869565217,-0.0434782608695652,60,16,24,68,53,90,7,-0.3
1996,"Arsenal",1,38,68,62,32,30,1.78947368421053,1.63157894736842,0.842105263157895,0.789473684210526,2,2,20,20,1,116,1,-0.1
1996,"Aston Villa",1,38,61,47,34,13,1.60526315789474,1.23684210526316,0.894736842105263,0.342105263157895,5,5,20,20,7,121,-2,-0.6
1996,"Barnet",4,46,58,46,51,-5,1.26086956521739,1,1.10869565217391,-0.108695652173913,82,14,24,92,75,21,7,-0.8
1996,"Barnsley",2,46,80,76,55,21,1.73913043478261,1.65217391304348,1.19565217391304,0.456521739130435,22,2,24,44,19,111,3,-1.8
1996,"Birmingham City",2,46,66,52,48,4,1.43478260869565,1.1304347826087,1.04347826086957,0.0869565217391304,29,9,24,44,26,117,3,0.7
1996,"Blackburn Rovers",1,38,42,42,43,-1,1.10526315789474,1.10526315789474,1.13157894736842,-0.0263157894736842,13,13,20,20,6,121,7,0.3
1996,"Blackpool",3,46,69,60,47,13,1.5,1.30434782608696,1.02173913043478,0.282608695652174,51,7,24,68,55,112,-4,0.4
1996,"Bolton Wanderers",2,46,98,100,53,47,2.1304347826087,2.17391304347826,1.15217391304348,1.02173913043478,21,1,24,44,17,121,4,1.4
1996,"Bradford City",2,46,48,47,72,-25,1.04347826086957,1.02173913043478,1.56521739130435,-0.543478260869565,41,21,24,44,33,106,8,-2.5
1996,"Brentford",3,46,74,56,43,13,1.60869565217391,1.21739130434783,0.934782608695652,0.282608695652174,48,4,24,68,65,93,-17,-2
1996,"Brighton & Hove Albion",4,46,49,53,70,-17,1.06521739130435,1.15217391304348,1.52173913043478,-0.369565217391304,90,22,24,92,91,93,-1,2.8
1996,"Bristol City",3,46,73,69,51,18,1.58695652173913,1.5,1.10869565217391,0.391304347826087,49,5,24,68,46,108,3,0.3
1996,"Bristol Rovers",3,46,56,47,50,-3,1.21739130434783,1.02173913043478,1.08695652173913,-0.0652173913043478,61,17,24,68,49,92,12,-1.3
1996,"Burnley",3,46,68,71,55,16,1.47826086956522,1.54347826086957,1.19565217391304,0.347826086956522,53,9,24,68,64,121,-11,1.8
1996,"Bury",3,46,84,62,38,24,1.82608695652174,1.34782608695652,0.826086956521739,0.521739130434783,45,1,24,68,37,114,8,-4.4
1996,"Cambridge United",4,46,65,53,59,-6,1.41304347826087,1.15217391304348,1.28260869565217,-0.130434782608696,78,10,24,92,83,41,-5,0.1
1996,"Cardiff City",4,46,69,56,54,2,1.5,1.21739130434783,1.17391304347826,0.0434782608695652,75,7,24,92,88,93,-13,4.2
1996,"Carlisle United",4,46,84,67,44,23,1.82608695652174,1.45652173913043,0.956521739130435,0.5,71,3,24,92,67,84,4,2.3
1996,"Charlton Athletic",2,46,59,52,66,-14,1.28260869565217,1.1304347826087,1.43478260869565,-0.304347826086957,35,15,24,44,24,92,11,1.6
1996,"Chelsea",1,38,59,58,55,3,1.55263157894737,1.52631578947368,1.44736842105263,0.0789473684210526,6,6,20,20,4,104,2,0.4
1996,"Chester",4,46,70,55,43,12,1.52173913043478,1.19565217391304,0.934782608695652,0.260869565217391,74,6,24,92,81,67,-7,NA
1996,"Chesterfield",3,46,68,42,39,3,1.47826086956522,0.91304347826087,0.847826086956522,0.0652173913043478,54,10,24,68,54,100,0,-1.3
1996,"Colchester United",4,46,68,62,51,11,1.47826086956522,1.34782608695652,1.10869565217391,0.239130434782609,76,8,24,92,72,68,4,4.6
1996,"Coventry City",1,38,41,38,54,-16,1.07894736842105,1,1.42105263157895,-0.421052631578947,17,17,20,20,11,94,6,-2
1996,"Crewe Alexandra",3,46,73,56,47,9,1.58695652173913,1.21739130434783,1.02173913043478,0.195652173913043,50,6,24,68,31,96,19,-0.6
1996,"Crystal Palace",2,46,71,78,48,30,1.54347826086957,1.69565217391304,1.04347826086957,0.652173913043478,26,6,24,44,20,93,6,-0.6
1996,"Darlington",4,46,52,64,78,-14,1.1304347826087,1.39130434782609,1.69565217391304,-0.304347826086957,86,18,24,92,87,81,-1,0.8
1996,"Derby County",1,38,46,45,58,-13,1.21052631578947,1.18421052631579,1.52631578947368,-0.342105263157895,10,10,20,20,9,121,1,-1.3
1996,"Doncaster Rovers",4,46,52,52,66,-14,1.1304347826087,1.1304347826087,1.43478260869565,-0.304347826086957,87,19,24,92,92,88,-5,4.3
1996,"Everton",1,38,42,44,57,-13,1.10526315789474,1.15789473684211,1.5,-0.342105263157895,14,14,20,20,18,121,-4,0.8
1996,"Exeter City",4,46,48,48,73,-25,1.04347826086957,1.04347826086957,1.58695652173913,-0.543478260869565,91,23,24,92,84,88,7,2.4
1996,"Fulham",4,46,87,72,38,34,1.89130434782609,1.56521739130435,0.826086956521739,0.739130434782609,69,1,24,92,50,102,19,5.3
1996,"Gillingham",3,46,67,60,59,1,1.45652173913043,1.30434782608696,1.28260869565217,0.0217391304347826,55,11,24,68,51,88,4,-0.3
1996,"Grimsby Town",2,46,46,60,81,-21,1,1.30434782608696,1.76086956521739,-0.456521739130435,42,22,24,44,47,110,-5,-4.1
1996,"Hartlepool United",4,46,51,53,66,-13,1.10869565217391,1.15217391304348,1.43478260869565,-0.282608695652174,88,20,24,92,85,89,3,1.8
1996,"Hereford United",4,46,47,50,65,-15,1.02173913043478,1.08695652173913,1.41304347826087,-0.326086956521739,92,24,24,92,84,31,8,NA
1996,"Huddersfield Town",2,46,54,48,61,-13,1.17391304347826,1.04347826086957,1.32608695652174,-0.282608695652174,39,19,24,44,36,99,3,-2
1996,"Hull City",4,46,57,44,50,-6,1.23913043478261,0.956521739130435,1.08695652173913,-0.130434782608696,84,16,24,92,90,104,-6,4.3
1996,"Ipswich Town",2,46,74,68,50,18,1.60869565217391,1.47826086956522,1.08695652173913,0.391304347826087,24,4,24,44,25,75,-1,-1
1996,"Leeds United",1,38,46,28,38,-10,1.21052631578947,0.736842105263158,1,-0.263157894736842,11,11,20,20,5,93,6,-3.1
1996,"Leicester City",1,38,47,46,54,-8,1.23684210526316,1.21052631578947,1.42105263157895,-0.210526315789474,9,9,20,20,10,115,-1,-2.9
1996,"Leyton Orient",4,46,57,50,58,-8,1.23913043478261,1.08695652173913,1.26086956521739,-0.173913043478261,85,17,24,92,76,102,9,2.1
1996,"Lincoln City",4,46,66,70,69,1,1.43478260869565,1.52173913043478,1.5,0.0217391304347826,77,9,24,92,71,107,6,0.4
1996,"Liverpool",1,38,68,62,37,25,1.78947368421053,1.63157894736842,0.973684210526316,0.657894736842105,3,3,20,20,3,116,0,-0.1
1996,"Luton Town",3,46,78,71,45,26,1.69565217391304,1.54347826086957,0.978260869565217,0.565217391304348,47,3,24,68,61,91,-14,0.3
1996,"Manchester City",2,46,61,59,60,-1,1.32608695652174,1.28260869565217,1.30434782608696,-0.0217391304347826,34,14,24,44,42,117,-8,2
1996,"Manchester United",1,38,75,76,44,32,1.97368421052632,2,1.15789473684211,0.842105263157895,1,1,20,20,2,117,-1,0
1996,"Mansfield Town",4,46,64,47,45,2,1.39130434782609,1.02173913043478,0.978260869565217,0.0434782608695652,79,11,24,92,80,77,-1,-0.6
1996,"Middlesbrough",1,38,42,51,60,-9,1.10526315789474,1.34210526315789,1.57894736842105,-0.236842105263158,15,15,20,20,22,110,-7,0.3
1996,"Millwall",3,46,61,50,55,-5,1.32608695652174,1.08695652173913,1.19565217391304,-0.108695652173913,58,14,24,68,62,93,-4,0.4
1996,"Newcastle United",1,38,68,73,40,33,1.78947368421053,1.92105263157895,1.05263157894737,0.868421052631579,4,4,20,20,13,116,-9,-0.9
1996,"Northampton Town",4,46,72,67,44,23,1.56521739130435,1.45652173913043,0.956521739130435,0.5,72,4,24,92,48,93,24,1.2
1996,"Norwich City",2,46,63,63,68,-5,1.3695652173913,1.3695652173913,1.47826086956522,-0.108695652173913,33,13,24,44,35,93,-2,-0.3
1996,"Nottingham Forest",1,38,34,31,59,-28,0.894736842105263,0.815789473684211,1.55263157894737,-0.736842105263158,20,20,20,20,21,117,-1,-2.8
1996,"Notts County",3,46,35,33,59,-26,0.760869565217391,0.717391304347826,1.28260869565217,-0.565217391304348,67,23,24,68,69,120,-2,-1.3
1996,"Oldham Athletic",2,46,43,51,66,-15,0.934782608695652,1.10869565217391,1.43478260869565,-0.326086956521739,43,23,24,44,57,102,-14,-0.7
1996,"Oxford United",2,46,57,64,68,-4,1.23913043478261,1.39130434782609,1.47826086956522,-0.0869565217391304,36,16,24,44,32,54,4,-4.4
1996,"Peterborough United",3,46,47,55,73,-18,1.02173913043478,1.19565217391304,1.58695652173913,-0.391304347826087,65,21,24,68,78,60,-13,-1.4
1996,"Plymouth Argyle",3,46,54,47,58,-11,1.17391304347826,1.02173913043478,1.26086956521739,-0.239130434782609,63,19,24,68,66,93,-3,3.2
1996,"Port Vale",2,46,67,58,55,3,1.45652173913043,1.26086956521739,1.19565217391304,0.0652173913043478,28,8,24,44,39,107,-11,-2.9
1996,"Portsmouth",2,46,68,59,53,6,1.47826086956522,1.28260869565217,1.15217391304348,0.130434782608696,27,7,24,44,40,93,-13,1.8
1996,"Preston North End",3,46,61,49,55,-6,1.32608695652174,1.06521739130435,1.19565217391304,-0.130434782608696,59,15,24,68,59,121,0,3.2
1996,"Queens Park Rangers",2,46,66,64,60,4,1.43478260869565,1.39130434782609,1.30434782608696,0.0869565217391304,30,10,24,44,41,93,-11,-0.9
1996,"Reading",2,46,57,58,67,-9,1.23913043478261,1.26086956521739,1.45652173913043,-0.195652173913043,37,17,24,44,44,93,-7,2.9
1996,"Rochdale",4,46,58,58,58,0,1.26086956521739,1.26086956521739,1.26086956521739,0,83,15,24,92,86,92,-3,0.6
1996,"Rotherham United",3,46,35,39,70,-31,0.760869565217391,0.847826086956522,1.52173913043478,-0.673913043478261,68,24,24,68,79,88,-11,0.3
1996,"Scarborough",4,46,63,65,68,-3,1.3695652173913,1.41304347826087,1.47826086956522,-0.0652173913043478,80,12,24,92,74,12,6,NA
1996,"Scunthorpe United",4,46,63,59,62,-3,1.3695652173913,1.28260869565217,1.34782608695652,-0.0652173913043478,81,13,24,92,77,70,4,3.6
1996,"Sheffield United",2,46,73,75,52,23,1.58695652173913,1.6304347826087,1.1304347826087,0.5,25,5,24,44,27,117,-2,0.8
1996,"Sheffield Wednesday",1,38,57,50,51,-1,1.5,1.31578947368421,1.34210526315789,-0.0263157894736842,7,7,20,20,14,117,-7,-2.2
1996,"Shrewsbury Town",3,46,46,49,74,-25,1,1.06521739130435,1.60869565217391,-0.543478260869565,66,22,24,68,82,69,-16,-2.1
1996,"Southampton",1,38,41,50,56,-6,1.07894736842105,1.31578947368421,1.47368421052632,-0.157894736842105,18,18,20,20,12,93,6,-0.8
1996,"Southend United",2,46,39,42,86,-44,0.847826086956522,0.91304347826087,1.8695652173913,-0.956521739130435,44,24,24,44,68,93,-24,0.1
1996,"Stockport County",3,46,82,59,41,18,1.78260869565217,1.28260869565217,0.891304347826087,0.391304347826087,46,2,24,68,28,99,18,-3
1996,"Stoke City",2,46,64,51,57,-6,1.39130434782609,1.10869565217391,1.23913043478261,-0.130434782608696,32,12,24,44,43,113,-11,0.4
1996,"Sunderland",1,38,40,35,53,-18,1.05263157894737,0.921052631578947,1.39473684210526,-0.473684210526316,19,19,20,20,23,119,-4,-0.2
1996,"Swansea City",4,46,71,62,58,4,1.54347826086957,1.34782608695652,1.26086956521739,0.0869565217391304,73,5,24,92,89,93,-16,2.2
1996,"Swindon Town",2,46,54,52,71,-19,1.17391304347826,1.1304347826087,1.54347826086957,-0.41304347826087,40,20,24,44,38,93,2,-3.1
1996,"Torquay United",4,46,50,46,62,-16,1.08695652173913,1,1.34782608695652,-0.347826086956522,89,21,24,92,73,78,16,-0.3
1996,"Tottenham Hotspur",1,38,46,44,51,-7,1.21052631578947,1.15789473684211,1.34210526315789,-0.184210526315789,12,12,20,20,15,101,-3,0.7
1996,"Tranmere Rovers",2,46,65,63,56,7,1.41304347826087,1.3695652173913,1.21739130434783,0.152173913043478,31,11,24,44,34,89,-3,-2.2
1996,"Walsall",3,46,67,54,53,1,1.45652173913043,1.17391304347826,1.15217391304348,0.0217391304347826,56,12,24,68,63,100,-7,-1.3
1996,"Watford",3,46,67,45,38,7,1.45652173913043,0.978260869565217,0.826086956521739,0.152173913043478,57,13,24,68,45,93,12,3.7
1996,"West Bromwich Albion",2,46,57,68,72,-4,1.23913043478261,1.47826086956522,1.56521739130435,-0.0869565217391304,38,18,24,44,30,121,8,1.4
1996,"West Ham United",1,38,42,39,48,-9,1.10526315789474,1.02631578947368,1.26315789473684,-0.236842105263158,16,16,20,20,8,94,8,0.1
1996,"Wigan Athletic",4,46,87,84,51,33,1.89130434782609,1.82608695652174,1.10869565217391,0.717391304347826,70,2,24,92,56,42,14,5.2
1996,"Wimbledon",1,38,56,49,46,3,1.47368421052632,1.28947368421053,1.21052631578947,0.0789473684210526,8,8,20,20,16,27,-8,NA
1996,"Wolverhampton Wanderers",2,46,76,68,51,17,1.65217391304348,1.47826086956522,1.10869565217391,0.369565217391304,23,3,24,44,29,121,-6,-0.2
1996,"Wrexham",3,46,69,54,50,4,1.5,1.17391304347826,1.08695652173913,0.0869565217391304,52,8,24,68,52,80,0,-3.5
1996,"Wycombe Wanderers",3,46,55,51,56,-5,1.19565217391304,1.10869565217391,1.21739130434783,-0.108695652173913,62,18,24,68,58,27,4,-1.9
1996,"York City",3,46,52,47,68,-21,1.1304347826087,1.02173913043478,1.47826086956522,-0.456521739130435,64,20,24,68,60,72,4,-2.2
1997,"AFC Bournemouth",3,46,66,57,52,5,1.43478260869565,1.23913043478261,1.1304347826087,0.108695652173913,53,9,24,68,50,90,3,-0.6
1997,"Arsenal",1,38,78,68,33,35,2.05263157894737,1.78947368421053,0.868421052631579,0.921052631578947,1,1,20,20,2,116,-1,-0.2
1997,"Aston Villa",1,38,57,49,48,1,1.5,1.28947368421053,1.26315789473684,0.0263157894736842,7,7,20,20,6,121,1,0.1
1997,"Barnet",4,46,70,61,51,10,1.52173913043478,1.32608695652174,1.10869565217391,0.217391304347826,75,7,24,92,84,21,-9,-1.4
1997,"Barnsley",1,38,35,37,82,-45,0.921052631578947,0.973684210526316,2.15789473684211,-1.18421052631579,19,19,20,20,32,111,-13,-1.7
1997,"Birmingham City",2,46,74,60,35,25,1.60869565217391,1.30434782608696,0.760869565217391,0.543478260869565,26,6,24,44,24,117,2,0.7
1997,"Blackburn Rovers",1,38,58,57,52,5,1.52631578947368,1.5,1.36842105263158,0.131578947368421,6,6,20,20,19,121,-13,-0.1
1997,"Blackpool",3,46,62,59,67,-8,1.34782608695652,1.28260869565217,1.45652173913043,-0.173913043478261,55,11,24,68,57,112,-2,1.6
1997,"Bolton Wanderers",1,38,40,41,61,-20,1.05263157894737,1.07894736842105,1.60526315789474,-0.526315789473684,17,17,20,20,26,121,-9,0.1
1997,"Bradford City",2,46,57,46,59,-13,1.23913043478261,1,1.28260869565217,-0.282608695652174,33,13,24,44,22,106,11,-4.5
1997,"Brentford",3,46,50,50,71,-21,1.08695652173913,1.08695652173913,1.54347826086957,-0.456521739130435,65,21,24,68,69,93,-4,-1.6
1997,"Brighton & Hove Albion",4,46,35,38,66,-28,0.760869565217391,0.826086956521739,1.43478260869565,-0.608695652173913,91,23,24,92,85,93,6,4
1997,"Bristol City",3,46,85,69,39,30,1.84782608695652,1.5,0.847826086956522,0.652173913043478,46,2,24,68,44,108,2,2.2
1997,"Bristol Rovers",3,46,70,70,64,6,1.52173913043478,1.52173913043478,1.39130434782609,0.130434782608696,49,5,24,68,58,92,-9,-1.2
1997,"Burnley",3,46,52,55,65,-10,1.1304347826087,1.19565217391304,1.41304347826087,-0.217391304347826,64,20,24,68,59,121,5,3.1
1997,"Bury",2,46,52,42,58,-16,1.1304347826087,0.91304347826087,1.26086956521739,-0.347826086956522,37,17,24,44,39,114,-2,-4.5
1997,"Cambridge United",4,46,60,63,57,6,1.30434782608696,1.3695652173913,1.23913043478261,0.130434782608696,83,15,24,92,70,41,13,0.4
1997,"Cardiff City",4,46,50,48,52,-4,1.08695652173913,1.04347826086957,1.1304347826087,-0.0869565217391304,88,20,24,92,71,93,17,5.8
1997,"Carlisle United",3,46,44,57,73,-16,0.956521739130435,1.23913043478261,1.58695652173913,-0.347826086956522,67,23,24,68,91,84,-24,0.4
1997,"Charlton Athletic",2,46,88,80,49,31,1.91304347826087,1.73913043478261,1.06521739130435,0.673913043478261,24,4,24,44,18,92,6,-0.7
1997,"Chelsea",1,38,63,71,43,28,1.65789473684211,1.86842105263158,1.13157894736842,0.736842105263158,4,4,20,20,3,104,1,0.2
1997,"Chester",4,46,61,60,61,-1,1.32608695652174,1.30434782608696,1.32608695652174,-0.0217391304347826,81,13,24,92,82,67,-1,NA
1997,"Chesterfield",3,46,65,46,44,2,1.41304347826087,1,0.956521739130435,0.0434782608695652,54,10,24,68,53,100,1,-2.3
1997,"Colchester United",4,46,74,72,60,12,1.60869565217391,1.56521739130435,1.30434782608696,0.260869565217391,72,4,24,92,62,68,10,2.8
1997,"Coventry City",1,38,52,46,44,2,1.36842105263158,1.21052631578947,1.15789473684211,0.0526315789473684,11,11,20,20,15,94,-4,-3
1997,"Crewe Alexandra",2,46,59,58,65,-7,1.28260869565217,1.26086956521739,1.41304347826087,-0.152173913043478,31,11,24,44,38,96,-7,-3.4
1997,"Crystal Palace",1,38,33,37,71,-34,0.868421052631579,0.973684210526316,1.86842105263158,-0.894736842105263,20,20,20,20,34,93,-14,-0.5
1997,"Darlington",4,46,54,56,72,-16,1.17391304347826,1.21739130434783,1.56521739130435,-0.347826086956522,87,19,24,92,79,81,8,1.3
1997,"Derby County",1,38,55,52,49,3,1.44736842105263,1.36842105263158,1.28947368421053,0.0789473684210526,9,9,20,20,8,121,1,-1.1
1997,"Doncaster Rovers",4,46,20,30,113,-83,0.434782608695652,0.652173913043478,2.45652173913043,-1.80434782608696,92,24,24,92,69,88,23,4.7
1997,"Everton",1,38,40,41,56,-15,1.05263157894737,1.07894736842105,1.47368421052632,-0.394736842105263,18,18,20,20,14,121,4,1.3
1997,"Exeter City",4,46,60,68,63,5,1.30434782608696,1.47826086956522,1.3695652173913,0.108695652173913,84,16,24,92,80,88,4,0.6
1997,"Fulham",3,46,70,60,43,17,1.52173913043478,1.30434782608696,0.934782608695652,0.369565217391304,50,6,24,68,45,102,5,3.3
1997,"Gillingham",3,46,70,52,47,5,1.52173913043478,1.1304347826087,1.02173913043478,0.108695652173913,51,7,24,68,48,88,3,-1.5
1997,"Grimsby Town",3,46,72,55,37,18,1.56521739130435,1.19565217391304,0.804347826086957,0.391304347826087,47,3,24,68,30,110,17,-3.7
1997,"Hartlepool United",4,46,59,61,53,8,1.28260869565217,1.32608695652174,1.15217391304348,0.173913043478261,85,17,24,92,90,89,-5,2.5
1997,"Huddersfield Town",2,46,53,50,72,-22,1.15217391304348,1.08695652173913,1.56521739130435,-0.478260869565217,36,16,24,44,31,99,5,-1.7
1997,"Hull City",4,46,41,56,83,-27,0.891304347826087,1.21739130434783,1.80434782608696,-0.58695652173913,90,22,24,92,88,104,2,6.7
1997,"Ipswich Town",2,46,83,77,43,34,1.80434782608696,1.67391304347826,0.934782608695652,0.739130434782609,25,5,24,44,23,75,2,-0.3
1997,"Leeds United",1,38,59,57,46,11,1.55263157894737,1.5,1.21052631578947,0.289473684210526,5,5,20,20,4,93,1,-4.1
1997,"Leicester City",1,38,53,51,41,10,1.39473684210526,1.34210526315789,1.07894736842105,0.263157894736842,10,10,20,20,10,115,0,-3.2
1997,"Leyton Orient",4,46,69,62,47,15,1.5,1.34782608695652,1.02173913043478,0.326086956521739,76,8,24,92,74,102,2,1.8
1997,"Lincoln City",4,46,75,60,51,9,1.6304347826087,1.30434782608696,1.10869565217391,0.195652173913043,71,3,24,92,67,107,4,-1.2
1997,"Liverpool",1,38,65,68,42,26,1.71052631578947,1.78947368421053,1.10526315789474,0.684210526315789,3,3,20,20,7,116,-4,-0.1
1997,"Luton Town",3,46,57,60,64,-4,1.23913043478261,1.30434782608696,1.39130434782609,-0.0869565217391304,61,17,24,68,56,91,5,-0.6
1997,"Macclesfield",4,46,82,63,44,19,1.78260869565217,1.3695652173913,0.956521739130435,0.41304347826087,70,2,24,92,68,17,2,-1.6
1997,"Manchester City",2,46,48,56,57,-1,1.04347826086957,1.21739130434783,1.23913043478261,-0.0217391304347826,42,22,24,44,47,117,-5,3.3
1997,"Manchester United",1,38,77,73,26,47,2.02631578947368,1.92105263157895,0.684210526315789,1.23684210526316,2,2,20,20,1,117,1,0.1
1997,"Mansfield Town",4,46,65,64,55,9,1.41304347826087,1.39130434782609,1.19565217391304,0.195652173913043,80,12,24,92,76,77,4,-1.1
1997,"Middlesbrough",2,46,91,77,41,36,1.97826086956522,1.67391304347826,0.891304347826087,0.782608695652174,22,2,24,44,9,110,13,0.9
1997,"Millwall",3,46,55,43,54,-11,1.19565217391304,0.934782608695652,1.17391304347826,-0.239130434782609,62,18,24,68,54,93,8,0
1997,"Newcastle United",1,38,44,35,44,-9,1.15789473684211,0.921052631578947,1.15789473684211,-0.236842105263158,13,13,20,20,12,116,1,0.1
1997,"Northampton Town",3,46,71,52,37,15,1.54347826086957,1.1304347826087,0.804347826086957,0.326086956521739,48,4,24,68,66,93,-18,-0.6
1997,"Norwich City",2,46,55,52,69,-17,1.19565217391304,1.1304347826087,1.5,-0.369565217391304,35,15,24,44,29,93,6,-0.2
1997,"Nottingham Forest",2,46,94,82,42,40,2.04347826086957,1.78260869565217,0.91304347826087,0.869565217391304,21,1,24,44,20,117,1,-2.6
1997,"Notts County",4,46,99,82,43,39,2.15217391304348,1.78260869565217,0.934782608695652,0.847826086956522,69,1,24,92,60,120,9,-2
1997,"Oldham Athletic",3,46,61,62,54,8,1.32608695652174,1.34782608695652,1.17391304347826,0.173913043478261,57,13,24,68,63,102,-6,0.5
1997,"Oxford United",2,46,58,60,64,-4,1.26086956521739,1.30434782608696,1.39130434782609,-0.0869565217391304,32,12,24,44,43,54,-11,-4.6
1997,"Peterborough United",4,46,67,63,51,12,1.45652173913043,1.3695652173913,1.10869565217391,0.260869565217391,78,10,24,92,78,60,0,0.8
1997,"Plymouth Argyle",3,46,49,55,70,-15,1.06521739130435,1.19565217391304,1.52173913043478,-0.326086956521739,66,22,24,68,81,93,-15,3.4
1997,"Port Vale",2,46,49,56,66,-10,1.06521739130435,1.21739130434783,1.43478260869565,-0.217391304347826,39,19,24,44,40,107,-1,-2.9
1997,"Portsmouth",2,46,49,51,63,-12,1.06521739130435,1.10869565217391,1.3695652173913,-0.260869565217391,40,20,24,44,41,93,-1,3.2
1997,"Preston North End",3,46,59,56,56,0,1.28260869565217,1.21739130434783,1.21739130434783,0,59,15,24,68,49,121,10,2.4
1997,"Queens Park Rangers",2,46,49,51,63,-12,1.06521739130435,1.10869565217391,1.3695652173913,-0.260869565217391,41,21,24,44,42,93,-1,0.7
1997,"Reading",2,46,42,39,78,-39,0.91304347826087,0.847826086956522,1.69565217391304,-0.847826086956522,44,24,24,44,55,93,-11,2.6
1997,"Rochdale",4,46,58,56,55,1,1.26086956521739,1.21739130434783,1.19565217391304,0.0217391304347826,86,18,24,92,86,92,0,1.3
1997,"Rotherham United",4,46,67,67,61,6,1.45652173913043,1.45652173913043,1.32608695652174,0.130434782608696,79,11,24,92,73,88,6,0.3
1997,"Scarborough",4,46,72,67,58,9,1.56521739130435,1.45652173913043,1.26086956521739,0.195652173913043,74,6,24,92,92,12,-18,NA
1997,"Scunthorpe United",4,46,69,56,52,4,1.5,1.21739130434783,1.1304347826087,0.0869565217391304,77,9,24,92,72,70,5,3.4
1997,"Sheffield United",2,46,74,69,54,15,1.60869565217391,1.5,1.17391304347826,0.326086956521739,27,7,24,44,28,117,-1,-0.2
1997,"Sheffield Wednesday",1,38,44,52,67,-15,1.15789473684211,1.36842105263158,1.76315789473684,-0.394736842105263,14,14,20,20,13,117,1,-2.4
1997,"Shrewsbury Town",4,46,61,61,62,-1,1.32608695652174,1.32608695652174,1.34782608695652,-0.0217391304347826,82,14,24,92,83,69,-1,0.5
1997,"Southampton",1,38,48,50,55,-5,1.26315789473684,1.31578947368421,1.44736842105263,-0.131578947368421,12,12,20,20,17,93,-5,-2.8
1997,"Southend United",3,46,43,47,79,-32,0.934782608695652,1.02173913043478,1.71739130434783,-0.695652173913043,68,24,24,68,87,93,-19,1.8
1997,"Stockport County",2,46,65,71,69,2,1.41304347826087,1.54347826086957,1.5,0.0434782608695652,28,8,24,44,36,99,-8,-4.4
1997,"Stoke City",2,46,46,44,74,-30,1,0.956521739130435,1.60869565217391,-0.652173913043478,43,23,24,44,52,113,-9,2.1
1997,"Sunderland",2,46,90,86,50,36,1.95652173913043,1.8695652173913,1.08695652173913,0.782608695652174,23,3,24,44,21,119,2,0.8
1997,"Swansea City",4,46,50,49,62,-13,1.08695652173913,1.06521739130435,1.34782608695652,-0.282608695652174,89,21,24,92,75,93,14,4.4
1997,"Swindon Town",2,46,52,42,73,-31,1.1304347826087,0.91304347826087,1.58695652173913,-0.673913043478261,38,18,24,44,37,93,1,-1.9
1997,"Torquay United",4,46,74,68,59,9,1.60869565217391,1.47826086956522,1.28260869565217,0.195652173913043,73,5,24,92,89,78,-16,-1.2
1997,"Tottenham Hotspur",1,38,44,44,56,-12,1.15789473684211,1.15789473684211,1.47368421052632,-0.315789473684211,15,15,20,20,11,101,4,0.4
1997,"Tranmere Rovers",2,46,56,54,57,-3,1.21739130434783,1.17391304347826,1.23913043478261,-0.0652173913043478,34,14,24,44,35,89,-1,-2.1
1997,"Walsall",3,46,54,43,52,-9,1.17391304347826,0.934782608695652,1.1304347826087,-0.195652173913043,63,19,24,68,46,100,17,0.7
1997,"Watford",3,46,88,67,41,26,1.91304347826087,1.45652173913043,0.891304347826087,0.565217391304348,45,1,24,68,25,93,20,1.9
1997,"West Bromwich Albion",2,46,61,50,56,-6,1.32608695652174,1.08695652173913,1.21739130434783,-0.130434782608696,30,10,24,44,33,121,-3,0.9
1997,"West Ham United",1,38,56,56,57,-1,1.47368421052632,1.47368421052632,1.5,-0.0263157894736842,8,8,20,20,5,94,3,-0.2
1997,"Wigan Athletic",3,46,62,64,66,-2,1.34782608695652,1.39130434782609,1.43478260869565,-0.0434782608695652,56,12,24,68,51,42,5,4.2
1997,"Wimbledon",1,38,44,34,46,-12,1.15789473684211,0.894736842105263,1.21052631578947,-0.315789473684211,16,16,20,20,16,27,0,NA
1997,"Wolverhampton Wanderers",2,46,65,57,53,4,1.41304347826087,1.23913043478261,1.15217391304348,0.0869565217391304,29,9,24,44,27,121,2,0.2
1997,"Wrexham",3,46,70,55,51,4,1.52173913043478,1.19565217391304,1.10869565217391,0.0869565217391304,52,8,24,68,61,80,-9,-4
1997,"Wycombe Wanderers",3,46,60,51,53,-2,1.30434782608696,1.10869565217391,1.15217391304348,-0.0434782608695652,58,14,24,68,64,27,-6,-1.7
1997,"York City",3,46,59,52,58,-6,1.28260869565217,1.1304347826087,1.26086956521739,-0.130434782608696,60,16,24,68,65,72,-5,-3.2
1998,"AFC Bournemouth",3,46,76,63,41,22,1.65217391304348,1.3695652173913,0.891304347826087,0.478260869565217,50,6,24,68,59,90,-9,-3
1998,"Arsenal",1,38,78,59,17,42,2.05263157894737,1.55263157894737,0.447368421052632,1.10526315789474,2,2,20,20,2,116,0,-0.2
1998,"Aston Villa",1,38,55,51,46,5,1.44736842105263,1.34210526315789,1.21052631578947,0.131578947368421,6,6,20,20,6,121,0,0
1998,"Barnet",4,46,55,54,71,-17,1.19565217391304,1.17391304347826,1.54347826086957,-0.369565217391304,84,16,24,92,74,21,10,-0.6
1998,"Barnsley",2,46,59,59,56,3,1.28260869565217,1.28260869565217,1.21739130434783,0.0652173913043478,32,12,24,44,24,111,8,-0.8
1998,"Birmingham City",2,46,81,66,37,29,1.76086956521739,1.43478260869565,0.804347826086957,0.630434782608696,24,4,24,44,25,117,-1,0.2
1998,"Blackburn Rovers",1,38,35,38,52,-14,0.921052631578947,1,1.36842105263158,-0.368421052631579,19,19,20,20,31,121,-12,0.6
1998,"Blackpool",3,46,56,44,54,-10,1.21739130434783,0.956521739130435,1.17391304347826,-0.217391304347826,57,13,24,68,66,112,-9,2.1
1998,"Bolton Wanderers",2,46,76,78,59,19,1.65217391304348,1.69565217391304,1.28260869565217,0.41304347826087,26,6,24,44,26,121,0,1.2
1998,"Bradford City",2,46,87,82,47,35,1.89130434782609,1.78260869565217,1.02173913043478,0.760869565217391,22,2,24,44,17,106,5,-5.7
1998,"Brentford",4,46,85,79,56,23,1.84782608695652,1.71739130434783,1.21739130434783,0.5,69,1,24,92,61,93,8,0
1998,"Brighton & Hove Albion",4,46,55,49,66,-17,1.19565217391304,1.06521739130435,1.43478260869565,-0.369565217391304,85,17,24,92,79,93,6,2.4
1998,"Bristol City",2,46,42,57,80,-23,0.91304347826087,1.23913043478261,1.73913043478261,-0.5,44,24,24,44,53,108,-9,1.4
1998,"Bristol Rovers",3,46,56,65,56,9,1.21739130434783,1.41304347826087,1.21739130434783,0.195652173913043,58,14,24,68,51,92,7,0.3
1998,"Burnley",3,46,55,54,73,-19,1.19565217391304,1.17391304347826,1.58695652173913,-0.41304347826087,59,15,24,68,46,121,13,3.4
1998,"Bury",2,46,47,35,60,-25,1.02173913043478,0.760869565217391,1.30434782608696,-0.543478260869565,39,19,24,44,60,114,-21,-3.2
1998,"Cambridge United",4,46,81,78,48,30,1.76086956521739,1.69565217391304,1.04347826086957,0.652173913043478,70,2,24,92,63,41,7,-0.9
1998,"Cardiff City",4,46,80,60,39,21,1.73913043478261,1.30434782608696,0.847826086956522,0.456521739130435,71,3,24,92,65,93,6,4.5
1998,"Carlisle United",4,46,49,43,53,-10,1.06521739130435,0.934782608695652,1.15217391304348,-0.217391304347826,91,23,24,92,91,84,0,3.3
1998,"Charlton Athletic",1,38,36,41,56,-15,0.947368421052632,1.07894736842105,1.47368421052632,-0.394736842105263,18,18,20,20,21,92,-3,-2.6
1998,"Chelsea",1,38,75,57,30,27,1.97368421052632,1.5,0.789473684210526,0.710526315789474,3,3,20,20,5,104,-2,0
1998,"Chester",4,46,57,57,66,-9,1.23913043478261,1.23913043478261,1.43478260869565,-0.195652173913043,82,14,24,92,92,67,-10,NA
1998,"Chesterfield",3,46,64,46,44,2,1.39130434782609,1,0.956521739130435,0.0434782608695652,53,9,24,68,68,100,-15,-2.8
1998,"Colchester United",3,46,52,52,70,-18,1.1304347826087,1.1304347826087,1.52173913043478,-0.391304347826087,62,18,24,68,62,68,0,0.6
1998,"Coventry City",1,38,42,39,51,-12,1.10526315789474,1.02631578947368,1.34210526315789,-0.315789473684211,15,15,20,20,14,94,1,-2.2
1998,"Crewe Alexandra",2,46,48,54,78,-24,1.04347826086957,1.17391304347826,1.69565217391304,-0.521739130434783,38,18,24,44,38,96,0,-2.8
1998,"Crystal Palace",2,46,58,58,71,-13,1.26086956521739,1.26086956521739,1.54347826086957,-0.282608695652174,34,14,24,44,35,93,-1,-0.1
1998,"Darlington",4,46,65,69,58,11,1.41304347826087,1.5,1.26086956521739,0.239130434782609,79,11,24,92,72,81,7,0.4
1998,"Derby County",1,38,52,40,45,-5,1.36842105263158,1.05263157894737,1.18421052631579,-0.131578947368421,8,8,20,20,16,121,-8,-3
1998,"Everton",1,38,43,42,47,-5,1.13157894736842,1.10526315789474,1.23684210526316,-0.131578947368421,14,14,20,20,13,121,1,0.9
1998,"Exeter City",4,46,63,47,50,-3,1.3695652173913,1.02173913043478,1.08695652173913,-0.0652173913043478,80,12,24,92,89,88,-9,-0.6
1998,"Fulham",3,46,101,79,32,47,2.19565217391304,1.71739130434783,0.695652173913043,1.02173913043478,45,1,24,68,29,102,16,3.8
1998,"Gillingham",3,46,80,75,44,31,1.73913043478261,1.6304347826087,0.956521739130435,0.673913043478261,48,4,24,68,47,88,1,-2.5
1998,"Grimsby Town",2,46,61,40,52,-12,1.32608695652174,0.869565217391304,1.1304347826087,-0.260869565217391,30,10,24,44,39,110,-9,-6.1
1998,"Halifax Town",4,46,66,58,56,2,1.43478260869565,1.26086956521739,1.21739130434783,0.0434782608695652,77,9,24,92,86,69,-9,NA
1998,"Hartlepool United",4,46,51,52,65,-13,1.10869565217391,1.1304347826087,1.41304347826087,-0.282608695652174,90,22,24,92,75,89,15,2.6
1998,"Huddersfield Town",2,46,61,62,71,-9,1.32608695652174,1.34782608695652,1.54347826086957,-0.195652173913043,31,11,24,44,27,99,4,-2.2
1998,"Hull City",4,46,53,44,62,-18,1.15217391304348,0.956521739130435,1.34782608695652,-0.391304347826087,88,20,24,92,82,104,6,7.1
1998,"Ipswich Town",2,46,86,69,32,37,1.8695652173913,1.5,0.695652173913043,0.804347826086957,23,3,24,44,23,75,0,-0.6
1998,"Leeds United",1,38,67,62,34,28,1.76315789473684,1.63157894736842,0.894736842105263,0.736842105263158,4,4,20,20,3,93,1,-4.4
1998,"Leicester City",1,38,49,40,46,-6,1.28947368421053,1.05263157894737,1.21052631578947,-0.157894736842105,10,10,20,20,8,115,2,-3.5
1998,"Leyton Orient",4,46,72,68,59,9,1.56521739130435,1.47826086956522,1.28260869565217,0.195652173913043,74,6,24,92,87,102,-13,1.5
1998,"Lincoln City",3,46,46,42,74,-32,1,0.91304347826087,1.60869565217391,-0.695652173913043,67,23,24,68,83,107,-16,-1.6
1998,"Liverpool",1,38,54,68,49,19,1.42105263157895,1.78947368421053,1.28947368421053,0.5,7,7,20,20,4,116,3,0.5
1998,"Luton Town",3,46,58,51,60,-9,1.26086956521739,1.10869565217391,1.30434782608696,-0.195652173913043,56,12,24,68,56,91,0,-2.8
1998,"Macclesfield",3,46,43,43,63,-20,0.934782608695652,0.934782608695652,1.3695652173913,-0.434782608695652,68,24,24,68,81,17,-13,-2.1
1998,"Manchester City",3,46,82,69,33,36,1.78260869565217,1.5,0.717391304347826,0.782608695652174,47,3,24,68,22,117,25,3.7
1998,"Manchester United",1,38,79,80,37,43,2.07894736842105,2.10526315789474,0.973684210526316,1.13157894736842,1,1,20,20,1,117,0,0
1998,"Mansfield Town",4,46,67,60,58,2,1.45652173913043,1.30434782608696,1.26086956521739,0.0434782608695652,76,8,24,92,84,77,-8,-0.2
1998,"Middlesbrough",1,38,51,48,54,-6,1.34210526315789,1.26315789473684,1.42105263157895,-0.157894736842105,9,9,20,20,11,110,-2,-1
1998,"Millwall",3,46,62,52,59,-7,1.34782608695652,1.1304347826087,1.28260869565217,-0.152173913043478,54,10,24,68,49,93,5,0.5
1998,"Newcastle United",1,38,46,48,54,-6,1.21052631578947,1.26315789473684,1.42105263157895,-0.157894736842105,12,12,20,20,12,116,0,-0.6
1998,"Northampton Town",3,46,48,43,57,-14,1.04347826086957,0.934782608695652,1.23913043478261,-0.304347826086957,66,22,24,68,71,93,-5,0.1
1998,"Norwich City",2,46,62,62,61,1,1.34782608695652,1.34782608695652,1.32608695652174,0.0217391304347826,29,9,24,44,32,93,-3,-1.3
1998,"Nottingham Forest",1,38,30,35,69,-34,0.789473684210526,0.921052631578947,1.81578947368421,-0.894736842105263,20,20,20,20,34,117,-14,-1.9
1998,"Notts County",3,46,54,52,61,-9,1.17391304347826,1.1304347826087,1.32608695652174,-0.195652173913043,60,16,24,68,52,120,8,-3
1998,"Oldham Athletic",3,46,51,48,66,-18,1.10869565217391,1.04347826086957,1.43478260869565,-0.391304347826087,63,19,24,68,58,102,5,0.9
1998,"Oxford United",2,46,44,48,71,-23,0.956521739130435,1.04347826086957,1.54347826086957,-0.5,43,23,24,44,64,54,-21,-3.4
1998,"Peterborough United",4,46,66,72,56,16,1.43478260869565,1.56521739130435,1.21739130434783,0.347826086956522,78,10,24,92,73,60,5,3.2
1998,"Plymouth Argyle",4,46,61,58,54,4,1.32608695652174,1.26086956521739,1.17391304347826,0.0869565217391304,81,13,24,92,80,93,1,4
1998,"Port Vale",2,46,47,45,75,-30,1.02173913043478,0.978260869565217,1.6304347826087,-0.652173913043478,40,20,24,44,43,107,-3,-4.8
1998,"Portsmouth",2,46,47,57,73,-16,1.02173913043478,1.23913043478261,1.58695652173913,-0.347826086956522,41,21,24,44,40,93,1,2.6
1998,"Preston North End",3,46,79,78,50,28,1.71739130434783,1.69565217391304,1.08695652173913,0.608695652173913,49,5,24,68,45,121,4,2.2
1998,"Queens Park Rangers",2,46,47,52,61,-9,1.02173913043478,1.1304347826087,1.32608695652174,-0.195652173913043,42,22,24,44,30,93,12,1.1
1998,"Reading",3,46,61,54,63,-9,1.32608695652174,1.17391304347826,1.3695652173913,-0.195652173913043,55,11,24,68,54,93,1,3.1
1998,"Rochdale",4,46,54,42,55,-13,1.17391304347826,0.91304347826087,1.19565217391304,-0.282608695652174,86,18,24,92,78,92,8,1
1998,"Rotherham United",4,46,73,79,61,18,1.58695652173913,1.71739130434783,1.32608695652174,0.391304347826087,73,5,24,92,70,88,3,-0.1
1998,"Scarborough",4,46,48,50,77,-27,1.04347826086957,1.08695652173913,1.67391304347826,-0.58695652173913,92,24,24,92,NA,12,NA,NA
1998,"Scunthorpe United",4,46,74,69,58,11,1.60869565217391,1.5,1.26086956521739,0.239130434782609,72,4,24,92,67,70,5,2.2
1998,"Sheffield United",2,46,67,71,66,5,1.45652173913043,1.54347826086957,1.43478260869565,0.108695652173913,28,8,24,44,36,117,-8,0.5
1998,"Sheffield Wednesday",1,38,46,41,42,-1,1.21052631578947,1.07894736842105,1.10526315789474,-0.0263157894736842,13,13,20,20,19,117,-6,-1.9
1998,"Shrewsbury Town",4,46,56,52,63,-11,1.21739130434783,1.1304347826087,1.3695652173913,-0.239130434782609,83,15,24,92,90,69,-7,0.3
1998,"Southampton",1,38,41,37,64,-27,1.07894736842105,0.973684210526316,1.68421052631579,-0.710526315789474,17,17,20,20,15,93,2,-2.6
1998,"Southend United",4,46,54,52,58,-6,1.17391304347826,1.1304347826087,1.26086956521739,-0.130434782608696,87,19,24,92,85,93,2,3.5
1998,"Stockport County",2,46,53,49,60,-11,1.15217391304348,1.06521739130435,1.30434782608696,-0.239130434782609,36,16,24,44,37,99,-1,-2.2
1998,"Stoke City",3,46,69,59,63,-4,1.5,1.28260869565217,1.3695652173913,-0.0869565217391304,52,8,24,68,50,113,2,4.1
1998,"Sunderland",2,46,105,91,28,63,2.28260869565217,1.97826086956522,0.608695652173913,1.3695652173913,21,1,24,44,7,119,14,0.5
1998,"Swansea City",4,46,71,56,48,8,1.54347826086957,1.21739130434783,1.04347826086957,0.173913043478261,75,7,24,92,69,93,6,4.7
1998,"Swindon Town",2,46,50,59,81,-22,1.08695652173913,1.28260869565217,1.76086956521739,-0.478260869565217,37,17,24,44,44,93,-7,-2.3
1998,"Torquay United",4,46,53,47,58,-11,1.15217391304348,1.02173913043478,1.26086956521739,-0.239130434782609,89,21,24,92,77,78,12,1.4
1998,"Tottenham Hotspur",1,38,47,47,50,-3,1.23684210526316,1.23684210526316,1.31578947368421,-0.0789473684210526,11,11,20,20,10,101,1,0.3
1998,"Tranmere Rovers",2,46,56,63,61,2,1.21739130434783,1.3695652173913,1.32608695652174,0.0434782608695652,35,15,24,44,33,89,2,-1.6
1998,"Walsall",3,46,87,63,47,16,1.89130434782609,1.3695652173913,1.02173913043478,0.347826086956522,46,2,24,68,42,100,4,-1.1
1998,"Watford",2,46,77,65,56,9,1.67391304347826,1.41304347826087,1.21739130434783,0.195652173913043,25,5,24,44,20,93,5,-0.9
1998,"West Bromwich Albion",2,46,59,69,76,-7,1.28260869565217,1.5,1.65217391304348,-0.152173913043478,33,13,24,44,41,121,-8,1.3
1998,"West Ham United",1,38,57,46,53,-7,1.5,1.21052631578947,1.39473684210526,-0.184210526315789,5,5,20,20,9,94,-4,-0.4
1998,"Wigan Athletic",3,46,76,75,48,27,1.65217391304348,1.6304347826087,1.04347826086957,0.58695652173913,51,7,24,68,48,42,3,3.9
1998,"Wimbledon",1,38,42,40,63,-23,1.10526315789474,1.05263157894737,1.65789473684211,-0.605263157894737,16,16,20,20,18,27,-2,NA
1998,"Wolverhampton Wanderers",2,46,73,64,43,21,1.58695652173913,1.39130434782609,0.934782608695652,0.456521739130435,27,7,24,44,28,121,-1,0.6
1998,"Wrexham",3,46,53,43,62,-19,1.15217391304348,0.934782608695652,1.34782608695652,-0.41304347826087,61,17,24,68,55,80,6,NA
1998,"Wycombe Wanderers",3,46,51,52,58,-6,1.10869565217391,1.1304347826087,1.26086956521739,-0.130434782608696,64,20,24,68,57,27,7,-0.8
1998,"York City",3,46,50,56,80,-24,1.08695652173913,1.21739130434783,1.73913043478261,-0.521739130434783,65,21,24,68,88,72,-23,NA
1999,"AFC Bournemouth",3,46,57,59,62,-3,1.23913043478261,1.28260869565217,1.34782608695652,-0.0652173913043478,59,15,24,68,51,90,8,-1.1
1999,"Arsenal",1,38,73,73,43,30,1.92105263157895,1.92105263157895,1.13157894736842,0.789473684210526,2,2,20,20,2,116,0,-0.1
1999,"Aston Villa",1,38,58,46,35,11,1.52631578947368,1.21052631578947,0.921052631578947,0.289473684210526,6,6,20,20,8,121,-2,0
1999,"Barnet",4,46,75,59,53,6,1.6304347826087,1.28260869565217,1.15217391304348,0.130434782608696,74,6,24,92,92,21,-18,-0.9
1999,"Barnsley",2,46,82,88,67,21,1.78260869565217,1.91304347826087,1.45652173913043,0.456521739130435,24,4,24,44,35,111,-11,-1.3
1999,"Birmingham City",2,46,77,65,44,21,1.67391304347826,1.41304347826087,0.956521739130435,0.456521739130435,25,5,24,44,24,117,1,1.6
1999,"Blackburn Rovers",2,46,62,55,51,4,1.34782608695652,1.19565217391304,1.10869565217391,0.0869565217391304,31,11,24,44,22,121,9,2.1
1999,"Blackpool",3,46,41,49,77,-28,0.891304347826087,1.06521739130435,1.67391304347826,-0.608695652173913,66,22,24,68,75,112,-9,4
1999,"Bolton Wanderers",2,46,76,69,50,19,1.65217391304348,1.5,1.08695652173913,0.41304347826087,26,6,24,44,23,121,3,1.2
1999,"Bradford City",1,38,36,38,68,-30,0.947368421052632,1,1.78947368421053,-0.789473684210526,17,17,20,20,20,106,-3,-6.4
1999,"Brentford",3,46,52,47,61,-14,1.1304347826087,1.02173913043478,1.32608695652174,-0.304347826086957,61,17,24,68,56,93,5,0.8
1999,"Brighton & Hove Albion",4,46,67,64,46,18,1.45652173913043,1.39130434782609,1,0.391304347826087,79,11,24,92,69,93,10,2.2
1999,"Bristol City",3,46,64,59,57,2,1.39130434782609,1.28260869565217,1.23913043478261,0.0434782608695652,53,9,24,68,53,108,0,2.4
1999,"Bristol Rovers",3,46,80,69,45,24,1.73913043478261,1.5,0.978260869565217,0.521739130434783,51,7,24,68,65,92,-14,-0.3
1999,"Burnley",3,46,88,69,47,22,1.91304347826087,1.5,1.02173913043478,0.478260869565217,46,2,24,68,27,121,19,2.8
1999,"Bury",3,46,57,61,64,-3,1.23913043478261,1.32608695652174,1.39130434782609,-0.0652173913043478,60,16,24,68,59,114,1,-1.7
1999,"Cambridge United",3,46,48,64,65,-1,1.04347826086957,1.39130434782609,1.41304347826087,-0.0217391304347826,63,19,24,68,63,41,0,-2.6
1999,"Cardiff City",3,46,44,45,67,-22,0.956521739130435,0.978260869565217,1.45652173913043,-0.478260869565217,65,21,24,68,71,93,-6,4.1
1999,"Carlisle United",4,46,39,42,75,-33,0.847826086956522,0.91304347826087,1.6304347826087,-0.717391304347826,91,23,24,92,90,84,1,3.5
1999,"Charlton Athletic",2,46,91,79,45,34,1.97826086956522,1.71739130434783,0.978260869565217,0.739130434782609,21,1,24,44,9,92,12,-2.7
1999,"Chelsea",1,38,65,53,34,19,1.71052631578947,1.39473684210526,0.894736842105263,0.5,5,5,20,20,6,104,-1,0.4
1999,"Cheltenham",4,46,70,50,42,8,1.52173913043478,1.08695652173913,0.91304347826087,0.173913043478261,76,8,24,92,77,20,-1,-1.4
1999,"Chester",4,46,39,44,79,-35,0.847826086956522,0.956521739130435,1.71739130434783,-0.760869565217391,92,24,24,92,87,67,5,NA
1999,"Chesterfield",3,46,36,34,63,-29,0.782608695652174,0.739130434782609,1.3695652173913,-0.630434782608696,68,24,24,68,70,100,-2,-0.8
1999,"Colchester United",3,46,52,59,82,-23,1.1304347826087,1.28260869565217,1.78260869565217,-0.5,62,18,24,68,61,68,1,1
1999,"Coventry City",1,38,44,47,54,-7,1.15789473684211,1.23684210526316,1.42105263157895,-0.184210526315789,14,14,20,20,18,94,-4,-2.4
1999,"Crewe Alexandra",2,46,51,46,67,-21,1.10869565217391,1,1.45652173913043,-0.456521739130435,38,18,24,44,32,96,6,-4.8
1999,"Crystal Palace",2,46,54,57,67,-10,1.17391304347826,1.23913043478261,1.45652173913043,-0.217391304347826,35,15,24,44,40,93,-5,0.2
1999,"Darlington",4,46,79,66,36,30,1.71739130434783,1.43478260869565,0.782608695652174,0.652173913043478,72,4,24,92,88,81,-16,-2
1999,"Derby County",1,38,38,44,57,-13,1,1.15789473684211,1.5,-0.342105263157895,16,16,20,20,14,121,2,-1.9
1999,"Everton",1,38,50,59,49,10,1.31578947368421,1.55263157894737,1.28947368421053,0.263157894736842,13,13,20,20,15,121,-2,0.5
1999,"Exeter City",4,46,44,46,72,-26,0.956521739130435,1,1.56521739130435,-0.565217391304348,89,21,24,92,87,88,2,1.1
1999,"Fulham",2,46,67,49,41,8,1.45652173913043,1.06521739130435,0.891304347826087,0.173913043478261,29,9,24,44,21,102,8,1.7
1999,"Gillingham",3,46,85,79,48,31,1.84782608695652,1.71739130434783,1.04347826086957,0.673913043478261,47,3,24,68,33,88,14,-1.8
1999,"Grimsby Town",2,46,51,41,67,-26,1.10869565217391,0.891304347826087,1.45652173913043,-0.565217391304348,39,19,24,44,38,110,1,-5.2
1999,"Halifax Town",4,46,54,44,58,-14,1.17391304347826,0.956521739130435,1.26086956521739,-0.304347826086957,86,18,24,92,91,69,-5,NA
1999,"Hartlepool United",4,46,72,60,49,11,1.56521739130435,1.30434782608696,1.06521739130435,0.239130434782609,75,7,24,92,72,89,3,1.6
1999,"Huddersfield Town",2,46,74,62,49,13,1.60869565217391,1.34782608695652,1.06521739130435,0.282608695652174,27,7,24,44,42,99,-15,-2.4
1999,"Hull City",4,46,59,43,43,0,1.28260869565217,0.934782608695652,0.934782608695652,0,82,14,24,92,74,104,8,6.3
1999,"Ipswich Town",2,46,87,71,42,29,1.89130434782609,1.54347826086957,0.91304347826087,0.630434782608696,23,3,24,44,5,75,18,-1.3
1999,"Leeds United",1,38,69,58,43,15,1.81578947368421,1.52631578947368,1.13157894736842,0.394736842105263,3,3,20,20,4,93,-1,-4.3
1999,"Leicester City",1,38,55,55,55,0,1.44736842105263,1.44736842105263,1.44736842105263,0,8,8,20,20,13,115,-5,-1.7
1999,"Leyton Orient",4,46,52,47,52,-5,1.1304347826087,1.02173913043478,1.1304347826087,-0.108695652173913,87,19,24,92,73,102,14,2.4
1999,"Lincoln City",4,46,59,67,69,-2,1.28260869565217,1.45652173913043,1.5,-0.0434782608695652,83,15,24,92,86,107,-3,-0.5
1999,"Liverpool",1,38,67,51,30,21,1.76315789473684,1.34210526315789,0.789473684210526,0.552631578947368,4,4,20,20,3,116,1,-0.3
1999,"Luton Town",3,46,61,61,65,-4,1.32608695652174,1.32608695652174,1.41304347826087,-0.0869565217391304,56,12,24,68,66,91,-10,-2
1999,"Macclesfield",4,46,65,66,61,5,1.41304347826087,1.43478260869565,1.32608695652174,0.108695652173913,81,13,24,92,82,17,-1,-0.6
1999,"Manchester City",2,46,89,78,40,38,1.93478260869565,1.69565217391304,0.869565217391304,0.826086956521739,22,2,24,44,19,117,3,1.7
1999,"Manchester United",1,38,91,97,45,52,2.39473684210526,2.55263157894737,1.18421052631579,1.36842105263158,1,1,20,20,1,117,0,-0.1
1999,"Mansfield Town",4,46,56,50,65,-15,1.21739130434783,1.08695652173913,1.41304347826087,-0.326086956521739,84,16,24,92,80,77,4,-0.5
1999,"Middlesbrough",1,38,52,46,52,-6,1.36842105263158,1.21052631578947,1.36842105263158,-0.157894736842105,11,11,20,20,16,110,-5,-2
1999,"Millwall",3,46,82,76,50,26,1.78260869565217,1.65217391304348,1.08695652173913,0.565217391304348,49,5,24,68,45,93,4,0.2
1999,"Newcastle United",1,38,52,63,54,9,1.36842105263158,1.65789473684211,1.42105263157895,0.236842105263158,12,12,20,20,11,116,1,-0.9
1999,"Northampton Town",4,46,82,63,45,18,1.78260869565217,1.3695652173913,0.978260869565217,0.391304347826087,71,3,24,92,62,93,9,-0.8
1999,"Norwich City",2,46,57,45,50,-5,1.23913043478261,0.978260869565217,1.08695652173913,-0.108695652173913,32,12,24,44,36,93,-4,-1.3
1999,"Nottingham Forest",2,46,56,53,55,-2,1.21739130434783,1.15217391304348,1.19565217391304,-0.0434782608695652,34,14,24,44,30,117,4,1.1
1999,"Notts County",3,46,65,61,55,6,1.41304347826087,1.32608695652174,1.19565217391304,0.130434782608696,52,8,24,68,52,120,0,-1.7
1999,"Oldham Athletic",3,46,60,50,55,-5,1.30434782608696,1.08695652173913,1.19565217391304,-0.108695652173913,58,14,24,68,60,102,-2,-0.3
1999,"Oxford United",3,46,45,43,73,-30,0.978260869565217,0.934782608695652,1.58695652173913,-0.652173913043478,64,20,24,68,68,54,-4,-1.2
1999,"Peterborough United",4,46,78,63,54,9,1.69565217391304,1.3695652173913,1.17391304347826,0.195652173913043,73,5,24,92,57,60,16,2.9
1999,"Plymouth Argyle",4,46,66,55,51,4,1.43478260869565,1.19565217391304,1.10869565217391,0.0869565217391304,80,12,24,92,81,93,-1,3.7
1999,"Port Vale",2,46,36,48,69,-21,0.782608695652174,1.04347826086957,1.5,-0.456521739130435,43,23,24,44,55,107,-12,-3.5
1999,"Portsmouth",2,46,51,55,66,-11,1.10869565217391,1.19565217391304,1.43478260869565,-0.239130434782609,40,20,24,44,41,93,-1,2
1999,"Preston North End",3,46,95,74,37,37,2.06521739130435,1.60869565217391,0.804347826086957,0.804347826086957,45,1,24,68,25,121,20,0.6
1999,"Queens Park Rangers",2,46,66,62,53,9,1.43478260869565,1.34782608695652,1.15217391304348,0.195652173913043,30,10,24,44,43,93,-13,-0.4
1999,"Reading",3,46,62,57,63,-6,1.34782608695652,1.23913043478261,1.3695652173913,-0.130434782608696,54,10,24,68,47,93,7,2.4
1999,"Rochdale",4,46,68,57,54,3,1.47826086956522,1.23913043478261,1.17391304347826,0.0652173913043478,78,10,24,92,76,92,2,0.7
1999,"Rotherham United",4,46,84,72,36,36,1.82608695652174,1.56521739130435,0.782608695652174,0.782608695652174,70,2,24,92,46,88,24,-0.3
1999,"Scunthorpe United",3,46,39,40,74,-34,0.847826086956522,0.869565217391304,1.60869565217391,-0.739130434782609,67,23,24,68,78,70,-11,2.6
1999,"Sheffield United",2,46,54,59,71,-12,1.17391304347826,1.28260869565217,1.54347826086957,-0.260869565217391,36,16,24,44,31,117,5,0.8
1999,"Sheffield Wednesday",1,38,31,38,70,-32,0.815789473684211,1,1.84210526315789,-0.842105263157895,19,19,20,20,37,117,-18,-2.3
1999,"Shrewsbury Town",4,46,40,40,67,-27,0.869565217391304,0.869565217391304,1.45652173913043,-0.58695652173913,90,22,24,92,83,69,7,1.8
1999,"Southampton",1,38,44,45,62,-17,1.15789473684211,1.18421052631579,1.63157894736842,-0.447368421052632,15,15,20,20,10,93,5,-3.4
1999,"Southend United",4,46,56,53,61,-8,1.21739130434783,1.15217391304348,1.32608695652174,-0.173913043478261,85,17,24,92,79,93,6,1.8
1999,"Stockport County",2,46,54,55,67,-12,1.17391304347826,1.19565217391304,1.45652173913043,-0.260869565217391,37,17,24,44,39,99,-2,-3.1
1999,"Stoke City",3,46,82,68,42,26,1.78260869565217,1.47826086956522,0.91304347826087,0.565217391304348,50,6,24,68,49,113,1,3.9
1999,"Sunderland",1,38,58,57,56,1,1.52631578947368,1.5,1.47368421052632,0.0263157894736842,7,7,20,20,7,119,0,-0.6
1999,"Swansea City",4,46,85,51,30,21,1.84782608695652,1.10869565217391,0.652173913043478,0.456521739130435,69,1,24,92,67,93,2,4.2
1999,"Swindon Town",2,46,36,38,77,-39,0.782608695652174,0.826086956521739,1.67391304347826,-0.847826086956522,44,24,24,44,64,93,-20,-0.6
1999,"Torquay United",4,46,69,62,52,10,1.5,1.34782608695652,1.1304347826087,0.217391304347826,77,9,24,92,89,78,-12,0.4
1999,"Tottenham Hotspur",1,38,53,57,49,8,1.39473684210526,1.5,1.28947368421053,0.210526315789474,10,10,20,20,12,101,-2,0.6
1999,"Tranmere Rovers",2,46,57,57,68,-11,1.23913043478261,1.23913043478261,1.47826086956522,-0.239130434782609,33,13,24,44,44,89,-11,-3.1
1999,"Walsall",2,46,46,52,77,-25,1,1.1304347826087,1.67391304347826,-0.543478260869565,42,22,24,44,48,100,-6,-1.3
1999,"Watford",1,38,24,35,77,-42,0.631578947368421,0.921052631578947,2.02631578947368,-1.10526315789474,20,20,20,20,28,93,-8,-2
1999,"West Bromwich Albion",2,46,49,43,60,-17,1.06521739130435,0.934782608695652,1.30434782608696,-0.369565217391304,41,21,24,44,26,121,15,1.9
1999,"West Ham United",1,38,55,52,53,-1,1.44736842105263,1.36842105263158,1.39473684210526,-0.0263157894736842,9,9,20,20,17,94,-8,-0.8
1999,"Wigan Athletic",3,46,83,72,38,34,1.80434782608696,1.56521739130435,0.826086956521739,0.739130434782609,48,4,24,68,50,42,-2,3.2
1999,"Wimbledon",1,38,33,46,74,-28,0.868421052631579,1.21052631578947,1.94736842105263,-0.736842105263158,18,18,20,20,29,27,-11,NA
1999,"Wolverhampton Wanderers",2,46,74,64,48,16,1.60869565217391,1.39130434782609,1.04347826086957,0.347826086956522,28,8,24,44,34,121,-6,1.3
1999,"Wrexham",3,46,62,52,61,-9,1.34782608695652,1.1304347826087,1.32608695652174,-0.195652173913043,55,11,24,68,54,80,1,NA
1999,"Wycombe Wanderers",3,46,61,56,53,3,1.32608695652174,1.21739130434783,1.15217391304348,0.0652173913043478,57,13,24,68,58,27,-1,-0.9
1999,"York City",4,46,52,39,53,-14,1.1304347826087,0.847826086956522,1.15217391304348,-0.304347826086957,88,20,24,92,85,72,3,NA
2000,"AFC Bournemouth",3,46,73,79,55,24,1.58695652173913,1.71739130434783,1.19565217391304,0.521739130434783,51,7,24,68,65,90,-14,0.1
2000,"Arsenal",1,38,70,63,38,25,1.84210526315789,1.65789473684211,1,0.657894736842105,2,2,20,20,1,116,1,-0.2
2000,"Aston Villa",1,38,54,46,43,3,1.42105263157895,1.21052631578947,1.13157894736842,0.0789473684210526,8,8,20,20,8,121,0,-0.1
2000,"Barnet",4,46,45,67,81,-14,0.978260869565217,1.45652173913043,1.76086956521739,-0.304347826086957,92,24,24,92,83,21,9,0.9
2000,"Barnsley",2,46,54,49,62,-13,1.17391304347826,1.06521739130435,1.34782608695652,-0.282608695652174,35,15,24,44,43,111,-8,-0.2
2000,"Birmingham City",2,46,78,59,48,11,1.69565217391304,1.28260869565217,1.04347826086957,0.239130434782609,24,4,24,44,25,117,-1,0.6
2000,"Blackburn Rovers",2,46,91,76,39,37,1.97826086956522,1.65217391304348,0.847826086956522,0.804347826086957,22,2,24,44,10,121,12,0.7
2000,"Blackpool",4,46,72,74,58,16,1.56521739130435,1.60869565217391,1.26086956521739,0.347826086956522,75,7,24,92,60,112,15,5.6
2000,"Bolton Wanderers",2,46,87,76,45,31,1.89130434782609,1.65217391304348,0.978260869565217,0.673913043478261,23,3,24,44,16,121,7,1.1
2000,"Bradford City",1,38,26,30,70,-40,0.684210526315789,0.789473684210526,1.84210526315789,-1.05263157894737,20,20,20,20,35,106,-15,-6.5
2000,"Brentford",3,46,59,56,70,-14,1.28260869565217,1.21739130434783,1.52173913043478,-0.304347826086957,56,12,24,68,47,93,9,0.1
2000,"Brighton & Hove Albion",4,46,92,73,35,38,2,1.58695652173913,0.760869565217391,0.826086956521739,69,1,24,92,45,93,24,2.4
2000,"Bristol City",3,46,68,70,56,14,1.47826086956522,1.52173913043478,1.21739130434783,0.304347826086957,53,9,24,68,51,108,2,1.8
2000,"Bristol Rovers",3,46,51,53,57,-4,1.10869565217391,1.15217391304348,1.23913043478261,-0.0869565217391304,65,21,24,68,91,92,-26,-0.2
2000,"Burnley",2,46,72,50,54,-4,1.56521739130435,1.08695652173913,1.17391304347826,-0.0869565217391304,27,7,24,44,26,121,1,-0.1
2000,"Bury",3,46,58,45,59,-14,1.26086956521739,0.978260869565217,1.28260869565217,-0.304347826086957,59,15,24,68,66,114,-7,-1.1
2000,"Cambridge United",3,46,53,61,77,-16,1.15217391304348,1.32608695652174,1.67391304347826,-0.347826086956522,63,19,24,68,68,41,-5,-1.7
2000,"Cardiff City",4,46,82,95,58,37,1.78260869565217,2.06521739130435,1.26086956521739,0.804347826086957,71,3,24,92,48,93,23,4.8
2000,"Carlisle United",4,46,48,42,65,-23,1.04347826086957,0.91304347826087,1.41304347826087,-0.5,90,22,24,92,85,84,5,3.8
2000,"Charlton Athletic",1,38,52,50,57,-7,1.36842105263158,1.31578947368421,1.5,-0.184210526315789,9,9,20,20,13,92,-4,-4.8
2000,"Chelsea",1,38,61,68,45,23,1.60526315789474,1.78947368421053,1.18421052631579,0.605263157894737,6,6,20,20,6,104,0,0.4
2000,"Cheltenham",4,46,68,59,52,7,1.47826086956522,1.28260869565217,1.1304347826087,0.152173913043478,77,9,24,92,72,20,5,-0.9
2000,"Chesterfield",4,46,89,79,42,37,1.93478260869565,1.71739130434783,0.91304347826087,0.804347826086957,70,2,24,92,62,100,8,0.1
2000,"Colchester United",3,46,57,55,59,-4,1.23913043478261,1.19565217391304,1.28260869565217,-0.0869565217391304,61,17,24,68,59,68,2,0.7
2000,"Coventry City",1,38,34,36,63,-27,0.894736842105263,0.947368421052632,1.65789473684211,-0.710526315789474,18,18,20,20,30,94,-12,-2
2000,"Crewe Alexandra",2,46,55,47,62,-15,1.19565217391304,1.02173913043478,1.34782608695652,-0.326086956521739,32,12,24,44,41,96,-9,-4.6
2000,"Crystal Palace",2,46,49,57,70,-13,1.06521739130435,1.23913043478261,1.52173913043478,-0.282608695652174,40,20,24,44,31,93,9,0
2000,"Darlington",4,46,49,44,56,-12,1.06521739130435,0.956521739130435,1.21739130434783,-0.260869565217391,88,20,24,92,83,81,5,NA
2000,"Derby County",1,38,42,37,59,-22,1.10526315789474,0.973684210526316,1.55263157894737,-0.578947368421053,14,14,20,20,19,121,-5,-2.5
2000,"Everton",1,38,42,45,59,-14,1.10526315789474,1.18421052631579,1.55263157894737,-0.368421052631579,15,15,20,20,15,121,0,0.8
2000,"Exeter City",4,46,50,40,58,-18,1.08695652173913,0.869565217391304,1.26086956521739,-0.391304347826087,87,19,24,92,84,88,3,0.7
2000,"Fulham",2,46,101,90,32,58,2.19565217391304,1.95652173913043,0.695652173913043,1.26086956521739,21,1,24,44,14,102,7,1.3
2000,"Gillingham",2,46,55,61,66,-5,1.19565217391304,1.32608695652174,1.43478260869565,-0.108695652173913,33,13,24,44,32,88,1,-4.3
2000,"Grimsby Town",2,46,52,43,62,-19,1.1304347826087,0.934782608695652,1.34782608695652,-0.41304347826087,38,18,24,44,39,110,-1,-4.4
2000,"Halifax Town",4,46,47,54,68,-14,1.02173913043478,1.17391304347826,1.47826086956522,-0.304347826086957,91,23,24,92,92,69,-1,NA
2000,"Hartlepool United",4,46,77,71,54,17,1.67391304347826,1.54347826086957,1.17391304347826,0.369565217391304,72,4,24,92,75,89,-3,1.2
2000,"Huddersfield Town",2,46,48,48,57,-9,1.04347826086957,1.04347826086957,1.23913043478261,-0.195652173913043,42,22,24,44,50,99,-8,-0.5
2000,"Hull City",4,46,74,47,39,8,1.60869565217391,1.02173913043478,0.847826086956522,0.173913043478261,74,6,24,92,79,104,-5,4.3
2000,"Ipswich Town",1,38,66,57,42,15,1.73684210526316,1.5,1.10526315789474,0.394736842105263,5,5,20,20,18,75,-13,-2.7
2000,"Kidderminster Harriers",4,46,53,47,61,-14,1.15217391304348,1.02173913043478,1.32608695652174,-0.304347826086957,84,16,24,92,78,5,6,NA
2000,"Leeds United",1,38,68,64,43,21,1.78947368421053,1.68421052631579,1.13157894736842,0.552631578947368,4,4,20,20,5,93,-1,-2.3
2000,"Leicester City",1,38,48,39,51,-12,1.26315789473684,1.02631578947368,1.34210526315789,-0.315789473684211,13,13,20,20,20,115,-7,-1.6
2000,"Leyton Orient",4,46,75,59,51,8,1.6304347826087,1.28260869565217,1.10869565217391,0.173913043478261,73,5,24,92,86,102,-13,2.1
2000,"Lincoln City",4,46,51,58,66,-8,1.10869565217391,1.26086956521739,1.43478260869565,-0.173913043478261,86,18,24,92,90,107,-4,-0.5
2000,"Liverpool",1,38,69,71,39,32,1.81578947368421,1.86842105263158,1.02631578947368,0.842105263157895,3,3,20,20,2,116,1,-0.3
2000,"Luton Town",3,46,40,52,80,-28,0.869565217391304,1.1304347826087,1.73913043478261,-0.608695652173913,66,22,24,68,70,91,-4,-1.3
2000,"Macclesfield",4,46,56,51,62,-11,1.21739130434783,1.10869565217391,1.34782608695652,-0.239130434782609,82,14,24,92,80,17,2,-0.1
2000,"Manchester City",1,38,34,41,65,-24,0.894736842105263,1.07894736842105,1.71052631578947,-0.631578947368421,19,19,20,20,21,117,-2,1.6
2000,"Manchester United",1,38,80,79,31,48,2.10526315789474,2.07894736842105,0.815789473684211,1.26315789473684,1,1,20,20,3,117,-2,0
2000,"Mansfield Town",4,46,58,64,72,-8,1.26086956521739,1.39130434782609,1.56521739130435,-0.173913043478261,80,12,24,92,71,77,9,-0.1
2000,"Middlesbrough",1,38,42,44,44,0,1.10526315789474,1.15789473684211,1.15789473684211,0,16,16,20,20,11,110,5,-1.7
2000,"Millwall",3,46,93,89,38,51,2.02173913043478,1.93478260869565,0.826086956521739,1.10869565217391,45,1,24,68,24,93,21,1.5
2000,"Newcastle United",1,38,51,44,50,-6,1.34210526315789,1.15789473684211,1.31578947368421,-0.157894736842105,11,11,20,20,4,116,7,-0.2
2000,"Northampton Town",3,46,57,46,59,-13,1.23913043478261,1,1.28260869565217,-0.282608695652174,62,18,24,68,64,93,-2,-2.5
2000,"Norwich City",2,46,54,46,58,-12,1.17391304347826,1,1.26086956521739,-0.260869565217391,36,16,24,44,27,93,9,1.4
2000,"Nottingham Forest",2,46,68,55,53,2,1.47826086956522,1.19565217391304,1.15217391304348,0.0434782608695652,30,10,24,44,36,117,-6,0.4
2000,"Notts County",3,46,69,62,66,-4,1.5,1.34782608695652,1.43478260869565,-0.0869565217391304,52,8,24,68,63,120,-11,-1.2
2000,"Oldham Athletic",3,46,58,53,65,-12,1.26086956521739,1.15217391304348,1.41304347826087,-0.260869565217391,60,16,24,68,53,102,7,-0.1
2000,"Oxford United",3,46,27,53,100,-47,0.58695652173913,1.15217391304348,2.17391304347826,-1.02173913043478,68,24,24,68,89,54,-21,-1.3
2000,"Peterborough United",3,46,59,61,66,-5,1.28260869565217,1.32608695652174,1.43478260869565,-0.108695652173913,57,13,24,68,61,60,-4,0.9
2000,"Plymouth Argyle",4,46,58,54,61,-7,1.26086956521739,1.17391304347826,1.32608695652174,-0.152173913043478,81,13,24,92,69,93,12,1.8
2000,"Port Vale",3,46,62,55,49,6,1.34782608695652,1.19565217391304,1.06521739130435,0.130434782608696,55,11,24,68,58,107,-3,-2.4
2000,"Portsmouth",2,46,49,47,59,-12,1.06521739130435,1.02173913043478,1.28260869565217,-0.260869565217391,41,21,24,44,37,93,4,0.5
2000,"Preston North End",2,46,78,64,52,12,1.69565217391304,1.39130434782609,1.1304347826087,0.260869565217391,25,5,24,44,28,121,-3,-1.7
2000,"Queens Park Rangers",2,46,40,45,75,-30,0.869565217391304,0.978260869565217,1.6304347826087,-0.652173913043478,43,23,24,44,52,93,-9,2.2
2000,"Reading",3,46,86,86,52,34,1.8695652173913,1.8695652173913,1.1304347826087,0.739130434782609,47,3,24,68,46,93,1,2.2
2000,"Rochdale",4,46,71,59,48,11,1.54347826086957,1.28260869565217,1.04347826086957,0.239130434782609,76,8,24,92,73,92,3,2.3
2000,"Rotherham United",3,46,91,79,55,24,1.97826086956522,1.71739130434783,1.19565217391304,0.521739130434783,46,2,24,68,42,88,4,-3.1
2000,"Scunthorpe United",4,46,65,62,52,10,1.41304347826087,1.34782608695652,1.1304347826087,0.217391304347826,78,10,24,92,76,70,2,3.5
2000,"Sheffield United",2,46,68,52,49,3,1.47826086956522,1.1304347826087,1.06521739130435,0.0652173913043478,31,11,24,44,33,117,-2,-1.3
2000,"Sheffield Wednesday",2,46,53,52,71,-19,1.15217391304348,1.1304347826087,1.54347826086957,-0.41304347826087,37,17,24,44,40,117,-3,-2.2
2000,"Shrewsbury Town",4,46,55,49,65,-16,1.19565217391304,1.06521739130435,1.41304347826087,-0.347826086956522,83,15,24,92,77,69,6,1.3
2000,"Southampton",1,38,52,40,48,-8,1.36842105263158,1.05263157894737,1.26315789473684,-0.210526315789474,10,10,20,20,12,93,-2,-3.6
2000,"Southend United",4,46,63,55,53,2,1.3695652173913,1.19565217391304,1.15217391304348,0.0434782608695652,79,11,24,92,81,93,-2,-0.3
2000,"Stockport County",2,46,51,58,65,-7,1.10869565217391,1.26086956521739,1.41304347826087,-0.152173913043478,39,19,24,44,44,99,-5,-5.3
2000,"Stoke City",3,46,77,74,49,25,1.67391304347826,1.60869565217391,1.06521739130435,0.543478260869565,49,5,24,68,49,113,0,3.5
2000,"Sunderland",1,38,57,46,41,5,1.5,1.21052631578947,1.07894736842105,0.131578947368421,7,7,20,20,17,119,-10,-0.3
2000,"Swansea City",3,46,37,47,73,-26,0.804347826086957,1.02173913043478,1.58695652173913,-0.565217391304348,67,23,24,68,87,93,-20,4.3
2000,"Swindon Town",3,46,52,47,65,-18,1.1304347826087,1.02173913043478,1.41304347826087,-0.391304347826087,64,20,24,68,57,93,7,-0.4
2000,"Torquay United",4,46,49,52,77,-25,1.06521739130435,1.1304347826087,1.67391304347826,-0.543478260869565,89,21,24,92,88,78,1,0.1
2000,"Tottenham Hotspur",1,38,49,47,54,-7,1.28947368421053,1.23684210526316,1.42105263157895,-0.184210526315789,12,12,20,20,9,101,3,0.7
2000,"Tranmere Rovers",2,46,38,46,77,-31,0.826086956521739,1,1.67391304347826,-0.673913043478261,44,24,24,44,56,89,-12,-1.8
2000,"Walsall",3,46,81,79,50,29,1.76086956521739,1.71739130434783,1.08695652173913,0.630434782608696,48,4,24,68,38,100,10,-1.7
2000,"Watford",2,46,69,76,67,9,1.5,1.65217391304348,1.45652173913043,0.195652173913043,28,8,24,44,34,93,-6,-0.6
2000,"West Bromwich Albion",2,46,74,60,52,8,1.60869565217391,1.30434782608696,1.1304347826087,0.173913043478261,26,6,24,44,22,121,4,1.5
2000,"West Ham United",1,38,42,45,50,-5,1.10526315789474,1.18421052631579,1.31578947368421,-0.131578947368421,17,17,20,20,7,94,10,-0.3
2000,"Wigan Athletic",3,46,75,53,42,11,1.6304347826087,1.15217391304348,0.91304347826087,0.239130434782609,50,6,24,68,54,42,-4,3.4
2000,"Wimbledon",2,46,69,71,50,21,1.5,1.54347826086957,1.08695652173913,0.456521739130435,29,9,24,44,29,27,0,NA
2000,"Wolverhampton Wanderers",2,46,55,45,48,-3,1.19565217391304,0.978260869565217,1.04347826086957,-0.0652173913043478,34,14,24,44,23,121,11,1.7
2000,"Wrexham",3,46,63,65,71,-6,1.3695652173913,1.41304347826087,1.54347826086957,-0.130434782608696,54,10,24,68,67,80,-13,NA
2000,"Wycombe Wanderers",3,46,59,46,53,-7,1.28260869565217,1,1.15217391304348,-0.152173913043478,58,14,24,68,55,27,3,-1.3
2000,"York City",4,46,52,42,63,-21,1.1304347826087,0.91304347826087,1.3695652173913,-0.456521739130435,85,17,24,92,82,72,3,NA
2001,"AFC Bournemouth",3,46,44,56,71,-15,0.956521739130435,1.21739130434783,1.54347826086957,-0.326086956521739,65,21,24,68,72,90,-7,1
2001,"Arsenal",1,38,87,79,36,43,2.28947368421053,2.07894736842105,0.947368421052632,1.13157894736842,1,1,20,20,2,116,-1,-0.2
2001,"Aston Villa",1,38,50,46,47,-1,1.31578947368421,1.21052631578947,1.23684210526316,-0.0263157894736842,8,8,20,20,16,121,-8,-0.8
2001,"Barnsley",2,46,48,59,86,-27,1.04347826086957,1.28260869565217,1.8695652173913,-0.58695652173913,43,23,24,44,62,111,-19,0.1
2001,"Birmingham City",2,46,76,70,49,21,1.65217391304348,1.52173913043478,1.06521739130435,0.456521739130435,25,5,24,44,13,117,12,0.1
2001,"Blackburn Rovers",1,38,46,55,51,4,1.21052631578947,1.44736842105263,1.34210526315789,0.105263157894737,10,10,20,20,6,121,4,-0.9
2001,"Blackpool",3,46,56,66,69,-3,1.21739130434783,1.43478260869565,1.5,-0.0652173913043478,60,16,24,68,55,112,5,3.5
2001,"Bolton Wanderers",1,38,40,44,62,-18,1.05263157894737,1.15789473684211,1.63157894736842,-0.473684210526316,16,16,20,20,17,121,-1,-0.2
2001,"Bradford City",2,46,55,69,76,-7,1.19565217391304,1.5,1.65217391304348,-0.152173913043478,35,15,24,44,38,106,-3,-5.1
2001,"Brentford",3,46,83,77,43,34,1.80434782608696,1.67391304347826,0.934782608695652,0.739130434782609,47,3,24,68,60,93,-13,-0.6
2001,"Brighton & Hove Albion",3,46,90,66,42,24,1.95652173913043,1.43478260869565,0.91304347826087,0.521739130434783,45,1,24,68,43,93,2,1.6
2001,"Bristol City",3,46,73,68,53,15,1.58695652173913,1.47826086956522,1.15217391304348,0.326086956521739,51,7,24,68,47,108,4,1
2001,"Bristol Rovers",4,46,45,40,60,-20,0.978260869565217,0.869565217391304,1.30434782608696,-0.434782608695652,91,23,24,92,88,92,3,0.9
2001,"Burnley",2,46,75,70,62,8,1.6304347826087,1.52173913043478,1.34782608695652,0.173913043478261,26,6,24,44,36,121,-10,-0.7
2001,"Bury",3,46,44,43,75,-32,0.956521739130435,0.934782608695652,1.6304347826087,-0.695652173913043,66,22,24,68,74,114,-8,1
2001,"Cambridge United",3,46,34,47,93,-46,0.739130434782609,1.02173913043478,2.02173913043478,-1,68,24,24,68,80,41,-12,NA
2001,"Cardiff City",3,46,83,75,50,25,1.80434782608696,1.6304347826087,1.08695652173913,0.543478260869565,48,4,24,68,50,93,-2,2.2
2001,"Carlisle United",4,46,52,49,56,-7,1.1304347826087,1.06521739130435,1.21739130434783,-0.152173913043478,85,17,24,92,89,84,-4,2.5
2001,"Charlton Athletic",1,38,44,38,49,-11,1.15789473684211,1,1.28947368421053,-0.289473684210526,13,13,20,20,11,92,2,-3.2
2001,"Chelsea",1,38,64,66,38,28,1.68421052631579,1.73684210526316,1,0.736842105263158,6,6,20,20,4,104,2,0
2001,"Cheltenham",4,46,78,66,49,17,1.69565217391304,1.43478260869565,1.06521739130435,0.369565217391304,72,4,24,92,65,20,7,-0.2
2001,"Chesterfield",3,46,52,53,65,-12,1.1304347826087,1.15217391304348,1.41304347826087,-0.260869565217391,62,18,24,68,64,100,-2,-0.4
2001,"Colchester United",3,46,57,65,76,-11,1.23913043478261,1.41304347826087,1.65217391304348,-0.239130434782609,59,15,24,68,56,68,3,0.5
2001,"Coventry City",2,46,66,59,53,6,1.43478260869565,1.28260869565217,1.15217391304348,0.130434782608696,30,10,24,44,40,94,-10,-1.3
2001,"Crewe Alexandra",2,46,49,47,76,-29,1.06521739130435,1.02173913043478,1.65217391304348,-0.630434782608696,41,21,24,44,46,96,-5,-3.4
2001,"Crystal Palace",2,46,66,70,62,8,1.43478260869565,1.52173913043478,1.34782608695652,0.173913043478261,31,11,24,44,34,93,-3,-0.6
2001,"Darlington",4,46,56,60,71,-11,1.21739130434783,1.30434782608696,1.54347826086957,-0.239130434782609,83,15,24,92,83,81,0,NA
2001,"Derby County",1,38,30,33,63,-30,0.789473684210526,0.868421052631579,1.65789473684211,-0.789473684210526,19,19,20,20,39,121,-20,-1.2
2001,"Everton",1,38,43,45,57,-12,1.13157894736842,1.18421052631579,1.5,-0.315789473684211,15,15,20,20,7,121,8,0.8
2001,"Exeter City",4,46,55,48,73,-25,1.19565217391304,1.04347826086957,1.58695652173913,-0.543478260869565,84,16,24,92,91,88,-7,1
2001,"Fulham",1,38,44,36,44,-8,1.15789473684211,0.947368421052632,1.15789473684211,-0.210526315789474,14,14,20,20,14,102,0,0.6
2001,"Gillingham",2,46,64,64,67,-3,1.39130434782609,1.39130434782609,1.45652173913043,-0.0652173913043478,32,12,24,44,31,88,1,-4.4
2001,"Grimsby Town",2,46,50,50,72,-22,1.08695652173913,1.08695652173913,1.56521739130435,-0.478260869565217,39,19,24,44,44,110,-5,-4.7
2001,"Halifax Town",4,46,36,39,84,-45,0.782608695652174,0.847826086956522,1.82608695652174,-0.978260869565217,92,24,24,92,NA,69,NA,NA
2001,"Hartlepool United",4,46,71,74,48,26,1.54347826086957,1.60869565217391,1.04347826086957,0.565217391304348,75,7,24,92,70,89,5,1.8
2001,"Huddersfield Town",3,46,78,65,47,18,1.69565217391304,1.41304347826087,1.02173913043478,0.391304347826087,50,6,24,68,66,99,-16,0.2
2001,"Hull City",4,46,61,57,51,6,1.32608695652174,1.23913043478261,1.10869565217391,0.130434782608696,79,11,24,92,81,104,-2,5.1
2001,"Ipswich Town",1,38,36,41,64,-23,0.947368421052632,1.07894736842105,1.68421052631579,-0.605263157894737,18,18,20,20,27,75,-9,-1.6
2001,"Kidderminster Harriers",4,46,66,56,47,9,1.43478260869565,1.21739130434783,1.02173913043478,0.195652173913043,78,10,24,92,79,5,-1,NA
2001,"Leeds United",1,38,66,53,37,16,1.73684210526316,1.39473684210526,0.973684210526316,0.421052631578947,5,5,20,20,15,93,-10,-3
2001,"Leicester City",1,38,28,30,64,-34,0.736842105263158,0.789473684210526,1.68421052631579,-0.894736842105263,20,20,20,20,22,115,-2,-1
2001,"Leyton Orient",4,46,52,55,71,-16,1.1304347826087,1.19565217391304,1.54347826086957,-0.347826086956522,86,18,24,92,86,102,0,2.3
2001,"Lincoln City",4,46,46,44,62,-18,1,0.956521739130435,1.34782608695652,-0.391304347826087,90,22,24,92,75,107,15,1.5
2001,"Liverpool",1,38,80,67,30,37,2.10526315789474,1.76315789473684,0.789473684210526,0.973684210526316,2,2,20,20,5,116,-3,-0.7
2001,"Luton Town",4,46,97,96,48,48,2.10869565217391,2.08695652173913,1.04347826086957,1.04347826086957,70,2,24,92,52,91,18,-0.2
2001,"Macclesfield",4,46,58,41,52,-11,1.26086956521739,0.891304347826087,1.1304347826087,-0.239130434782609,80,12,24,92,84,17,-4,-1.2
2001,"Manchester City",2,46,99,108,52,56,2.15217391304348,2.34782608695652,1.1304347826087,1.21739130434783,21,1,24,44,9,117,12,2
2001,"Manchester United",1,38,77,87,45,42,2.02631578947368,2.28947368421053,1.18421052631579,1.10526315789474,3,3,20,20,1,117,2,0.1
2001,"Mansfield Town",4,46,79,72,60,12,1.71739130434783,1.56521739130435,1.30434782608696,0.260869565217391,71,3,24,92,67,77,4,-0.9
2001,"Middlesbrough",1,38,45,35,47,-12,1.18421052631579,0.921052631578947,1.23684210526316,-0.315789473684211,11,11,20,20,12,110,-1,-1.6
2001,"Millwall",2,46,77,69,48,21,1.67391304347826,1.5,1.04347826086957,0.456521739130435,24,4,24,44,29,93,-5,-1.2
2001,"Newcastle United",1,38,71,74,52,22,1.86842105263158,1.94736842105263,1.36842105263158,0.578947368421053,4,4,20,20,3,116,1,-0.1
2001,"Northampton Town",3,46,49,54,79,-25,1.06521739130435,1.17391304347826,1.71739130434783,-0.543478260869565,64,20,24,68,68,93,-4,-2.4
2001,"Norwich City",2,46,75,60,51,9,1.6304347826087,1.30434782608696,1.10869565217391,0.195652173913043,27,7,24,44,28,93,-1,1.7
2001,"Nottingham Forest",2,46,54,50,51,-1,1.17391304347826,1.08695652173913,1.10869565217391,-0.0217391304347826,36,16,24,44,26,117,10,-0.2
2001,"Notts County",3,46,50,59,71,-12,1.08695652173913,1.28260869565217,1.54347826086957,-0.260869565217391,63,19,24,68,58,120,5,1.3
2001,"Oldham Athletic",3,46,70,77,65,12,1.52173913043478,1.67391304347826,1.41304347826087,0.260869565217391,53,9,24,68,49,102,4,-0.6
2001,"Oxford United",4,46,47,53,62,-9,1.02173913043478,1.15217391304348,1.34782608695652,-0.195652173913043,89,21,24,92,76,54,13,1.9
2001,"Peterborough United",3,46,55,64,59,5,1.19565217391304,1.39130434782609,1.28260869565217,0.108695652173913,61,17,24,68,57,60,4,2.2
2001,"Plymouth Argyle",4,46,102,71,28,43,2.21739130434783,1.54347826086957,0.608695652173913,0.934782608695652,69,1,24,92,53,93,16,-2.1
2001,"Port Vale",3,46,58,51,62,-11,1.26086956521739,1.10869565217391,1.34782608695652,-0.239130434782609,58,14,24,68,61,107,-3,-1.9
2001,"Portsmouth",2,46,53,60,72,-12,1.15217391304348,1.30434782608696,1.56521739130435,-0.260869565217391,37,17,24,44,21,93,16,-0.3
2001,"Preston North End",2,46,72,71,59,12,1.56521739130435,1.54347826086957,1.28260869565217,0.260869565217391,28,8,24,44,32,121,-4,-3.2
2001,"Queens Park Rangers",3,46,71,60,49,11,1.54347826086957,1.30434782608696,1.06521739130435,0.239130434782609,52,8,24,68,48,93,4,3.5
2001,"Reading",3,46,84,70,43,27,1.82608695652174,1.52173913043478,0.934782608695652,0.58695652173913,46,2,24,68,24,93,22,2.5
2001,"Rochdale",4,46,78,65,52,13,1.69565217391304,1.41304347826087,1.1304347826087,0.282608695652174,73,5,24,92,87,92,-14,0.5
2001,"Rotherham United",2,46,49,52,66,-14,1.06521739130435,1.1304347826087,1.43478260869565,-0.304347826086957,42,22,24,44,35,88,7,-3.7
2001,"Rushden & Diamonds",4,46,73,69,53,16,1.58695652173913,1.5,1.15217391304348,0.347826086956522,74,6,24,92,69,5,5,NA
2001,"Scunthorpe United",4,46,71,74,56,18,1.54347826086957,1.60869565217391,1.21739130434783,0.391304347826087,76,8,24,92,73,70,3,1.4
2001,"Sheffield United",2,46,60,53,54,-1,1.30434782608696,1.15217391304348,1.17391304347826,-0.0217391304347826,33,13,24,44,23,117,10,-1.4
2001,"Sheffield Wednesday",2,46,50,49,71,-22,1.08695652173913,1.06521739130435,1.54347826086957,-0.478260869565217,40,20,24,44,42,117,-2,-0.6
2001,"Shrewsbury Town",4,46,70,64,53,11,1.52173913043478,1.39130434782609,1.15217391304348,0.239130434782609,77,9,24,92,92,69,-15,1.6
2001,"Southampton",1,38,45,46,54,-8,1.18421052631579,1.21052631578947,1.42105263157895,-0.210526315789474,12,12,20,20,8,93,4,-1
2001,"Southend United",4,46,58,51,54,-3,1.26086956521739,1.10869565217391,1.17391304347826,-0.0652173913043478,81,13,24,92,85,93,-4,0.9
2001,"Stockport County",2,46,26,42,102,-60,0.565217391304348,0.91304347826087,2.21739130434783,-1.30434782608696,44,24,24,44,59,99,-15,NA
2001,"Stoke City",3,46,80,67,40,27,1.73913043478261,1.45652173913043,0.869565217391304,0.58695652173913,49,5,24,68,41,113,8,3.6
2001,"Sunderland",1,38,40,29,51,-22,1.05263157894737,0.763157894736842,1.34210526315789,-0.578947368421053,17,17,20,20,20,119,-3,0.3
2001,"Swansea City",4,46,51,53,77,-24,1.10869565217391,1.15217391304348,1.67391304347826,-0.521739130434783,87,19,24,92,90,93,-3,7.6
2001,"Swindon Town",3,46,59,46,56,-10,1.28260869565217,1,1.21739130434783,-0.217391304347826,57,13,24,68,54,93,3,-1.2
2001,"Torquay United",4,46,51,46,63,-17,1.10869565217391,1,1.3695652173913,-0.369565217391304,88,20,24,92,77,78,11,-0.4
2001,"Tottenham Hotspur",1,38,50,49,53,-4,1.31578947368421,1.28947368421053,1.39473684210526,-0.105263157894737,9,9,20,20,10,101,-1,0.5
2001,"Tranmere Rovers",3,46,63,63,60,3,1.3695652173913,1.3695652173913,1.30434782608696,0.0652173913043478,56,12,24,68,51,89,5,-0.2
2001,"Walsall",2,46,51,51,71,-20,1.10869565217391,1.10869565217391,1.54347826086957,-0.434782608695652,38,18,24,44,37,100,1,-2.6
2001,"Watford",2,46,59,62,56,6,1.28260869565217,1.34782608695652,1.21739130434783,0.130434782608696,34,14,24,44,33,93,1,0.2
2001,"West Bromwich Albion",2,46,89,61,29,32,1.93478260869565,1.32608695652174,0.630434782608696,0.695652173913043,22,2,24,44,19,121,3,1
2001,"West Ham United",1,38,53,48,57,-9,1.39473684210526,1.26315789473684,1.5,-0.236842105263158,7,7,20,20,18,94,-11,-1.6
2001,"Wigan Athletic",3,46,64,66,51,15,1.39130434782609,1.43478260869565,1.10869565217391,0.326086956521739,54,10,24,68,45,42,9,3.9
2001,"Wimbledon",2,46,67,63,57,6,1.45652173913043,1.3695652173913,1.23913043478261,0.130434782608696,29,9,24,44,30,27,-1,NA
2001,"Wolverhampton Wanderers",2,46,86,76,43,33,1.8695652173913,1.65217391304348,0.934782608695652,0.717391304347826,23,3,24,44,25,121,-2,0.3
2001,"Wrexham",3,46,43,56,89,-33,0.934782608695652,1.21739130434783,1.93478260869565,-0.717391304347826,67,23,24,68,71,80,-4,NA
2001,"Wycombe Wanderers",3,46,64,58,64,-6,1.39130434782609,1.26086956521739,1.39130434782609,-0.130434782608696,55,11,24,68,63,27,-8,-1
2001,"York City",4,46,57,54,67,-13,1.23913043478261,1.17391304347826,1.45652173913043,-0.282608695652174,82,14,24,92,78,72,4,NA
2002,"AFC Bournemouth",4,46,74,60,48,12,1.60869565217391,1.30434782608696,1.04347826086957,0.260869565217391,72,4,24,92,53,90,19,2.6
2002,"Arsenal",1,38,78,85,42,43,2.05263157894737,2.23684210526316,1.10526315789474,1.13157894736842,2,2,20,20,1,116,1,-0.2
2002,"Aston Villa",1,38,45,42,47,-5,1.18421052631579,1.10526315789474,1.23684210526316,-0.131578947368421,16,16,20,20,5,121,11,0.2
2002,"Barnsley",3,46,52,51,64,-13,1.1304347826087,1.10869565217391,1.39130434782609,-0.282608695652174,62,18,24,68,56,111,6,2.1
2002,"Birmingham City",1,38,48,41,49,-8,1.26315789473684,1.07894736842105,1.28947368421053,-0.210526315789474,13,13,20,20,10,117,3,-1.7
2002,"Blackburn Rovers",1,38,60,52,43,9,1.57894736842105,1.36842105263158,1.13157894736842,0.236842105263158,6,6,20,20,15,121,-9,-3.1
2002,"Blackpool",3,46,58,56,64,-8,1.26086956521739,1.21739130434783,1.39130434782609,-0.173913043478261,55,11,24,68,58,112,-3,2
2002,"Bolton Wanderers",1,38,44,41,51,-10,1.15789473684211,1.07894736842105,1.34210526315789,-0.263157894736842,17,17,20,20,7,121,10,-0.9
2002,"Boston United",4,46,58,55,56,-1,1.26086956521739,1.19565217391304,1.21739130434783,-0.0217391304347826,82,14,24,92,78,5,4,NA
2002,"Bradford City",2,46,52,51,73,-22,1.1304347826087,1.10869565217391,1.58695652173913,-0.478260869565217,38,18,24,44,43,106,-5,-3.7
2002,"Brentford",3,46,54,47,56,-9,1.17391304347826,1.02173913043478,1.21739130434783,-0.195652173913043,60,16,24,68,60,93,0,1.3
2002,"Brighton & Hove Albion",2,46,45,49,67,-18,0.978260869565217,1.06521739130435,1.45652173913043,-0.391304347826087,43,23,24,44,48,93,-5,1.9
2002,"Bristol City",3,46,83,79,48,31,1.80434782608696,1.71739130434783,1.04347826086957,0.673913043478261,47,3,24,68,47,108,0,0.3
2002,"Bristol Rovers",4,46,51,50,57,-7,1.10869565217391,1.08695652173913,1.23913043478261,-0.152173913043478,88,20,24,92,83,92,5,0.7
2002,"Burnley",2,46,55,65,89,-24,1.19565217391304,1.41304347826087,1.93478260869565,-0.521739130434783,36,16,24,44,38,121,-2,0.5
2002,"Bury",4,46,70,57,56,1,1.52173913043478,1.23913043478261,1.21739130434783,0.0217391304347826,74,6,24,92,80,114,-6,0.7
2002,"Cambridge United",4,46,61,67,70,-3,1.32608695652174,1.45652173913043,1.52173913043478,-0.0652173913043478,80,12,24,92,81,41,-1,NA
2002,"Cardiff City",3,46,81,68,43,25,1.76086956521739,1.47826086956522,0.934782608695652,0.543478260869565,50,6,24,68,32,93,18,2.9
2002,"Carlisle United",4,46,49,52,78,-26,1.06521739130435,1.1304347826087,1.69565217391304,-0.565217391304348,89,21,24,92,91,84,-2,2.3
2002,"Charlton Athletic",1,38,49,45,56,-11,1.28947368421053,1.18421052631579,1.47368421052632,-0.289473684210526,11,11,20,20,8,92,3,-1.8
2002,"Chelsea",1,38,67,68,38,30,1.76315789473684,1.78947368421053,1,0.789473684210526,4,4,20,20,2,104,2,0.1
2002,"Cheltenham",3,46,48,53,68,-15,1.04347826086957,1.15217391304348,1.47826086956522,-0.326086956521739,65,21,24,68,82,20,-17,-0.8
2002,"Chesterfield",3,46,50,43,73,-30,1.08695652173913,0.934782608695652,1.58695652173913,-0.652173913043478,64,20,24,68,64,100,0,-1.2
2002,"Colchester United",3,46,58,52,56,-4,1.26086956521739,1.1304347826087,1.21739130434783,-0.0869565217391304,56,12,24,68,55,68,1,-0.7
2002,"Coventry City",2,46,50,46,62,-16,1.08695652173913,1,1.34782608695652,-0.347826086956522,40,20,24,44,33,94,7,-1.6
2002,"Crewe Alexandra",3,46,86,76,40,36,1.8695652173913,1.65217391304348,0.869565217391304,0.782608695652174,46,2,24,68,39,96,7,-1.2
2002,"Crystal Palace",2,46,59,59,52,7,1.28260869565217,1.28260869565217,1.1304347826087,0.152173913043478,34,14,24,44,25,93,9,0.9
2002,"Darlington",4,46,54,58,59,-1,1.17391304347826,1.26086956521739,1.28260869565217,-0.0217391304347826,83,15,24,92,86,81,-3,NA
2002,"Derby County",2,46,52,55,74,-19,1.1304347826087,1.19565217391304,1.60869565217391,-0.41304347826087,39,19,24,44,40,121,-1,0.7
2002,"Everton",1,38,59,48,49,-1,1.55263157894737,1.26315789473684,1.28947368421053,-0.0263157894736842,7,7,20,20,17,121,-10,0.1
2002,"Exeter City",4,46,48,50,64,-14,1.04347826086957,1.08695652173913,1.39130434782609,-0.304347826086957,91,23,24,92,70,88,21,1.9
2002,"Fulham",1,38,48,41,50,-9,1.26315789473684,1.07894736842105,1.31578947368421,-0.236842105263158,14,14,20,20,9,102,5,0.2
2002,"Gillingham",2,46,62,56,65,-9,1.34782608695652,1.21739130434783,1.41304347826087,-0.195652173913043,31,11,24,44,41,88,-10,-3.8
2002,"Grimsby Town",2,46,39,48,85,-37,0.847826086956522,1.04347826086957,1.84782608695652,-0.804347826086957,44,24,24,44,65,110,-21,-4.1
2002,"Hartlepool United",4,46,85,71,51,20,1.84782608695652,1.54347826086957,1.10869565217391,0.434782608695652,70,2,24,92,49,89,21,0.2
2002,"Huddersfield Town",3,46,45,39,61,-22,0.978260869565217,0.847826086956522,1.32608695652174,-0.478260869565217,66,22,24,68,71,99,-5,2.8
2002,"Hull City",4,46,59,58,53,5,1.28260869565217,1.26086956521739,1.15217391304348,0.108695652173913,81,13,24,92,70,104,11,5.9
2002,"Ipswich Town",2,46,70,80,64,16,1.52173913043478,1.73913043478261,1.39130434782609,0.347826086956522,27,7,24,44,26,75,1,-0.7
2002,"Kidderminster Harriers",4,46,63,62,63,-1,1.3695652173913,1.34782608695652,1.3695652173913,-0.0217391304347826,79,11,24,92,84,5,-5,NA
2002,"Leeds United",1,38,47,58,57,1,1.23684210526316,1.52631578947368,1.5,0.0263157894736842,15,15,20,20,18,93,-3,-1.8
2002,"Leicester City",2,46,92,73,40,33,2,1.58695652173913,0.869565217391304,0.717391304347826,22,2,24,44,19,115,3,-0.5
2002,"Leyton Orient",4,46,53,51,61,-10,1.15217391304348,1.10869565217391,1.32608695652174,-0.217391304347826,86,18,24,92,87,102,-1,3.5
2002,"Lincoln City",4,46,70,46,37,9,1.52173913043478,1,0.804347826086957,0.195652173913043,75,7,24,92,75,107,0,0.6
2002,"Liverpool",1,38,64,61,41,20,1.68421052631579,1.60526315789474,1.07894736842105,0.526315789473684,5,5,20,20,4,116,1,-0.2
2002,"Luton Town",3,46,65,67,62,5,1.41304347826087,1.45652173913043,1.34782608695652,0.108695652173913,52,8,24,68,54,91,-2,-1.8
2002,"Macclesfield",4,46,54,57,63,-6,1.17391304347826,1.23913043478261,1.3695652173913,-0.130434782608696,84,16,24,92,88,17,-4,-0.6
2002,"Manchester City",1,38,51,47,54,-7,1.34210526315789,1.23684210526316,1.42105263157895,-0.184210526315789,9,9,20,20,16,117,-7,0.7
2002,"Manchester United",1,38,83,74,34,40,2.18421052631579,1.94736842105263,0.894736842105263,1.05263157894737,1,1,20,20,3,117,-2,0
2002,"Mansfield Town",3,46,44,66,97,-31,0.956521739130435,1.43478260869565,2.10869565217391,-0.673913043478261,67,23,24,68,73,77,-6,-0.9
2002,"Middlesbrough",1,38,49,48,44,4,1.28947368421053,1.26315789473684,1.15789473684211,0.105263157894737,12,12,20,20,11,110,1,-2.4
2002,"Millwall",2,46,66,59,69,-10,1.43478260869565,1.28260869565217,1.5,-0.217391304347826,29,9,24,44,30,93,-1,-1.1
2002,"Newcastle United",1,38,69,63,48,15,1.81578947368421,1.65789473684211,1.26315789473684,0.394736842105263,3,3,20,20,6,116,-3,-1.2
2002,"Northampton Town",3,46,39,40,79,-39,0.847826086956522,0.869565217391304,1.71739130434783,-0.847826086956522,68,24,24,68,74,93,-6,-0.6
2002,"Norwich City",2,46,69,60,49,11,1.5,1.30434782608696,1.06521739130435,0.239130434782609,28,8,24,44,21,93,7,1.7
2002,"Nottingham Forest",2,46,74,82,50,32,1.60869565217391,1.78260869565217,1.08695652173913,0.695652173913043,26,6,24,44,34,117,-8,-0.2
2002,"Notts County",3,46,55,62,70,-8,1.19565217391304,1.34782608695652,1.52173913043478,-0.173913043478261,58,14,24,68,67,120,-9,0.1
2002,"Oldham Athletic",3,46,82,68,38,30,1.78260869565217,1.47826086956522,0.826086956521739,0.652173913043478,49,5,24,68,59,102,-10,-1.5
2002,"Oxford United",4,46,69,57,47,10,1.5,1.23913043478261,1.02173913043478,0.217391304347826,76,8,24,92,77,54,-1,2.4
2002,"Peterborough United",3,46,58,51,54,-3,1.26086956521739,1.10869565217391,1.17391304347826,-0.0652173913043478,57,13,24,68,62,60,-5,1.5
2002,"Plymouth Argyle",3,46,65,63,52,11,1.41304347826087,1.3695652173913,1.1304347826087,0.239130434782609,53,9,24,68,45,93,8,-3.6
2002,"Port Vale",3,46,53,54,70,-16,1.15217391304348,1.17391304347826,1.52173913043478,-0.347826086956522,61,17,24,68,50,107,11,-1
2002,"Portsmouth",2,46,98,97,45,52,2.1304347826087,2.10869565217391,0.978260869565217,1.1304347826087,21,1,24,44,13,93,8,-4.5
2002,"Preston North End",2,46,61,68,70,-2,1.32608695652174,1.47826086956522,1.52173913043478,-0.0434782608695652,32,12,24,44,35,121,-3,-2.7
2002,"Queens Park Rangers",3,46,83,69,45,24,1.80434782608696,1.5,0.978260869565217,0.521739130434783,48,4,24,68,46,93,2,2.8
2002,"Reading",2,46,79,61,46,15,1.71739130434783,1.32608695652174,1,0.326086956521739,24,4,24,44,29,93,-5,0.5
2002,"Rochdale",4,46,52,63,70,-7,1.1304347826087,1.3695652173913,1.52173913043478,-0.152173913043478,87,19,24,92,89,92,-2,0.8
2002,"Rotherham United",2,46,59,62,62,0,1.28260869565217,1.34782608695652,1.34782608695652,0,35,15,24,44,37,88,-2,-3.5
2002,"Rushden & Diamonds",4,46,87,73,47,26,1.89130434782609,1.58695652173913,1.02173913043478,0.565217391304348,69,1,24,92,66,5,3,NA
2002,"Scunthorpe United",4,46,72,68,49,19,1.56521739130435,1.47826086956522,1.06521739130435,0.41304347826087,73,5,24,92,90,70,-17,0.8
2002,"Sheffield United",2,46,80,72,52,20,1.73913043478261,1.56521739130435,1.1304347826087,0.434782608695652,23,3,24,44,27,117,-4,-2.6
2002,"Sheffield Wednesday",2,46,46,56,73,-17,1,1.21739130434783,1.58695652173913,-0.369565217391304,42,22,24,44,61,117,-19,0.3
2002,"Shrewsbury Town",4,46,41,62,92,-30,0.891304347826087,1.34782608695652,2,-0.652173913043478,92,24,24,92,89,69,3,2.5
2002,"Southampton",1,38,52,43,46,-3,1.36842105263158,1.13157894736842,1.21052631578947,-0.0789473684210526,8,8,20,20,12,93,-4,-0.8
2002,"Southend United",4,46,54,47,59,-12,1.17391304347826,1.02173913043478,1.28260869565217,-0.260869565217391,85,17,24,92,85,93,0,0.5
2002,"Stockport County",3,46,55,65,70,-5,1.19565217391304,1.41304347826087,1.52173913043478,-0.108695652173913,59,15,24,68,63,99,-4,NA
2002,"Stoke City",2,46,50,45,69,-24,1.08695652173913,0.978260869565217,1.5,-0.521739130434783,41,21,24,44,31,113,10,2.8
2002,"Sunderland",1,38,19,21,65,-44,0.5,0.552631578947368,1.71052631578947,-1.15789473684211,20,20,20,20,23,119,-3,0.3
2002,"Swansea City",4,46,49,48,65,-17,1.06521739130435,1.04347826086957,1.41304347826087,-0.369565217391304,90,22,24,92,79,93,11,8.1
2002,"Swindon Town",3,46,60,59,63,-4,1.30434782608696,1.28260869565217,1.3695652173913,-0.0869565217391304,54,10,24,68,51,93,3,0.4
2002,"Torquay United",4,46,66,71,71,0,1.43478260869565,1.54347826086957,1.54347826086957,0,77,9,24,92,72,78,5,NA
2002,"Tottenham Hotspur",1,38,50,51,62,-11,1.31578947368421,1.34210526315789,1.63157894736842,-0.289473684210526,10,10,20,20,14,101,-4,0.5
2002,"Tranmere Rovers",3,46,80,66,57,9,1.73913043478261,1.43478260869565,1.23913043478261,0.195652173913043,51,7,24,68,52,89,-1,-0.4
2002,"Walsall",2,46,54,57,69,-12,1.17391304347826,1.23913043478261,1.5,-0.260869565217391,37,17,24,44,42,100,-5,-1.7
2002,"Watford",2,46,60,54,70,-16,1.30434782608696,1.17391304347826,1.52173913043478,-0.347826086956522,33,13,24,44,36,93,-3,1
2002,"West Bromwich Albion",1,38,26,29,65,-36,0.684210526315789,0.763157894736842,1.71052631578947,-0.947368421052632,19,19,20,20,22,121,-3,1.1
2002,"West Ham United",1,38,42,42,59,-17,1.10526315789474,1.10526315789474,1.55263157894737,-0.447368421052632,18,18,20,20,24,94,-6,0.8
2002,"Wigan Athletic",3,46,100,68,25,43,2.17391304347826,1.47826086956522,0.543478260869565,0.934782608695652,45,1,24,68,28,42,17,2.7
2002,"Wimbledon",2,46,65,76,73,3,1.41304347826087,1.65217391304348,1.58695652173913,0.0652173913043478,30,10,24,44,44,27,-14,NA
2002,"Wolverhampton Wanderers",2,46,76,81,44,37,1.65217391304348,1.76086956521739,0.956521739130435,0.804347826086957,25,5,24,44,20,121,5,-1.8
2002,"Wrexham",4,46,84,84,50,34,1.82608695652174,1.82608695652174,1.08695652173913,0.739130434782609,71,3,24,92,57,80,14,NA
2002,"Wycombe Wanderers",3,46,52,59,66,-7,1.1304347826087,1.28260869565217,1.43478260869565,-0.152173913043478,63,19,24,68,68,27,-5,-2
2002,"York City",4,46,66,52,53,-1,1.43478260869565,1.1304347826087,1.15217391304348,-0.0217391304347826,78,10,24,92,92,72,-14,NA
2003,"AFC Bournemouth",3,46,66,56,51,5,1.43478260869565,1.21739130434783,1.10869565217391,0.108695652173913,53,9,24,68,51,90,2,2.3
2003,"Arsenal",1,38,90,73,26,47,2.36842105263158,1.92105263157895,0.684210526315789,1.23684210526316,1,1,20,20,2,116,-1,-0.3
2003,"Aston Villa",1,38,56,48,44,4,1.47368421052632,1.26315789473684,1.15789473684211,0.105263157894737,5,5,20,20,10,121,-5,-0.9
2003,"Barnsley",3,46,62,54,58,-4,1.34782608695652,1.17391304347826,1.26086956521739,-0.0869565217391304,56,12,24,68,57,111,-1,1.3
2003,"Birmingham City",1,38,50,43,48,-5,1.31578947368421,1.13157894736842,1.26315789473684,-0.131578947368421,10,10,20,20,12,117,-2,-3.1
2003,"Blackburn Rovers",1,38,44,51,59,-8,1.15789473684211,1.34210526315789,1.55263157894737,-0.210526315789474,15,15,20,20,15,121,0,-1.3
2003,"Blackpool",3,46,59,58,65,-7,1.28260869565217,1.26086956521739,1.41304347826087,-0.152173913043478,58,14,24,68,60,112,-2,1.8
2003,"Bolton Wanderers",1,38,53,48,56,-8,1.39473684210526,1.26315789473684,1.47368421052632,-0.210526315789474,7,7,20,20,5,121,2,-2.7
2003,"Boston United",4,46,59,50,54,-4,1.28260869565217,1.08695652173913,1.17391304347826,-0.0869565217391304,78,10,24,92,84,5,-6,NA
2003,"Bradford City",2,46,36,38,69,-31,0.782608695652174,0.826086956521739,1.5,-0.673913043478261,43,23,24,44,55,106,-12,-1.3
2003,"Brentford",3,46,53,52,69,-17,1.15217391304348,1.1304347826087,1.5,-0.369565217391304,60,16,24,68,48,93,12,1.4
2003,"Brighton & Hove Albion",3,46,77,64,43,21,1.67391304347826,1.39130434782609,0.934782608695652,0.456521739130435,48,4,24,68,40,93,8,2.2
2003,"Bristol City",3,46,82,58,37,21,1.78260869565217,1.26086956521739,0.804347826086957,0.456521739130435,47,3,24,68,52,108,-5,-1
2003,"Bristol Rovers",4,46,55,50,61,-11,1.19565217391304,1.08695652173913,1.32608695652174,-0.239130434782609,83,15,24,92,80,92,3,-0.7
2003,"Burnley",2,46,53,60,77,-17,1.15217391304348,1.30434782608696,1.67391304347826,-0.369565217391304,38,18,24,44,33,121,5,1.6
2003,"Bury",4,46,56,54,64,-10,1.21739130434783,1.17391304347826,1.39130434782609,-0.217391304347826,80,12,24,92,85,114,-5,0
2003,"Cambridge United",4,46,56,55,67,-12,1.21739130434783,1.19565217391304,1.45652173913043,-0.260869565217391,81,13,24,92,91,41,-10,NA
2003,"Cardiff City",2,46,65,68,58,10,1.41304347826087,1.47826086956522,1.26086956521739,0.217391304347826,32,12,24,44,36,93,-4,1.2
2003,"Carlisle United",4,46,45,46,69,-23,0.978260869565217,1,1.5,-0.5,91,23,24,92,69,84,22,0.3
2003,"Charlton Athletic",1,38,53,51,51,0,1.39473684210526,1.34210526315789,1.34210526315789,0,8,8,20,20,11,92,-3,-3
2003,"Chelsea",1,38,79,67,30,37,2.07894736842105,1.76315789473684,0.789473684210526,0.973684210526316,2,2,20,20,1,104,1,-0.1
2003,"Cheltenham",4,46,56,57,71,-14,1.21739130434783,1.23913043478261,1.54347826086957,-0.304347826086957,82,14,24,92,81,20,1,-0.3
2003,"Chesterfield",3,46,51,49,71,-22,1.10869565217391,1.06521739130435,1.54347826086957,-0.478260869565217,64,20,24,68,61,100,3,-0.5
2003,"Colchester United",3,46,64,52,56,-4,1.39130434782609,1.1304347826087,1.21739130434783,-0.0869565217391304,55,11,24,68,59,68,-4,-0.6
2003,"Coventry City",2,46,65,67,54,13,1.41304347826087,1.45652173913043,1.17391304347826,0.282608695652174,33,13,24,44,38,94,-5,-2
2003,"Crewe Alexandra",2,46,53,57,66,-9,1.15217391304348,1.23913043478261,1.43478260869565,-0.195652173913043,39,19,24,44,41,96,-2,-2.4
2003,"Crystal Palace",2,46,73,72,61,11,1.58695652173913,1.56521739130435,1.32608695652174,0.239130434782609,25,5,24,44,18,93,7,1.4
2003,"Darlington",4,46,53,53,61,-8,1.15217391304348,1.15217391304348,1.32608695652174,-0.173913043478261,86,18,24,92,74,81,12,NA
2003,"Derby County",2,46,52,53,67,-14,1.1304347826087,1.15217391304348,1.45652173913043,-0.304347826086957,40,20,24,44,24,121,16,1.7
2003,"Doncaster Rovers",4,46,92,79,37,42,2,1.71739130434783,0.804347826086957,0.91304347826087,69,1,24,92,54,88,15,2.7
2003,"Everton",1,38,39,45,57,-12,1.02631578947368,1.18421052631579,1.5,-0.315789473684211,17,17,20,20,4,121,13,1.2
2003,"Fulham",1,38,52,52,46,6,1.36842105263158,1.36842105263158,1.21052631578947,0.157894736842105,9,9,20,20,13,102,-4,-1
2003,"Gillingham",2,46,51,48,67,-19,1.10869565217391,1.04347826086957,1.45652173913043,-0.41304347826087,41,21,24,44,42,88,-1,-2.1
2003,"Grimsby Town",3,46,50,55,81,-26,1.08695652173913,1.19565217391304,1.76086956521739,-0.565217391304348,65,21,24,68,86,110,-21,-2
2003,"Hartlepool United",3,46,73,76,61,15,1.58695652173913,1.65217391304348,1.32608695652174,0.326086956521739,49,5,24,68,50,89,-1,-3.9
2003,"Huddersfield Town",4,46,81,68,52,16,1.76086956521739,1.47826086956522,1.1304347826087,0.347826086956522,71,3,24,92,53,99,18,3.5
2003,"Hull City",4,46,88,82,44,38,1.91304347826087,1.78260869565217,0.956521739130435,0.826086956521739,70,2,24,92,46,104,24,5.4
2003,"Ipswich Town",2,46,73,84,72,12,1.58695652173913,1.82608695652174,1.56521739130435,0.260869565217391,26,6,24,44,23,75,3,-0.3
2003,"Kidderminster Harriers",4,46,55,45,59,-14,1.19565217391304,0.978260869565217,1.28260869565217,-0.304347826086957,84,16,24,92,92,5,-8,NA
2003,"Leeds United",1,38,33,40,79,-39,0.868421052631579,1.05263157894737,2.07894736842105,-1.02631578947368,18,18,20,20,34,93,-16,-1.7
2003,"Leicester City",1,38,33,48,65,-17,0.868421052631579,1.26315789473684,1.71052631578947,-0.447368421052632,19,19,20,20,35,115,-16,-0.2
2003,"Leyton Orient",4,46,53,48,65,-17,1.15217391304348,1.04347826086957,1.41304347826087,-0.369565217391304,87,19,24,92,79,102,8,4
2003,"Lincoln City",4,46,74,68,47,21,1.60869565217391,1.47826086956522,1.02173913043478,0.456521739130435,75,7,24,92,75,107,0,1.4
2003,"Liverpool",1,38,60,55,37,18,1.57894736842105,1.44736842105263,0.973684210526316,0.473684210526316,4,4,20,20,6,116,-2,0.2
2003,"Luton Town",3,46,66,69,66,3,1.43478260869565,1.5,1.43478260869565,0.0652173913043478,54,10,24,68,45,91,9,0.9
2003,"Macclesfield",4,46,52,54,69,-15,1.1304347826087,1.17391304347826,1.5,-0.326086956521739,88,20,24,92,73,17,15,0.6
2003,"Manchester City",1,38,41,55,54,1,1.07894736842105,1.44736842105263,1.42105263157895,0.0263157894736842,16,16,20,20,8,117,8,1.5
2003,"Manchester United",1,38,75,64,35,29,1.97368421052632,1.68421052631579,0.921052631578947,0.763157894736842,3,3,20,20,3,117,0,-0.4
2003,"Mansfield Town",4,46,75,76,62,14,1.6304347826087,1.65217391304348,1.34782608695652,0.304347826086957,73,5,24,92,82,77,-9,0.1
2003,"Middlesbrough",1,38,48,44,52,-8,1.26315789473684,1.15789473684211,1.36842105263158,-0.210526315789474,11,11,20,20,7,110,4,-2.1
2003,"Millwall",2,46,69,55,48,7,1.5,1.19565217391304,1.04347826086957,0.152173913043478,30,10,24,44,29,93,1,-0.9
2003,"Newcastle United",1,38,56,52,40,12,1.47368421052632,1.36842105263158,1.05263157894737,0.315789473684211,6,6,20,20,14,116,-8,-0.4
2003,"Northampton Town",4,46,75,58,51,7,1.6304347826087,1.26086956521739,1.10869565217391,0.152173913043478,74,6,24,92,76,93,-2,-1.5
2003,"Norwich City",2,46,94,79,39,40,2.04347826086957,1.71739130434783,0.847826086956522,0.869565217391304,21,1,24,44,19,93,2,0.3
2003,"Nottingham Forest",2,46,60,61,58,3,1.30434782608696,1.32608695652174,1.26086956521739,0.0652173913043478,34,14,24,44,43,117,-9,0.3
2003,"Notts County",3,46,42,50,78,-28,0.91304347826087,1.08695652173913,1.69565217391304,-0.608695652173913,67,23,24,68,88,120,-21,0.3
2003,"Oldham Athletic",3,46,57,66,60,6,1.23913043478261,1.43478260869565,1.30434782608696,0.130434782608696,59,15,24,68,64,102,-5,-0.1
2003,"Oxford United",4,46,71,55,44,11,1.54347826086957,1.19565217391304,0.956521739130435,0.239130434782609,77,9,24,92,83,54,-6,1.6
2003,"Peterborough United",3,46,52,58,58,0,1.1304347826087,1.26086956521739,1.26086956521739,0,62,18,24,68,67,60,-5,1.2
2003,"Plymouth Argyle",3,46,90,85,41,44,1.95652173913043,1.84782608695652,0.891304347826087,0.956521739130435,45,1,24,68,37,93,8,-3.4
2003,"Port Vale",3,46,73,73,63,10,1.58695652173913,1.58695652173913,1.3695652173913,0.217391304347826,50,6,24,68,62,107,-12,-0.4
2003,"Portsmouth",1,38,45,47,54,-7,1.18421052631579,1.23684210526316,1.42105263157895,-0.184210526315789,13,13,20,20,16,93,-3,-6.8
2003,"Preston North End",2,46,59,69,71,-2,1.28260869565217,1.5,1.54347826086957,-0.0434782608695652,35,15,24,44,25,121,10,-1.4
2003,"Queens Park Rangers",3,46,83,80,45,35,1.80434782608696,1.73913043478261,0.978260869565217,0.760869565217391,46,2,24,68,31,93,15,2.2
2003,"Reading",2,46,70,55,57,-2,1.52173913043478,1.19565217391304,1.23913043478261,-0.0434782608695652,29,9,24,44,27,93,2,0.2
2003,"Rochdale",4,46,50,49,58,-9,1.08695652173913,1.06521739130435,1.26086956521739,-0.195652173913043,89,21,24,92,77,92,12,1.9
2003,"Rotherham United",2,46,54,53,61,-8,1.17391304347826,1.15217391304348,1.32608695652174,-0.173913043478261,37,17,24,44,44,88,-7,-1.1
2003,"Rushden & Diamonds",3,46,48,60,74,-14,1.04347826086957,1.30434782608696,1.60869565217391,-0.304347826086957,66,22,24,68,90,5,-24,NA
2003,"Scunthorpe United",4,46,49,69,72,-3,1.06521739130435,1.5,1.56521739130435,-0.0652173913043478,90,22,24,92,70,70,20,1.9
2003,"Sheffield United",2,46,71,65,56,9,1.54347826086957,1.41304347826087,1.21739130434783,0.195652173913043,27,7,24,44,28,117,-1,-2.4
2003,"Sheffield Wednesday",3,46,53,48,64,-16,1.15217391304348,1.04347826086957,1.39130434782609,-0.347826086956522,61,17,24,68,49,117,12,2.4
2003,"Southampton",1,38,47,44,45,-1,1.23684210526316,1.15789473684211,1.18421052631579,-0.0263157894736842,12,12,20,20,20,93,-8,0.4
2003,"Southend United",4,46,54,51,63,-12,1.17391304347826,1.10869565217391,1.3695652173913,-0.260869565217391,85,17,24,92,72,93,13,1.1
2003,"Stockport County",3,46,52,62,70,-8,1.1304347826087,1.34782608695652,1.52173913043478,-0.173913043478261,63,19,24,68,68,99,-5,NA
2003,"Stoke City",2,46,66,58,55,3,1.43478260869565,1.26086956521739,1.19565217391304,0.0652173913043478,31,11,24,44,32,113,-1,2.2
2003,"Sunderland",2,46,79,62,45,17,1.71739130434783,1.34782608695652,0.978260869565217,0.369565217391304,23,3,24,44,21,119,2,0.8
2003,"Swansea City",4,46,59,58,61,-3,1.28260869565217,1.26086956521739,1.32608695652174,-0.0652173913043478,79,11,24,92,71,93,8,6.7
2003,"Swindon Town",3,46,73,76,58,18,1.58695652173913,1.65217391304348,1.26086956521739,0.391304347826087,51,7,24,68,56,93,-5,-0.1
2003,"Torquay United",4,46,81,68,44,24,1.76086956521739,1.47826086956522,0.956521739130435,0.521739130434783,72,4,24,92,66,78,6,NA
2003,"Tottenham Hotspur",1,38,45,47,57,-10,1.18421052631579,1.23684210526316,1.5,-0.263157894736842,14,14,20,20,9,101,5,0.8
2003,"Tranmere Rovers",3,46,67,59,56,3,1.45652173913043,1.28260869565217,1.21739130434783,0.0652173913043478,52,8,24,68,47,89,5,-1.3
2003,"Walsall",2,46,51,45,65,-20,1.10869565217391,0.978260869565217,1.41304347826087,-0.434782608695652,42,22,24,44,58,100,-16,-1.6
2003,"Watford",2,46,57,54,68,-14,1.23913043478261,1.17391304347826,1.47826086956522,-0.304347826086957,36,16,24,44,39,93,-3,0.3
2003,"West Bromwich Albion",2,46,86,64,42,22,1.8695652173913,1.39130434782609,0.91304347826087,0.478260869565217,22,2,24,44,17,121,5,0.5
2003,"West Ham United",2,46,74,67,45,22,1.60869565217391,1.45652173913043,0.978260869565217,0.478260869565217,24,4,24,44,26,94,-2,1.1
2003,"Wigan Athletic",2,46,71,60,45,15,1.54347826086957,1.30434782608696,0.978260869565217,0.326086956521739,28,8,24,44,22,42,6,0.3
2003,"Wimbledon",2,46,29,41,89,-48,0.630434782608696,0.891304347826087,1.93478260869565,-1.04347826086957,44,24,24,44,NA,27,NA,NA
2003,"Wolverhampton Wanderers",1,38,33,38,77,-39,0.868421052631579,1,2.02631578947368,-1.02631578947368,20,20,20,20,30,121,-10,-2.5
2003,"Wrexham",3,46,60,50,60,-10,1.30434782608696,1.08695652173913,1.30434782608696,-0.217391304347826,57,13,24,68,63,80,-6,NA
2003,"Wycombe Wanderers",3,46,37,50,75,-25,0.804347826086957,1.08695652173913,1.6304347826087,-0.543478260869565,68,24,24,68,78,27,-10,-2.3
2003,"Yeovil",4,46,74,70,57,13,1.60869565217391,1.52173913043478,1.23913043478261,0.282608695652174,76,8,24,92,69,16,7,3.2
2003,"York City",4,46,44,35,66,-31,0.956521739130435,0.760869565217391,1.43478260869565,-0.673913043478261,92,24,24,92,85,72,7,NA
2004,"AFC Bournemouth",3,46,70,77,64,13,1.52173913043478,1.67391304347826,1.39130434782609,0.282608695652174,51,7,24,68,61,90,-10,3
2004,"Arsenal",1,38,83,87,36,51,2.18421052631579,2.28947368421053,0.947368421052632,1.34210526315789,2,2,20,20,4,116,-2,-0.1
2004,"Aston Villa",1,38,47,45,52,-7,1.23684210526316,1.18421052631579,1.36842105263158,-0.184210526315789,10,10,20,20,16,121,-6,-0.6
2004,"Barnsley",3,46,61,69,64,5,1.32608695652174,1.5,1.39130434782609,0.108695652173913,57,13,24,68,49,111,8,0.2
2004,"Birmingham City",1,38,45,40,46,-6,1.18421052631579,1.05263157894737,1.21052631578947,-0.157894736842105,12,12,20,20,18,117,-6,-1.8
2004,"Blackburn Rovers",1,38,42,32,43,-11,1.10526315789474,0.842105263157895,1.13157894736842,-0.289473684210526,15,15,20,20,6,121,9,-1.4
2004,"Blackpool",3,46,57,54,59,-5,1.23913043478261,1.17391304347826,1.28260869565217,-0.108695652173913,60,16,24,68,63,112,-3,1.6
2004,"Bolton Wanderers",1,38,58,49,44,5,1.52631578947368,1.28947368421053,1.15789473684211,0.131578947368421,5,5,20,20,8,121,-3,-3.3
2004,"Boston United",4,46,58,62,58,4,1.26086956521739,1.34782608695652,1.26086956521739,0.0869565217391304,84,16,24,92,78,5,6,NA
2004,"Bradford City",3,46,65,64,62,2,1.41304347826087,1.39130434782609,1.34782608695652,0.0434782608695652,55,11,24,68,55,106,0,0.4
2004,"Brentford",3,46,75,57,60,-3,1.6304347826087,1.23913043478261,1.30434782608696,-0.0652173913043478,48,4,24,68,47,93,1,2.3
2004,"Brighton & Hove Albion",2,46,51,40,65,-25,1.10869565217391,0.869565217391304,1.41304347826087,-0.543478260869565,40,20,24,44,44,93,-4,-0.1
2004,"Bristol City",3,46,70,74,57,17,1.52173913043478,1.60869565217391,1.23913043478261,0.369565217391304,52,8,24,68,53,108,-1,0.7
2004,"Bristol Rovers",4,46,60,60,57,3,1.30434782608696,1.30434782608696,1.23913043478261,0.0652173913043478,80,12,24,92,80,92,0,0.8
2004,"Burnley",2,46,60,38,39,-1,1.30434782608696,0.826086956521739,0.847826086956522,-0.0217391304347826,33,13,24,44,36,121,-3,1.4
2004,"Bury",4,46,58,54,54,0,1.26086956521739,1.17391304347826,1.17391304347826,0,85,17,24,92,87,114,-2,1.4
2004,"Cambridge United",4,46,40,39,62,-23,0.869565217391304,0.847826086956522,1.34782608695652,-0.5,91,23,24,92,87,41,4,NA
2004,"Cardiff City",2,46,54,48,51,-3,1.17391304347826,1.04347826086957,1.10869565217391,-0.0652173913043478,36,16,24,44,31,93,5,0.5
2004,"Charlton Athletic",1,38,46,42,58,-16,1.21052631578947,1.10526315789474,1.52631578947368,-0.421052631578947,11,11,20,20,13,92,-2,-2.1
2004,"Chelsea",1,38,95,72,15,57,2.5,1.89473684210526,0.394736842105263,1.5,1,1,20,20,1,104,0,0
2004,"Cheltenham",4,46,60,51,54,-3,1.30434782608696,1.10869565217391,1.17391304347826,-0.0652173913043478,81,13,24,92,73,20,8,-1
2004,"Chester",4,46,52,43,69,-26,1.1304347826087,0.934782608695652,1.5,-0.565217391304348,87,19,24,92,84,67,3,NA
2004,"Chesterfield",3,46,57,55,62,-7,1.23913043478261,1.19565217391304,1.34782608695652,-0.152173913043478,61,17,24,68,59,100,2,1.1
2004,"Colchester United",3,46,59,60,50,10,1.28260869565217,1.30434782608696,1.08695652173913,0.217391304347826,59,15,24,68,46,68,13,-0.4
2004,"Coventry City",2,46,52,61,73,-12,1.1304347826087,1.32608695652174,1.58695652173913,-0.260869565217391,38,18,24,44,28,94,10,-2.3
2004,"Crewe Alexandra",2,46,50,66,86,-20,1.08695652173913,1.43478260869565,1.8695652173913,-0.434782608695652,41,21,24,44,42,96,-1,-2.3
2004,"Crystal Palace",1,38,33,41,62,-21,0.868421052631579,1.07894736842105,1.63157894736842,-0.552631578947368,18,18,20,20,26,93,-8,0.8
2004,"Darlington",4,46,72,57,49,8,1.56521739130435,1.23913043478261,1.06521739130435,0.173913043478261,74,6,24,92,76,81,-2,NA
2004,"Derby County",2,46,76,71,60,11,1.65217391304348,1.54347826086957,1.30434782608696,0.239130434782609,24,4,24,44,40,121,-16,-0.4
2004,"Doncaster Rovers",3,46,66,65,60,5,1.43478260869565,1.41304347826087,1.30434782608696,0.108695652173913,54,10,24,68,51,88,3,-0.3
2004,"Everton",1,38,61,45,46,-1,1.60526315789474,1.18421052631579,1.21052631578947,-0.0263157894736842,4,4,20,20,11,121,-7,-0.7
2004,"Fulham",1,38,44,52,60,-8,1.15789473684211,1.36842105263158,1.57894736842105,-0.210526315789474,13,13,20,20,12,102,1,-2.4
2004,"Gillingham",2,46,50,45,66,-21,1.08695652173913,0.978260869565217,1.43478260869565,-0.456521739130435,42,22,24,44,56,88,-14,-1.4
2004,"Grimsby Town",4,46,58,51,52,-1,1.26086956521739,1.10869565217391,1.1304347826087,-0.0217391304347826,86,18,24,92,72,110,14,NA
2004,"Hartlepool United",3,46,71,76,66,10,1.54347826086957,1.65217391304348,1.43478260869565,0.217391304347826,50,6,24,68,65,89,-15,-4
2004,"Huddersfield Town",3,46,70,74,65,9,1.52173913043478,1.60869565217391,1.41304347826087,0.195652173913043,53,9,24,68,48,99,5,1.7
2004,"Hull City",3,46,86,80,53,27,1.8695652173913,1.73913043478261,1.15217391304348,0.58695652173913,46,2,24,68,38,104,8,2.8
2004,"Ipswich Town",2,46,85,85,56,29,1.84782608695652,1.84782608695652,1.21739130434783,0.630434782608696,23,3,24,44,34,75,-11,-0.3
2004,"Kidderminster Harriers",4,46,38,39,85,-46,0.826086956521739,0.847826086956522,1.84782608695652,-1,92,24,24,92,NA,5,NA,NA
2004,"Leeds United",2,46,60,49,52,-3,1.30434782608696,1.06521739130435,1.1304347826087,-0.0652173913043478,34,14,24,44,25,93,9,-0.1
2004,"Leicester City",2,46,57,49,46,3,1.23913043478261,1.06521739130435,1,0.0652173913043478,35,15,24,44,37,115,-2,2.1
2004,"Leyton Orient",4,46,63,65,67,-2,1.3695652173913,1.41304347826087,1.45652173913043,-0.0434782608695652,79,11,24,92,71,102,8,1.2
2004,"Lincoln City",4,46,72,64,47,17,1.56521739130435,1.39130434782609,1.02173913043478,0.369565217391304,75,7,24,92,75,107,0,NA
2004,"Liverpool",1,38,58,52,41,11,1.52631578947368,1.36842105263158,1.07894736842105,0.289473684210526,6,6,20,20,3,116,3,0
2004,"Luton Town",3,46,98,87,48,39,2.1304347826087,1.89130434782609,1.04347826086957,0.847826086956522,45,1,24,68,30,91,15,0.4
2004,"Macclesfield",4,46,75,60,49,11,1.6304347826087,1.30434782608696,1.06521739130435,0.239130434782609,73,5,24,92,85,17,-12,NA
2004,"Manchester City",1,38,52,47,39,8,1.36842105263158,1.23684210526316,1.02631578947368,0.210526315789474,8,8,20,20,15,117,-7,0.6
2004,"Manchester United",1,38,77,58,26,32,2.02631578947368,1.52631578947368,0.684210526315789,0.842105263157895,3,3,20,20,2,117,1,-0.1
2004,"Mansfield Town",4,46,60,56,56,0,1.30434782608696,1.21739130434783,1.21739130434783,0,82,14,24,92,86,77,-4,-0.1
2004,"Middlesbrough",1,38,55,53,46,7,1.44736842105263,1.39473684210526,1.21052631578947,0.184210526315789,7,7,20,20,14,110,-7,-1.7
2004,"Millwall",2,46,66,51,45,6,1.43478260869565,1.10869565217391,0.978260869565217,0.130434782608696,29,9,24,44,43,93,-14,-1.3
2004,"Milton Keynes Dons",3,46,51,54,68,-14,1.10869565217391,1.17391304347826,1.47826086956522,-0.304347826086957,65,21,24,68,66,16,-1,1.9
2004,"Newcastle United",1,38,44,47,57,-10,1.15789473684211,1.23684210526316,1.5,-0.263157894736842,14,14,20,20,7,116,7,-0.1
2004,"Northampton Town",4,46,72,62,51,11,1.56521739130435,1.34782608695652,1.10869565217391,0.239130434782609,76,8,24,92,70,93,6,-0.4
2004,"Norwich City",1,38,33,42,77,-35,0.868421052631579,1.10526315789474,2.02631578947368,-0.921052631578947,19,19,20,20,29,93,-10,-0.4
2004,"Nottingham Forest",2,46,44,42,66,-24,0.956521739130435,0.91304347826087,1.43478260869565,-0.521739130434783,43,23,24,44,52,117,-9,0.9
2004,"Notts County",4,46,52,46,62,-16,1.1304347826087,1,1.34782608695652,-0.347826086956522,88,20,24,92,88,120,0,2.2
2004,"Oldham Athletic",3,46,52,60,73,-13,1.1304347826087,1.30434782608696,1.58695652173913,-0.282608695652174,64,20,24,68,54,102,10,0.5
2004,"Oxford United",4,46,59,50,63,-13,1.28260869565217,1.08695652173913,1.3695652173913,-0.282608695652174,83,15,24,92,91,54,-8,2.7
2004,"Peterborough United",3,46,39,49,73,-24,0.847826086956522,1.06521739130435,1.58695652173913,-0.521739130434783,67,23,24,68,77,60,-10,1.4
2004,"Plymouth Argyle",2,46,53,52,64,-12,1.15217391304348,1.1304347826087,1.39130434782609,-0.260869565217391,37,17,24,44,35,93,2,-3.8
2004,"Port Vale",3,46,56,49,59,-10,1.21739130434783,1.06521739130435,1.28260869565217,-0.217391304347826,62,18,24,68,57,107,5,0
2004,"Portsmouth",1,38,39,43,59,-16,1.02631578947368,1.13157894736842,1.55263157894737,-0.421052631578947,16,16,20,20,17,93,-1,-6.8
2004,"Preston North End",2,46,75,67,58,9,1.6304347826087,1.45652173913043,1.26086956521739,0.195652173913043,25,5,24,44,24,121,1,-2.2
2004,"Queens Park Rangers",2,46,62,54,58,-4,1.34782608695652,1.17391304347826,1.26086956521739,-0.0869565217391304,31,11,24,44,41,93,-10,1.1
2004,"Reading",2,46,70,51,44,7,1.52173913043478,1.10869565217391,0.956521739130435,0.152173913043478,27,7,24,44,21,93,6,-1.2
2004,"Rochdale",4,46,66,54,48,6,1.43478260869565,1.17391304347826,1.04347826086957,0.130434782608696,77,9,24,92,82,92,-5,2.3
2004,"Rotherham United",2,46,29,35,69,-34,0.630434782608696,0.760869565217391,1.5,-0.739130434782609,44,24,24,44,64,88,-20,0.4
2004,"Rushden & Diamonds",4,46,44,42,63,-21,0.956521739130435,0.91304347826087,1.3695652173913,-0.456521739130435,90,22,24,92,92,5,-2,NA
2004,"Scunthorpe United",4,46,80,69,42,27,1.73913043478261,1.5,0.91304347826087,0.58695652173913,70,2,24,92,58,70,12,1
2004,"Sheffield United",2,46,67,57,56,1,1.45652173913043,1.23913043478261,1.21739130434783,0.0217391304347826,28,8,24,44,22,117,6,-2.1
2004,"Sheffield Wednesday",3,46,72,77,59,18,1.56521739130435,1.67391304347826,1.28260869565217,0.391304347826087,49,5,24,68,39,117,10,1.6
2004,"Shrewsbury Town",4,46,49,48,53,-5,1.06521739130435,1.04347826086957,1.15217391304348,-0.108695652173913,89,21,24,92,79,69,10,1.9
2004,"Southampton",1,38,32,45,66,-21,0.842105263157895,1.18421052631579,1.73684210526316,-0.552631578947368,20,20,20,20,32,93,-12,1.3
2004,"Southend United",4,46,78,65,46,19,1.69565217391304,1.41304347826087,1,0.41304347826087,72,4,24,92,45,93,27,0
2004,"Stockport County",3,46,26,49,98,-49,0.565217391304348,1.06521739130435,2.1304347826087,-1.06521739130435,68,24,24,68,89,99,-21,NA
2004,"Stoke City",2,46,61,36,38,-2,1.32608695652174,0.782608695652174,0.826086956521739,-0.0434782608695652,32,12,24,44,33,113,-1,2.3
2004,"Sunderland",2,46,94,76,41,35,2.04347826086957,1.65217391304348,0.891304347826087,0.760869565217391,21,1,24,44,20,119,1,0.4
2004,"Swansea City",4,46,80,62,43,19,1.73913043478261,1.34782608695652,0.934782608695652,0.41304347826087,71,3,24,92,50,93,21,6.3
2004,"Swindon Town",3,46,63,66,68,-2,1.3695652173913,1.43478260869565,1.47826086956522,-0.0434782608695652,56,12,24,68,67,93,-11,0.8
2004,"Torquay United",3,46,51,55,79,-24,1.10869565217391,1.19565217391304,1.71739130434783,-0.521739130434783,66,22,24,68,90,78,-24,NA
2004,"Tottenham Hotspur",1,38,52,47,41,6,1.36842105263158,1.23684210526316,1.07894736842105,0.157894736842105,9,9,20,20,5,101,4,0.4
2004,"Tranmere Rovers",3,46,79,73,55,18,1.71739130434783,1.58695652173913,1.19565217391304,0.391304347826087,47,3,24,68,62,89,-15,-4.5
2004,"Walsall",3,46,60,65,69,-4,1.30434782608696,1.41304347826087,1.5,-0.0869565217391304,58,14,24,68,68,100,-10,0
2004,"Watford",2,46,52,52,59,-7,1.1304347826087,1.1304347826087,1.28260869565217,-0.152173913043478,39,19,24,44,23,93,16,1.7
2004,"West Bromwich Albion",1,38,34,36,61,-25,0.894736842105263,0.947368421052632,1.60526315789474,-0.657894736842105,17,17,20,20,19,121,-2,0.4
2004,"West Ham United",2,46,73,66,56,10,1.58695652173913,1.43478260869565,1.21739130434783,0.217391304347826,26,6,24,44,9,94,17,1.4
2004,"Wigan Athletic",2,46,87,79,35,44,1.89130434782609,1.71739130434783,0.760869565217391,0.956521739130435,22,2,24,44,10,42,12,-2.1
2004,"Wolverhampton Wanderers",2,46,66,72,59,13,1.43478260869565,1.56521739130435,1.28260869565217,0.282608695652174,30,10,24,44,27,121,3,0.3
2004,"Wrexham",3,46,53,62,80,-18,1.15217391304348,1.34782608695652,1.73913043478261,-0.391304347826087,63,19,24,68,81,80,-18,NA
2004,"Wycombe Wanderers",4,46,65,58,52,6,1.41304347826087,1.26086956521739,1.1304347826087,0.130434782608696,78,10,24,92,74,27,4,0.5
2004,"Yeovil",4,46,83,90,65,25,1.80434782608696,1.95652173913043,1.41304347826087,0.543478260869565,69,1,24,92,60,16,9,0.1
2005,"AFC Bournemouth",3,46,55,49,53,-4,1.19565217391304,1.06521739130435,1.15217391304348,-0.0869565217391304,61,17,24,68,63,90,-2,4.6
2005,"Arsenal",1,38,67,68,31,37,1.76315789473684,1.78947368421053,0.815789473684211,0.973684210526316,4,4,20,20,3,116,1,0.2
2005,"Aston Villa",1,38,42,42,55,-13,1.10526315789474,1.10526315789474,1.44736842105263,-0.342105263157895,16,16,20,20,11,121,5,-0.4
2005,"Barnet",4,46,54,44,57,-13,1.17391304347826,0.956521739130435,1.23913043478261,-0.282608695652174,83,15,24,92,82,21,1,-0.7
2005,"Barnsley",3,46,72,62,44,18,1.56521739130435,1.34782608695652,0.956521739130435,0.391304347826087,49,5,24,68,40,111,9,-0.1
2005,"Birmingham City",1,38,34,28,50,-22,0.894736842105263,0.736842105263158,1.31578947368421,-0.578947368421053,18,18,20,20,22,117,-4,-1.2
2005,"Blackburn Rovers",1,38,63,51,42,9,1.65789473684211,1.34210526315789,1.10526315789474,0.236842105263158,6,6,20,20,10,121,-4,-2.9
2005,"Blackpool",3,46,53,56,64,-8,1.15217391304348,1.21739130434783,1.39130434782609,-0.173913043478261,63,19,24,68,47,112,16,-0.2
2005,"Bolton Wanderers",1,38,56,49,41,8,1.47368421052632,1.28947368421053,1.07894736842105,0.210526315789474,8,8,20,20,7,121,1,-3.6
2005,"Boston United",4,46,61,50,60,-10,1.32608695652174,1.08695652173913,1.30434782608696,-0.217391304347826,78,10,24,92,91,5,-13,NA
2005,"Bradford City",3,46,61,51,49,2,1.32608695652174,1.10869565217391,1.06521739130435,0.0434782608695652,55,11,24,68,66,106,-11,0.6
2005,"Brentford",3,46,76,72,52,20,1.65217391304348,1.56521739130435,1.1304347826087,0.434782608695652,47,3,24,68,68,93,-21,1.8
2005,"Brighton & Hove Albion",2,46,38,39,71,-32,0.826086956521739,0.847826086956522,1.54347826086957,-0.695652173913043,44,24,24,44,62,93,-18,2.2
2005,"Bristol City",3,46,65,66,62,4,1.41304347826087,1.43478260869565,1.34782608695652,0.0869565217391304,53,9,24,68,46,108,7,1.6
2005,"Bristol Rovers",4,46,60,59,67,-8,1.30434782608696,1.28260869565217,1.45652173913043,-0.173913043478261,80,12,24,92,74,92,6,2.6
2005,"Burnley",2,46,54,46,54,-8,1.17391304347826,1,1.17391304347826,-0.173913043478261,36,16,24,44,35,121,1,1.5
2005,"Bury",4,46,53,45,57,-12,1.15217391304348,0.978260869565217,1.23913043478261,-0.260869565217391,87,19,24,92,89,114,-2,2.9
2005,"Cardiff City",2,46,60,58,59,-1,1.30434782608696,1.26086956521739,1.28260869565217,-0.0217391304347826,31,11,24,44,33,93,-2,0.3
2005,"Carlisle United",4,46,86,84,42,42,1.8695652173913,1.82608695652174,0.91304347826087,0.91304347826087,69,1,24,92,52,84,17,-0.9
2005,"Charlton Athletic",1,38,47,41,55,-14,1.23684210526316,1.07894736842105,1.44736842105263,-0.368421052631579,13,13,20,20,19,92,-6,-2.9
2005,"Chelsea",1,38,91,72,22,50,2.39473684210526,1.89473684210526,0.578947368421053,1.31578947368421,1,1,20,20,2,104,-1,-0.9
2005,"Cheltenham",4,46,72,65,53,12,1.56521739130435,1.41304347826087,1.15217391304348,0.260869565217391,73,5,24,92,61,20,12,-1.5
2005,"Chester",4,46,54,53,59,-6,1.17391304347826,1.15217391304348,1.28260869565217,-0.130434782608696,84,16,24,92,86,67,-2,NA
2005,"Chesterfield",3,46,56,63,73,-10,1.21739130434783,1.3695652173913,1.58695652173913,-0.217391304347826,59,15,24,68,67,100,-8,-0.3
2005,"Colchester United",3,46,79,58,40,18,1.71739130434783,1.26086956521739,0.869565217391304,0.391304347826087,46,2,24,68,30,68,16,-2.1
2005,"Coventry City",2,46,63,62,65,-3,1.3695652173913,1.34782608695652,1.41304347826087,-0.0652173913043478,28,8,24,44,37,94,-9,-2.4
2005,"Crewe Alexandra",2,46,42,57,86,-29,0.91304347826087,1.23913043478261,1.8695652173913,-0.630434782608696,42,22,24,44,56,96,-14,-2.6
2005,"Crystal Palace",2,46,75,67,48,19,1.6304347826087,1.45652173913043,1.04347826086957,0.41304347826087,26,6,24,44,32,93,-6,1
2005,"Darlington",4,46,63,58,52,6,1.3695652173913,1.26086956521739,1.1304347826087,0.130434782608696,76,8,24,92,78,81,-2,NA
2005,"Derby County",2,46,50,53,67,-14,1.08695652173913,1.15217391304348,1.45652173913043,-0.304347826086957,40,20,24,44,23,121,17,1.5
2005,"Doncaster Rovers",3,46,69,55,51,4,1.5,1.19565217391304,1.10869565217391,0.0869565217391304,51,7,24,68,55,88,-4,-1.5
2005,"Everton",1,38,50,34,49,-15,1.31578947368421,0.894736842105263,1.28947368421053,-0.394736842105263,11,11,20,20,6,121,5,0
2005,"Fulham",1,38,48,48,58,-10,1.26315789473684,1.26315789473684,1.52631578947368,-0.263157894736842,12,12,20,20,16,102,-4,-2.7
2005,"Gillingham",3,46,60,50,64,-14,1.30434782608696,1.08695652173913,1.39130434782609,-0.304347826086957,56,12,24,68,58,88,-2,0.3
2005,"Grimsby Town",4,46,78,64,44,20,1.69565217391304,1.39130434782609,0.956521739130435,0.434782608695652,72,4,24,92,83,110,-11,NA
2005,"Hartlepool United",3,46,50,44,59,-15,1.08695652173913,0.956521739130435,1.28260869565217,-0.326086956521739,65,21,24,68,70,89,-5,-1.9
2005,"Huddersfield Town",3,46,73,72,59,13,1.58695652173913,1.56521739130435,1.28260869565217,0.282608695652174,48,4,24,68,59,99,-11,0.8
2005,"Hull City",2,46,52,49,55,-6,1.1304347826087,1.06521739130435,1.19565217391304,-0.130434782608696,38,18,24,44,41,104,-3,1.4
2005,"Ipswich Town",2,46,56,53,66,-13,1.21739130434783,1.15217391304348,1.43478260869565,-0.282608695652174,34,14,24,44,34,75,0,0.7
2005,"Leeds United",2,46,78,57,38,19,1.69565217391304,1.23913043478261,0.826086956521739,0.41304347826087,25,5,24,44,42,93,-17,-0.8
2005,"Leicester City",2,46,54,51,59,-8,1.17391304347826,1.10869565217391,1.28260869565217,-0.173913043478261,37,17,24,44,38,115,-1,3.6
2005,"Leyton Orient",4,46,81,67,51,16,1.76086956521739,1.45652173913043,1.10869565217391,0.347826086956522,71,3,24,92,64,102,7,-0.5
2005,"Lincoln City",4,46,66,65,53,12,1.43478260869565,1.41304347826087,1.15217391304348,0.260869565217391,75,7,24,92,73,107,2,NA
2005,"Liverpool",1,38,82,57,25,32,2.15789473684211,1.5,0.657894736842105,0.842105263157895,3,3,20,20,4,116,-1,-0.5
2005,"Luton Town",2,46,61,66,67,-1,1.32608695652174,1.43478260869565,1.45652173913043,-0.0217391304347826,30,10,24,44,44,91,-14,NA
2005,"Macclesfield",4,46,54,60,71,-11,1.17391304347826,1.30434782608696,1.54347826086957,-0.239130434782609,85,17,24,92,90,17,-5,NA
2005,"Manchester City",1,38,43,43,48,-5,1.13157894736842,1.13157894736842,1.26315789473684,-0.131578947368421,15,15,20,20,14,117,1,1.1
2005,"Manchester United",1,38,83,72,34,38,2.18421052631579,1.89473684210526,0.894736842105263,1,2,2,20,20,1,117,1,-0.3
2005,"Mansfield Town",4,46,54,59,66,-7,1.17391304347826,1.28260869565217,1.43478260869565,-0.152173913043478,86,18,24,92,85,77,1,NA
2005,"Middlesbrough",1,38,45,48,58,-10,1.18421052631579,1.26315789473684,1.52631578947368,-0.263157894736842,14,14,20,20,12,110,2,-0.9
2005,"Millwall",2,46,40,35,62,-27,0.869565217391304,0.760869565217391,1.34782608695652,-0.58695652173913,43,23,24,44,54,93,-11,-0.5
2005,"Milton Keynes Dons",3,46,50,45,66,-21,1.08695652173913,0.978260869565217,1.43478260869565,-0.456521739130435,66,22,24,68,72,16,-6,2.3
2005,"Newcastle United",1,38,58,47,42,5,1.52631578947368,1.23684210526316,1.10526315789474,0.131578947368421,7,7,20,20,13,116,-6,-1.1
2005,"Northampton Town",4,46,83,63,37,26,1.80434782608696,1.3695652173913,0.804347826086957,0.565217391304348,70,2,24,92,60,93,10,0.1
2005,"Norwich City",2,46,62,56,65,-9,1.34782608695652,1.21739130434783,1.41304347826087,-0.195652173913043,29,9,24,44,36,93,-7,1
2005,"Nottingham Forest",3,46,69,67,52,15,1.5,1.45652173913043,1.1304347826087,0.326086956521739,52,8,24,68,48,117,4,1.6
2005,"Notts County",4,46,52,48,63,-15,1.1304347826087,1.04347826086957,1.3695652173913,-0.326086956521739,88,20,24,92,80,120,8,0.3
2005,"Oldham Athletic",3,46,65,58,60,-2,1.41304347826087,1.26086956521739,1.30434782608696,-0.0434782608695652,54,10,24,68,50,102,4,-0.7
2005,"Oxford United",4,46,49,43,57,-14,1.06521739130435,0.934782608695652,1.23913043478261,-0.304347826086957,91,23,24,92,80,54,11,3.9
2005,"Peterborough United",4,46,62,57,49,8,1.34782608695652,1.23913043478261,1.06521739130435,0.173913043478261,77,9,24,92,79,60,-2,2
2005,"Plymouth Argyle",2,46,56,39,46,-7,1.21739130434783,0.847826086956522,1,-0.152173913043478,35,15,24,44,31,93,4,-3.8
2005,"Port Vale",3,46,60,49,54,-5,1.30434782608696,1.06521739130435,1.17391304347826,-0.108695652173913,57,13,24,68,57,107,0,0.1
2005,"Portsmouth",1,38,38,37,62,-25,1,0.973684210526316,1.63157894736842,-0.657894736842105,17,17,20,20,9,93,8,-5.7
2005,"Preston North End",2,46,80,59,30,29,1.73913043478261,1.28260869565217,0.652173913043478,0.630434782608696,24,4,24,44,27,121,-3,-0.7
2005,"Queens Park Rangers",2,46,50,50,65,-15,1.08695652173913,1.08695652173913,1.41304347826087,-0.326086956521739,41,21,24,44,39,93,2,0.9
2005,"Reading",2,46,106,99,32,67,2.30434782608696,2.15217391304348,0.695652173913043,1.45652173913043,21,1,24,44,8,93,13,-1.7
2005,"Rochdale",4,46,56,66,69,-3,1.21739130434783,1.43478260869565,1.5,-0.0652173913043478,82,14,24,92,77,92,5,2.8
2005,"Rotherham United",3,46,52,52,62,-10,1.1304347826087,1.1304347826087,1.34782608695652,-0.217391304347826,64,20,24,68,65,88,-1,2.3
2005,"Rushden & Diamonds",4,46,45,44,76,-32,0.978260869565217,0.956521739130435,1.65217391304348,-0.695652173913043,92,24,24,92,NA,5,NA,NA
2005,"Scunthorpe United",3,46,60,68,73,-5,1.30434782608696,1.47826086956522,1.58695652173913,-0.108695652173913,58,14,24,68,45,70,13,0.7
2005,"Sheffield United",2,46,90,76,46,30,1.95652173913043,1.65217391304348,1,0.652173913043478,22,2,24,44,17,117,5,-3.3
2005,"Sheffield Wednesday",2,46,52,39,52,-13,1.1304347826087,0.847826086956522,1.1304347826087,-0.282608695652174,39,19,24,44,29,117,10,1.3
2005,"Shrewsbury Town",4,46,61,55,55,0,1.32608695652174,1.19565217391304,1.19565217391304,0,79,11,24,92,75,69,4,1.5
2005,"Southampton",2,46,58,49,50,-1,1.26086956521739,1.06521739130435,1.08695652173913,-0.0217391304347826,32,12,24,44,26,93,6,2.6
2005,"Southend United",3,46,82,72,43,29,1.78260869565217,1.56521739130435,0.934782608695652,0.630434782608696,45,1,24,68,43,93,2,-1.4
2005,"Stockport County",4,46,52,57,78,-21,1.1304347826087,1.23913043478261,1.69565217391304,-0.456521739130435,89,21,24,92,76,99,13,NA
2005,"Stoke City",2,46,58,54,63,-9,1.26086956521739,1.17391304347826,1.3695652173913,-0.195652173913043,33,13,24,44,28,113,5,2.4
2005,"Sunderland",1,38,15,26,69,-43,0.394736842105263,0.684210526315789,1.81578947368421,-1.13157894736842,20,20,20,20,21,119,-1,0.3
2005,"Swansea City",3,46,71,78,55,23,1.54347826086957,1.69565217391304,1.19565217391304,0.5,50,6,24,68,51,93,-1,3.8
2005,"Swindon Town",3,46,48,46,65,-19,1.04347826086957,1,1.41304347826087,-0.41304347826087,67,23,24,68,71,93,-4,0.7
2005,"Torquay United",4,46,52,53,66,-13,1.1304347826087,1.15217391304348,1.43478260869565,-0.282608695652174,90,22,24,92,92,78,-2,NA
2005,"Tottenham Hotspur",1,38,65,53,38,15,1.71052631578947,1.39473684210526,1,0.394736842105263,5,5,20,20,5,101,0,0.2
2005,"Tranmere Rovers",3,46,54,50,52,-2,1.17391304347826,1.08695652173913,1.1304347826087,-0.0434782608695652,62,18,24,68,53,89,9,-1.2
2005,"Walsall",3,46,47,47,70,-23,1.02173913043478,1.02173913043478,1.52173913043478,-0.5,68,24,24,68,69,100,-1,2.1
2005,"Watford",2,46,81,77,53,24,1.76086956521739,1.67391304347826,1.15217391304348,0.521739130434783,23,3,24,44,20,93,3,1
2005,"West Bromwich Albion",1,38,30,31,58,-27,0.789473684210526,0.815789473684211,1.52631578947368,-0.710526315789474,19,19,20,20,24,121,-5,0.5
2005,"West Ham United",1,38,55,52,55,-3,1.44736842105263,1.36842105263158,1.44736842105263,-0.0789473684210526,9,9,20,20,15,94,-6,0.2
2005,"Wigan Athletic",1,38,51,45,52,-7,1.34210526315789,1.18421052631579,1.36842105263158,-0.184210526315789,10,10,20,20,18,42,-8,-3.5
2005,"Wolverhampton Wanderers",2,46,67,50,42,8,1.45652173913043,1.08695652173913,0.91304347826087,0.173913043478261,27,7,24,44,25,121,2,-0.7
2005,"Wrexham",4,46,59,61,54,7,1.28260869565217,1.32608695652174,1.17391304347826,0.152173913043478,81,13,24,92,87,80,-6,NA
2005,"Wycombe Wanderers",4,46,71,72,56,16,1.54347826086957,1.56521739130435,1.21739130434783,0.347826086956522,74,6,24,92,81,27,-7,-0.8
2005,"Yeovil",3,46,56,54,62,-8,1.21739130434783,1.17391304347826,1.34782608695652,-0.173913043478261,60,16,24,68,49,16,11,-2.7
2006,"Accrington",4,46,50,70,81,-11,1.08695652173913,1.52173913043478,1.76086956521739,-0.239130434782609,88,20,24,92,85,14,3,0.7
2006,"AFC Bournemouth",3,46,52,50,64,-14,1.1304347826087,1.08695652173913,1.39130434782609,-0.304347826086957,63,19,24,68,59,90,4,5.5
2006,"Arsenal",1,38,68,63,35,28,1.78947368421053,1.65789473684211,0.921052631578947,0.736842105263158,3,3,20,20,3,116,0,-0.2
2006,"Aston Villa",1,38,50,43,41,2,1.31578947368421,1.13157894736842,1.07894736842105,0.0526315789473684,11,11,20,20,6,121,5,-2
2006,"Barnet",4,46,59,55,70,-15,1.28260869565217,1.19565217391304,1.52173913043478,-0.326086956521739,82,14,24,92,79,21,3,NA
2006,"Barnsley",2,46,50,53,85,-32,1.08695652173913,1.15217391304348,1.84782608695652,-0.695652173913043,40,20,24,44,36,111,4,0.6
2006,"Birmingham City",2,46,86,67,42,25,1.8695652173913,1.45652173913043,0.91304347826087,0.543478260869565,22,2,24,44,19,117,3,-1.6
2006,"Blackburn Rovers",1,38,52,52,54,-2,1.36842105263158,1.36842105263158,1.42105263157895,-0.0526315789473684,10,10,20,20,7,121,3,-3.1
2006,"Blackpool",3,46,83,76,49,27,1.80434782608696,1.65217391304348,1.06521739130435,0.58695652173913,47,3,24,68,39,112,8,-2.8
2006,"Bolton Wanderers",1,38,56,47,52,-5,1.47368421052632,1.23684210526316,1.36842105263158,-0.131578947368421,7,7,20,20,16,121,-9,-3.9
2006,"Boston United",4,46,46,51,80,-29,1,1.10869565217391,1.73913043478261,-0.630434782608696,91,23,24,92,NA,5,NA,NA
2006,"Bradford City",3,46,47,47,65,-18,1.02173913043478,1.02173913043478,1.41304347826087,-0.391304347826087,66,22,24,68,78,106,-12,1.7
2006,"Brentford",3,46,37,40,79,-39,0.804347826086957,0.869565217391304,1.71739130434783,-0.847826086956522,68,24,24,68,81,93,-13,3.8
2006,"Brighton & Hove Albion",3,46,53,49,58,-9,1.15217391304348,1.06521739130435,1.26086956521739,-0.195652173913043,62,18,24,68,51,93,11,4
2006,"Bristol City",3,46,85,63,39,24,1.84782608695652,1.3695652173913,0.847826086956522,0.521739130434783,46,2,24,68,24,108,22,0.9
2006,"Bristol Rovers",4,46,72,49,42,7,1.56521739130435,1.06521739130435,0.91304347826087,0.152173913043478,74,6,24,92,61,92,13,1.7
2006,"Burnley",2,46,57,52,49,3,1.23913043478261,1.1304347826087,1.06521739130435,0.0652173913043478,35,15,24,44,33,121,2,1.9
2006,"Bury",4,46,50,46,61,-15,1.08695652173913,1,1.32608695652174,-0.326086956521739,89,21,24,92,82,114,7,2.6
2006,"Cardiff City",2,46,64,57,53,4,1.39130434782609,1.23913043478261,1.15217391304348,0.0869565217391304,33,13,24,44,30,93,3,0.1
2006,"Carlisle United",3,46,68,54,55,-1,1.47826086956522,1.17391304347826,1.19565217391304,-0.0217391304347826,52,8,24,68,48,84,4,-2.1
2006,"Charlton Athletic",1,38,34,34,60,-26,0.894736842105263,0.894736842105263,1.57894736842105,-0.684210526315789,19,19,20,20,31,92,-12,-3.8
2006,"Chelsea",1,38,83,64,24,40,2.18421052631579,1.68421052631579,0.631578947368421,1.05263157894737,2,2,20,20,2,104,0,0.1
2006,"Cheltenham",3,46,54,49,61,-12,1.17391304347826,1.06521739130435,1.32608695652174,-0.260869565217391,61,17,24,68,64,20,-3,-2.4
2006,"Chester",4,46,53,40,48,-8,1.15217391304348,0.869565217391304,1.04347826086957,-0.173913043478261,86,18,24,92,90,67,-4,NA
2006,"Chesterfield",3,46,47,45,53,-8,1.02173913043478,0.978260869565217,1.15217391304348,-0.173913043478261,67,23,24,68,77,100,-10,-0.1
2006,"Colchester United",2,46,69,70,56,14,1.5,1.52173913043478,1.21739130434783,0.304347826086957,30,10,24,44,44,68,-14,-4.6
2006,"Coventry City",2,46,56,47,62,-15,1.21739130434783,1.02173913043478,1.34782608695652,-0.326086956521739,37,17,24,44,41,94,-4,-3
2006,"Crewe Alexandra",3,46,60,66,72,-6,1.30434782608696,1.43478260869565,1.56521739130435,-0.130434782608696,56,12,24,68,65,96,-9,-2.9
2006,"Crystal Palace",2,46,65,59,51,8,1.41304347826087,1.28260869565217,1.10869565217391,0.173913043478261,32,12,24,44,25,93,7,1.8
2006,"Darlington",4,46,65,52,56,-4,1.41304347826087,1.1304347826087,1.21739130434783,-0.0869565217391304,78,10,24,92,74,81,4,NA
2006,"Derby County",2,46,84,62,46,16,1.82608695652174,1.34782608695652,1,0.347826086956522,23,3,24,44,20,121,3,-0.6
2006,"Doncaster Rovers",3,46,63,52,47,5,1.3695652173913,1.1304347826087,1.02173913043478,0.108695652173913,55,11,24,68,49,88,6,-1.6
2006,"Everton",1,38,58,52,36,16,1.52631578947368,1.36842105263158,0.947368421052632,0.421052631578947,6,6,20,20,5,121,1,-0.1
2006,"Fulham",1,38,39,38,60,-22,1.02631578947368,1,1.57894736842105,-0.578947368421053,16,16,20,20,17,102,-1,-1
2006,"Gillingham",3,46,59,56,77,-21,1.28260869565217,1.21739130434783,1.67391304347826,-0.456521739130435,58,14,24,68,66,88,-8,-0.6
2006,"Grimsby Town",4,46,59,57,73,-16,1.28260869565217,1.23913043478261,1.58695652173913,-0.347826086956522,83,15,24,92,84,110,-1,NA
2006,"Hartlepool United",4,46,88,65,40,25,1.91304347826087,1.41304347826087,0.869565217391304,0.543478260869565,70,2,24,92,60,89,10,-2.1
2006,"Hereford United",4,46,55,45,53,-8,1.19565217391304,0.978260869565217,1.15217391304348,-0.173913043478261,84,16,24,92,71,31,13,NA
2006,"Huddersfield Town",3,46,59,60,69,-9,1.28260869565217,1.30434782608696,1.5,-0.195652173913043,59,15,24,68,53,99,6,3.5
2006,"Hull City",2,46,49,51,67,-16,1.06521739130435,1.10869565217391,1.45652173913043,-0.347826086956522,41,21,24,44,23,104,18,2.3
2006,"Ipswich Town",2,46,62,64,59,5,1.34782608695652,1.39130434782609,1.28260869565217,0.108695652173913,34,14,24,44,28,75,6,-0.2
2006,"Leeds United",2,46,46,46,72,-26,1,1,1.56521739130435,-0.565217391304348,42,22,24,44,46,93,-4,1.5
2006,"Leicester City",2,46,53,49,64,-15,1.15217391304348,1.06521739130435,1.39130434782609,-0.326086956521739,38,18,24,44,42,115,-4,2.6
2006,"Leyton Orient",3,46,51,61,77,-16,1.10869565217391,1.32608695652174,1.67391304347826,-0.347826086956522,64,20,24,68,58,102,6,-2.8
2006,"Lincoln City",4,46,74,70,59,11,1.60869565217391,1.52173913043478,1.28260869565217,0.239130434782609,73,5,24,92,83,107,-10,NA
2006,"Liverpool",1,38,68,57,27,30,1.78947368421053,1.5,0.710526315789474,0.789473684210526,4,4,20,20,4,116,0,0
2006,"Luton Town",2,46,40,53,81,-28,0.869565217391304,1.15217391304348,1.76086956521739,-0.608695652173913,44,24,24,44,67,91,-23,NA
2006,"Macclesfield",4,46,48,55,77,-22,1.04347826086957,1.19565217391304,1.67391304347826,-0.478260869565217,90,22,24,92,86,17,4,NA
2006,"Manchester City",1,38,42,29,44,-15,1.10526315789474,0.763157894736842,1.15789473684211,-0.394736842105263,14,14,20,20,9,117,5,1.1
2006,"Manchester United",1,38,89,83,27,56,2.34210526315789,2.18421052631579,0.710526315789474,1.47368421052632,1,1,20,20,1,117,0,-0.5
2006,"Mansfield Town",4,46,54,58,63,-5,1.17391304347826,1.26086956521739,1.3695652173913,-0.108695652173913,85,17,24,92,91,77,-6,NA
2006,"Middlesbrough",1,38,46,44,49,-5,1.21052631578947,1.15789473684211,1.28947368421053,-0.131578947368421,12,12,20,20,13,110,-1,-0.7
2006,"Millwall",3,46,66,59,62,-3,1.43478260869565,1.28260869565217,1.34782608695652,-0.0652173913043478,54,10,24,68,62,93,-8,0.4
2006,"Milton Keynes Dons",4,46,84,76,58,18,1.82608695652174,1.65217391304348,1.26086956521739,0.391304347826087,72,4,24,92,69,16,3,1.6
2006,"Newcastle United",1,38,43,38,47,-9,1.13157894736842,1,1.23684210526316,-0.236842105263158,13,13,20,20,12,116,1,-0.8
2006,"Northampton Town",3,46,59,48,51,-3,1.28260869565217,1.04347826086957,1.10869565217391,-0.0652173913043478,60,16,24,68,54,93,6,0
2006,"Norwich City",2,46,57,56,71,-15,1.23913043478261,1.21739130434783,1.54347826086957,-0.326086956521739,36,16,24,44,37,93,-1,0.8
2006,"Nottingham Forest",3,46,82,65,41,24,1.78260869565217,1.41304347826087,0.891304347826087,0.521739130434783,48,4,24,68,47,117,1,0.6
2006,"Notts County",4,46,62,55,53,2,1.34782608695652,1.19565217391304,1.15217391304348,0.0434782608695652,80,12,24,92,89,120,-9,-0.4
2006,"Oldham Athletic",3,46,75,69,47,22,1.6304347826087,1.5,1.02173913043478,0.478260869565217,50,6,24,68,52,102,-2,-1.1
2006,"Peterborough United",4,46,65,70,61,9,1.41304347826087,1.52173913043478,1.32608695652174,0.195652173913043,79,11,24,92,70,60,9,2.4
2006,"Plymouth Argyle",2,46,67,63,62,1,1.45652173913043,1.3695652173913,1.34782608695652,0.0217391304347826,31,11,24,44,32,93,-1,-3.8
2006,"Port Vale",3,46,60,64,65,-1,1.30434782608696,1.39130434782609,1.41304347826087,-0.0217391304347826,57,13,24,68,68,107,-11,-0.8
2006,"Portsmouth",1,38,54,45,42,3,1.42105263157895,1.18421052631579,1.10526315789474,0.0789473684210526,9,9,20,20,8,93,1,-6.1
2006,"Preston North End",2,46,74,64,53,11,1.60869565217391,1.39130434782609,1.15217391304348,0.239130434782609,27,7,24,44,35,121,-8,-0.6
2006,"Queens Park Rangers",2,46,53,54,68,-14,1.15217391304348,1.17391304347826,1.47826086956522,-0.304347826086957,39,19,24,44,34,93,5,0
2006,"Reading",1,38,55,52,47,5,1.44736842105263,1.36842105263158,1.23684210526316,0.131578947368421,8,8,20,20,18,93,-10,-1.5
2006,"Rochdale",4,46,66,70,50,20,1.43478260869565,1.52173913043478,1.08695652173913,0.434782608695652,77,9,24,92,73,92,4,2.4
2006,"Rotherham United",3,46,48,58,75,-17,1.04347826086957,1.26086956521739,1.6304347826087,-0.369565217391304,65,21,24,68,76,88,-11,2.1
2006,"Scunthorpe United",3,46,91,73,35,38,1.97826086956522,1.58695652173913,0.760869565217391,0.826086956521739,45,1,24,68,43,70,2,-0.3
2006,"Sheffield United",1,38,38,32,55,-23,1,0.842105263157895,1.44736842105263,-0.605263157894737,17,17,20,20,29,117,-12,-2.8
2006,"Sheffield Wednesday",2,46,71,70,66,4,1.54347826086957,1.52173913043478,1.43478260869565,0.0869565217391304,29,9,24,44,38,117,-9,0.4
2006,"Shrewsbury Town",4,46,71,68,46,22,1.54347826086957,1.47826086956522,1,0.478260869565217,75,7,24,92,87,69,-12,1.3
2006,"Southampton",2,46,75,77,53,24,1.6304347826087,1.67391304347826,1.15217391304348,0.521739130434783,26,6,24,44,40,93,-14,1.7
2006,"Southend United",2,46,42,47,80,-33,0.91304347826087,1.02173913043478,1.73913043478261,-0.717391304347826,43,23,24,44,50,93,-7,-0.8
2006,"Stockport County",4,46,71,65,54,11,1.54347826086957,1.41304347826087,1.17391304347826,0.239130434782609,76,8,24,92,72,99,4,NA
2006,"Stoke City",2,46,73,62,41,21,1.58695652173913,1.34782608695652,0.891304347826087,0.456521739130435,28,8,24,44,22,113,6,1.5
2006,"Sunderland",2,46,88,76,47,29,1.91304347826087,1.65217391304348,1.02173913043478,0.630434782608696,21,1,24,44,15,119,6,0.1
2006,"Swansea City",3,46,72,69,53,16,1.56521739130435,1.5,1.15217391304348,0.347826086956522,51,7,24,68,45,93,6,3.6
2006,"Swindon Town",4,46,85,58,38,20,1.84782608695652,1.26086956521739,0.826086956521739,0.434782608695652,71,3,24,92,57,93,14,0.5
2006,"Torquay United",4,46,35,36,63,-27,0.760869565217391,0.782608695652174,1.3695652173913,-0.58695652173913,92,24,24,92,85,78,7,NA
2006,"Tottenham Hotspur",1,38,60,57,54,3,1.57894736842105,1.5,1.42105263157895,0.0789473684210526,5,5,20,20,11,101,-6,0.3
2006,"Tranmere Rovers",3,46,67,58,53,5,1.45652173913043,1.26086956521739,1.15217391304348,0.108695652173913,53,9,24,68,55,89,-2,-0.9
2006,"Walsall",4,46,89,66,34,32,1.93478260869565,1.43478260869565,0.739130434782609,0.695652173913043,69,1,24,92,56,100,13,1.1
2006,"Watford",1,38,28,29,59,-30,0.736842105263158,0.763157894736842,1.55263157894737,-0.789473684210526,20,20,20,20,26,93,-6,0.3
2006,"West Bromwich Albion",2,46,76,81,55,26,1.65217391304348,1.76086956521739,1.19565217391304,0.565217391304348,24,4,24,44,21,121,3,1.4
2006,"West Ham United",1,38,41,35,59,-24,1.07894736842105,0.921052631578947,1.55263157894737,-0.631578947368421,15,15,20,20,10,94,5,0.4
2006,"Wigan Athletic",1,38,38,37,59,-22,1,0.973684210526316,1.55263157894737,-0.578947368421053,18,18,20,20,14,42,4,-2.5
2006,"Wolverhampton Wanderers",2,46,76,59,56,3,1.65217391304348,1.28260869565217,1.21739130434783,0.0652173913043478,25,5,24,44,27,121,-2,-1
2006,"Wrexham",4,46,51,43,65,-22,1.10869565217391,0.934782608695652,1.41304347826087,-0.478260869565217,87,19,24,92,92,80,-5,NA
2006,"Wycombe Wanderers",4,46,62,52,47,5,1.34782608695652,1.1304347826087,1.02173913043478,0.108695652173913,81,13,24,92,75,27,6,0.4
2006,"Yeovil",3,46,79,55,39,16,1.71739130434783,1.19565217391304,0.847826086956522,0.347826086956522,49,5,24,68,63,16,-14,-4
2007,"Accrington",4,46,51,49,83,-34,1.10869565217391,1.06521739130435,1.80434782608696,-0.739130434782609,85,17,24,92,86,14,-1,1.6
2007,"AFC Bournemouth",3,46,58,62,72,-10,1.26086956521739,1.34782608695652,1.56521739130435,-0.217391304347826,59,15,24,68,80,90,-21,4.9
2007,"Arsenal",1,38,83,74,31,43,2.18421052631579,1.94736842105263,0.815789473684211,1.13157894736842,3,3,20,20,4,116,-1,-0.3
2007,"Aston Villa",1,38,60,71,51,20,1.57894736842105,1.86842105263158,1.34210526315789,0.526315789473684,6,6,20,20,6,121,0,-1.8
2007,"Barnet",4,46,60,56,63,-7,1.30434782608696,1.21739130434783,1.3695652173913,-0.152173913043478,79,11,24,92,87,21,-8,NA
2007,"Barnsley",2,46,55,52,65,-13,1.19565217391304,1.1304347826087,1.41304347826087,-0.282608695652174,36,16,24,44,40,111,-4,-0.6
2007,"Birmingham City",1,38,35,46,62,-16,0.921052631578947,1.21052631578947,1.63157894736842,-0.421052631578947,19,19,20,20,22,117,-3,-2
2007,"Blackburn Rovers",1,38,58,50,48,2,1.52631578947368,1.31578947368421,1.26315789473684,0.0526315789473684,7,7,20,20,13,121,-6,-3.9
2007,"Blackpool",2,46,54,59,64,-5,1.17391304347826,1.28260869565217,1.39130434782609,-0.108695652173913,39,19,24,44,36,112,3,-1.7
2007,"Bolton Wanderers",1,38,37,36,54,-18,0.973684210526316,0.947368421052632,1.42105263157895,-0.473684210526316,16,16,20,20,14,121,2,-2.5
2007,"Bradford City",4,46,62,63,61,2,1.34782608695652,1.3695652173913,1.32608695652174,0.0434782608695652,78,10,24,92,79,106,-1,2.4
2007,"Brentford",4,46,59,52,70,-18,1.28260869565217,1.1304347826087,1.52173913043478,-0.391304347826087,81,13,24,92,69,93,12,5.2
2007,"Brighton & Hove Albion",3,46,69,58,50,8,1.5,1.26086956521739,1.08695652173913,0.173913043478261,51,7,24,68,61,93,-10,3.6
2007,"Bristol City",2,46,74,54,53,1,1.60869565217391,1.17391304347826,1.15217391304348,0.0217391304347826,24,4,24,44,30,108,-6,-0.7
2007,"Bristol Rovers",3,46,53,45,53,-8,1.15217391304348,0.978260869565217,1.15217391304348,-0.173913043478261,61,17,24,68,55,92,6,0.2
2007,"Burnley",2,46,62,60,67,-7,1.34782608695652,1.30434782608696,1.45652173913043,-0.152173913043478,33,13,24,44,25,121,8,2.6
2007,"Bury",4,46,59,58,61,-3,1.28260869565217,1.26086956521739,1.32608695652174,-0.0652173913043478,82,14,24,92,71,114,11,1.4
2007,"Cardiff City",2,46,64,59,55,4,1.39130434782609,1.28260869565217,1.19565217391304,0.0869565217391304,30,10,24,44,26,93,4,0.8
2007,"Carlisle United",3,46,80,64,46,18,1.73913043478261,1.39130434782609,1,0.391304347826087,48,4,24,68,63,84,-15,-3
2007,"Charlton Athletic",2,46,64,63,58,5,1.39130434782609,1.3695652173913,1.26086956521739,0.108695652173913,31,11,24,44,44,92,-13,-1.9
2007,"Chelsea",1,38,85,65,26,39,2.23684210526316,1.71052631578947,0.684210526315789,1.02631578947368,2,2,20,20,3,104,-1,-0.3
2007,"Cheltenham",3,46,51,42,64,-22,1.10869565217391,0.91304347826087,1.39130434782609,-0.478260869565217,64,20,24,68,67,20,-3,-2
2007,"Chester",4,46,47,51,68,-17,1.02173913043478,1.10869565217391,1.47826086956522,-0.369565217391304,90,22,24,92,92,67,-2,NA
2007,"Chesterfield",4,46,69,76,56,20,1.5,1.65217391304348,1.21739130434783,0.434782608695652,77,9,24,92,81,100,-4,-1.5
2007,"Colchester United",2,46,38,62,86,-24,0.826086956521739,1.34782608695652,1.8695652173913,-0.521739130434783,44,24,24,44,56,68,-12,-3.7
2007,"Coventry City",2,46,53,52,64,-12,1.15217391304348,1.1304347826087,1.39130434782609,-0.260869565217391,41,21,24,44,37,94,4,-3.3
2007,"Crewe Alexandra",3,46,50,47,65,-18,1.08695652173913,1.02173913043478,1.41304347826087,-0.391304347826087,65,21,24,68,66,96,-1,-1.8
2007,"Crystal Palace",2,46,71,58,42,16,1.54347826086957,1.26086956521739,0.91304347826087,0.347826086956522,25,5,24,44,35,93,-10,1.4
2007,"Dagenham and Redbridge",4,46,49,49,70,-21,1.06521739130435,1.06521739130435,1.52173913043478,-0.456521739130435,88,20,24,92,78,9,10,NA
2007,"Darlington",4,46,78,67,40,27,1.69565217391304,1.45652173913043,0.869565217391304,0.58695652173913,74,6,24,92,75,81,-1,NA
2007,"Derby County",1,38,11,20,89,-69,0.289473684210526,0.526315789473684,2.34210526315789,-1.81578947368421,20,20,20,20,38,121,-18,-0.6
2007,"Doncaster Rovers",3,46,80,65,41,24,1.73913043478261,1.41304347826087,0.891304347826087,0.521739130434783,49,5,24,68,33,88,16,-1
2007,"Everton",1,38,65,55,33,22,1.71052631578947,1.44736842105263,0.868421052631579,0.578947368421053,5,5,20,20,5,121,0,-0.3
2007,"Fulham",1,38,36,38,60,-22,0.947368421052632,1,1.57894736842105,-0.578947368421053,17,17,20,20,7,102,10,-0.6
2007,"Gillingham",3,46,46,44,73,-29,1,0.956521739130435,1.58695652173913,-0.630434782608696,66,22,24,68,73,88,-7,0.6
2007,"Grimsby Town",4,46,55,55,66,-11,1.19565217391304,1.19565217391304,1.43478260869565,-0.239130434782609,84,16,24,92,91,110,-7,NA
2007,"Hartlepool United",3,46,54,63,66,-3,1.17391304347826,1.3695652173913,1.43478260869565,-0.0652173913043478,60,16,24,68,64,89,-4,NA
2007,"Hereford United",4,46,88,72,41,31,1.91304347826087,1.56521739130435,0.891304347826087,0.673913043478261,71,3,24,92,68,31,3,NA
2007,"Huddersfield Town",3,46,66,50,62,-12,1.43478260869565,1.08695652173913,1.34782608695652,-0.260869565217391,53,9,24,68,53,99,0,3.7
2007,"Hull City",2,46,75,65,47,18,1.6304347826087,1.41304347826087,1.02173913043478,0.391304347826087,23,3,24,44,17,104,6,-1.5
2007,"Ipswich Town",2,46,69,65,56,9,1.5,1.41304347826087,1.21739130434783,0.195652173913043,28,8,24,44,29,75,-1,-0.4
2007,"Leeds United",3,46,91,72,38,34,1.97826086956522,1.56521739130435,0.826086956521739,0.739130434782609,46,2,24,68,48,93,-2,1.3
2007,"Leicester City",2,46,52,42,45,-3,1.1304347826087,0.91304347826087,0.978260869565217,-0.0652173913043478,42,22,24,44,45,115,-3,3.3
2007,"Leyton Orient",3,46,60,49,63,-14,1.30434782608696,1.06521739130435,1.3695652173913,-0.304347826086957,58,14,24,68,59,102,-1,-2.6
2007,"Lincoln City",4,46,58,61,77,-16,1.26086956521739,1.32608695652174,1.67391304347826,-0.347826086956522,83,15,24,92,83,107,0,NA
2007,"Liverpool",1,38,76,67,28,39,2,1.76315789473684,0.736842105263158,1.02631578947368,4,4,20,20,2,116,2,0
2007,"Luton Town",3,46,43,43,63,-20,0.934782608695652,0.934782608695652,1.3695652173913,-0.434782608695652,67,23,24,68,84,91,-17,NA
2007,"Macclesfield",4,46,50,47,64,-17,1.08695652173913,1.02173913043478,1.39130434782609,-0.369565217391304,86,18,24,92,89,17,-3,NA
2007,"Manchester City",1,38,55,45,53,-8,1.44736842105263,1.18421052631579,1.39473684210526,-0.210526315789474,9,9,20,20,10,117,-1,0.8
2007,"Manchester United",1,38,87,80,22,58,2.28947368421053,2.10526315789474,0.578947368421053,1.52631578947368,1,1,20,20,1,117,0,-0.1
2007,"Mansfield Town",4,46,42,48,68,-20,0.91304347826087,1.04347826086957,1.47826086956522,-0.434782608695652,91,23,24,92,78,77,13,NA
2007,"Middlesbrough",1,38,42,43,53,-10,1.10526315789474,1.13157894736842,1.39473684210526,-0.263157894736842,13,13,20,20,19,110,-6,-1.2
2007,"Millwall",3,46,52,45,60,-15,1.1304347826087,0.978260869565217,1.30434782608696,-0.326086956521739,62,18,24,68,49,93,13,3.4
2007,"Milton Keynes Dons",4,46,97,82,37,45,2.10869565217391,1.78260869565217,0.804347826086957,0.978260869565217,69,1,24,92,47,16,22,0.2
2007,"Morecambe",4,46,60,59,63,-4,1.30434782608696,1.28260869565217,1.3695652173913,-0.0869565217391304,80,12,24,92,82,13,-2,-1.1
2007,"Newcastle United",1,38,43,45,65,-20,1.13157894736842,1.18421052631579,1.71052631578947,-0.526315789473684,12,12,20,20,18,116,-6,0
2007,"Northampton Town",3,46,66,60,55,5,1.43478260869565,1.30434782608696,1.19565217391304,0.108695652173913,54,10,24,68,65,93,-11,-1.2
2007,"Norwich City",2,46,55,49,59,-10,1.19565217391304,1.06521739130435,1.28260869565217,-0.217391304347826,37,17,24,44,42,93,-5,0.3
2007,"Nottingham Forest",3,46,82,64,32,32,1.78260869565217,1.39130434782609,0.695652173913043,0.695652173913043,47,3,24,68,39,117,8,1
2007,"Notts County",4,46,48,37,53,-16,1.04347826086957,0.804347826086957,1.15217391304348,-0.347826086956522,89,21,24,92,90,120,-1,1.6
2007,"Oldham Athletic",3,46,67,58,46,12,1.45652173913043,1.26086956521739,1,0.260869565217391,52,8,24,68,54,102,-2,-1.3
2007,"Peterborough United",4,46,92,84,43,41,2,1.82608695652174,0.934782608695652,0.891304347826087,70,2,24,92,46,60,24,1.7
2007,"Plymouth Argyle",2,46,64,60,50,10,1.39130434782609,1.30434782608696,1.08695652173913,0.217391304347826,32,12,24,44,41,93,-9,-1.9
2007,"Port Vale",3,46,38,47,81,-34,0.826086956521739,1.02173913043478,1.76086956521739,-0.739130434782609,68,24,24,68,88,107,-20,-2.1
2007,"Portsmouth",1,38,57,48,40,8,1.5,1.26315789473684,1.05263157894737,0.210526315789474,8,8,20,20,15,93,-7,-4.4
2007,"Preston North End",2,46,56,50,56,-6,1.21739130434783,1.08695652173913,1.21739130434783,-0.130434782608696,35,15,24,44,27,121,8,0.8
2007,"Queens Park Rangers",2,46,58,60,66,-6,1.26086956521739,1.30434782608696,1.43478260869565,-0.130434782608696,34,14,24,44,31,93,3,-0.2
2007,"Reading",1,38,36,41,66,-25,0.947368421052632,1.07894736842105,1.73684210526316,-0.657894736842105,18,18,20,20,24,93,-6,-2.2
2007,"Rochdale",4,46,80,77,54,23,1.73913043478261,1.67391304347826,1.17391304347826,0.5,73,5,24,92,76,92,-3,0.9
2007,"Rotherham United",4,46,74,62,58,4,1.60869565217391,1.34782608695652,1.26086956521739,0.0869565217391304,76,8,24,92,74,88,2,2.8
2007,"Scunthorpe United",2,46,46,46,69,-23,1,1,1.5,-0.5,43,23,24,44,50,70,-7,-0.6
2007,"Sheffield United",2,46,66,56,51,5,1.43478260869565,1.21739130434783,1.10869565217391,0.108695652173913,29,9,24,44,23,117,6,-0.1
2007,"Sheffield Wednesday",2,46,55,54,55,-1,1.19565217391304,1.17391304347826,1.19565217391304,-0.0217391304347826,38,18,24,44,32,117,6,0.3
2007,"Shrewsbury Town",4,46,50,56,65,-9,1.08695652173913,1.21739130434783,1.41304347826087,-0.195652173913043,87,19,24,92,77,69,10,4
2007,"Southampton",2,46,54,56,72,-16,1.17391304347826,1.21739130434783,1.56521739130435,-0.347826086956522,40,20,24,44,43,93,-3,2.3
2007,"Southend United",3,46,76,70,55,15,1.65217391304348,1.52173913043478,1.19565217391304,0.326086956521739,50,6,24,68,52,93,-2,-0.5
2007,"Stockport County",4,46,82,72,54,18,1.78260869565217,1.56521739130435,1.17391304347826,0.391304347826087,72,4,24,92,58,99,14,NA
2007,"Stoke City",2,46,79,69,55,14,1.71739130434783,1.5,1.19565217391304,0.304347826086957,22,2,24,44,11,113,11,0.4
2007,"Sunderland",1,38,39,36,59,-23,1.02631578947368,0.947368421052632,1.55263157894737,-0.605263157894737,15,15,20,20,16,119,-1,-2.9
2007,"Swansea City",3,46,92,82,42,40,2,1.78260869565217,0.91304347826087,0.869565217391304,45,1,24,68,28,93,17,2.6
2007,"Swindon Town",3,46,61,63,56,7,1.32608695652174,1.3695652173913,1.21739130434783,0.152173913043478,57,13,24,68,60,93,-3,-2
2007,"Tottenham Hotspur",1,38,46,66,61,5,1.21052631578947,1.73684210526316,1.60526315789474,0.131578947368421,11,11,20,20,8,101,3,0.8
2007,"Tranmere Rovers",3,46,65,52,47,5,1.41304347826087,1.1304347826087,1.02173913043478,0.108695652173913,55,11,24,68,51,89,4,NA
2007,"Walsall",3,46,64,52,46,6,1.39130434782609,1.1304347826087,1,0.130434782608696,56,12,24,68,57,100,-1,-0.7
2007,"Watford",2,46,70,62,56,6,1.52173913043478,1.34782608695652,1.21739130434783,0.130434782608696,26,6,24,44,34,93,-8,1.2
2007,"West Bromwich Albion",2,46,81,88,55,33,1.76086956521739,1.91304347826087,1.19565217391304,0.717391304347826,21,1,24,44,20,121,1,0.1
2007,"West Ham United",1,38,49,42,50,-8,1.28947368421053,1.10526315789474,1.31578947368421,-0.210526315789474,10,10,20,20,9,94,1,-0.3
2007,"Wigan Athletic",1,38,40,34,51,-17,1.05263157894737,0.894736842105263,1.34210526315789,-0.447368421052632,14,14,20,20,12,42,2,-3.1
2007,"Wolverhampton Wanderers",2,46,70,53,48,5,1.52173913043478,1.15217391304348,1.04347826086957,0.108695652173913,27,7,24,44,21,121,6,0.6
2007,"Wrexham",4,46,40,38,70,-32,0.869565217391304,0.826086956521739,1.52173913043478,-0.695652173913043,92,24,24,92,NA,80,NA,NA
2007,"Wycombe Wanderers",4,46,78,56,42,14,1.69565217391304,1.21739130434783,0.91304347826087,0.304347826086957,75,7,24,92,72,27,3,0.4
2007,"Yeovil",3,46,52,38,59,-21,1.1304347826087,0.826086956521739,1.28260869565217,-0.456521739130435,63,19,24,68,62,16,1,-2.4
2008,"Accrington",4,46,50,42,59,-17,1.08695652173913,0.91304347826087,1.28260869565217,-0.369565217391304,86,18,24,92,83,14,3,2.9
2008,"AFC Bournemouth",4,46,63,59,51,8,1.3695652173913,1.28260869565217,1.10869565217391,0.173913043478261,80,12,24,92,70,90,10,6.7
2008,"Aldershot",4,46,54,59,80,-21,1.17391304347826,1.28260869565217,1.73913043478261,-0.456521739130435,85,17,24,92,74,57,11,NA
2008,"Arsenal",1,38,72,68,37,31,1.89473684210526,1.78947368421053,0.973684210526316,0.815789473684211,4,4,20,20,3,116,1,-0.1
2008,"Aston Villa",1,38,62,54,48,6,1.63157894736842,1.42105263157895,1.26315789473684,0.157894736842105,6,6,20,20,6,121,0,-1.9
2008,"Barnet",4,46,48,56,74,-18,1.04347826086957,1.21739130434783,1.60869565217391,-0.391304347826087,87,19,24,92,89,21,-2,NA
2008,"Barnsley",2,46,52,45,58,-13,1.1304347826087,0.978260869565217,1.26086956521739,-0.282608695652174,40,20,24,44,37,111,3,-0.6
2008,"Birmingham City",2,46,83,54,37,17,1.80434782608696,1.17391304347826,0.804347826086957,0.369565217391304,22,2,24,44,9,117,13,-1.2
2008,"Blackburn Rovers",1,38,41,40,60,-20,1.07894736842105,1.05263157894737,1.57894736842105,-0.526315789473684,13,13,20,20,10,121,3,-2.3
2008,"Blackpool",2,46,56,47,58,-11,1.21739130434783,1.02173913043478,1.26086956521739,-0.239130434782609,36,16,24,44,26,112,10,-1.8
2008,"Bolton Wanderers",1,38,41,41,53,-12,1.07894736842105,1.07894736842105,1.39473684210526,-0.315789473684211,14,14,20,20,14,121,0,-2.9
2008,"Bradford City",4,46,67,66,55,11,1.45652173913043,1.43478260869565,1.19565217391304,0.239130434782609,79,11,24,92,81,106,-2,1.1
2008,"Brentford",4,46,85,65,36,29,1.84782608695652,1.41304347826087,0.782608695652174,0.630434782608696,69,1,24,92,53,93,16,3.8
2008,"Brighton & Hove Albion",3,46,52,55,70,-15,1.1304347826087,1.19565217391304,1.52173913043478,-0.326086956521739,61,17,24,68,57,93,4,4.4
2008,"Bristol City",2,46,61,54,54,0,1.32608695652174,1.17391304347826,1.17391304347826,0,30,10,24,44,29,108,1,0.2
2008,"Bristol Rovers",3,46,63,79,61,18,1.3695652173913,1.71739130434783,1.32608695652174,0.391304347826087,55,11,24,68,54,92,1,0.2
2008,"Burnley",2,46,76,72,60,12,1.65217391304348,1.56521739130435,1.30434782608696,0.260869565217391,25,5,24,44,18,121,7,1
2008,"Bury",4,46,78,63,43,20,1.69565217391304,1.3695652173913,0.934782608695652,0.434782608695652,71,3,24,92,77,114,-6,0.1
2008,"Cardiff City",2,46,74,65,53,12,1.60869565217391,1.41304347826087,1.15217391304348,0.260869565217391,26,6,24,44,24,93,2,0.8
2008,"Carlisle United",3,46,50,56,69,-13,1.08695652173913,1.21739130434783,1.5,-0.282608695652174,63,19,24,68,58,84,5,-1.6
2008,"Charlton Athletic",2,46,39,52,74,-22,0.847826086956522,1.1304347826087,1.60869565217391,-0.478260869565217,44,24,24,44,48,92,-4,-0.3
2008,"Chelsea",1,38,83,68,24,44,2.18421052631579,1.78947368421053,0.631578947368421,1.15789473684211,3,3,20,20,1,104,2,0
2008,"Cheltenham",3,46,39,51,91,-40,0.847826086956522,1.10869565217391,1.97826086956522,-0.869565217391304,67,23,24,68,90,20,-23,-0.6
2008,"Chester",4,46,37,43,81,-38,0.804347826086957,0.934782608695652,1.76086956521739,-0.826086956521739,92,24,24,92,NA,67,NA,NA
2008,"Chesterfield",4,46,63,62,57,5,1.3695652173913,1.34782608695652,1.23913043478261,0.108695652173913,81,13,24,92,76,100,5,NA
2008,"Colchester United",3,46,63,58,58,0,1.3695652173913,1.26086956521739,1.26086956521739,0,56,12,24,68,52,68,4,-2
2008,"Coventry City",2,46,54,47,58,-11,1.17391304347826,1.02173913043478,1.26086956521739,-0.239130434782609,37,17,24,44,38,94,-1,-1.5
2008,"Crewe Alexandra",3,46,46,59,82,-23,1,1.28260869565217,1.78260869565217,-0.5,66,22,24,68,86,96,-20,-1.4
2008,"Crystal Palace",2,46,57,52,55,-3,1.23913043478261,1.1304347826087,1.19565217391304,-0.0652173913043478,35,15,24,44,33,93,2,2.3
2008,"Dagenham and Redbridge",4,46,68,77,53,24,1.47826086956522,1.67391304347826,1.15217391304348,0.521739130434783,78,10,24,92,75,9,3,NA
2008,"Darlington",4,46,72,61,44,17,1.56521739130435,1.32608695652174,0.956521739130435,0.369565217391304,75,7,24,92,92,81,-17,NA
2008,"Derby County",2,46,54,55,67,-12,1.17391304347826,1.19565217391304,1.45652173913043,-0.260869565217391,38,18,24,44,35,121,3,1.2
2008,"Doncaster Rovers",2,46,58,42,53,-11,1.26086956521739,0.91304347826087,1.15217391304348,-0.239130434782609,33,13,24,44,32,88,1,-1.7
2008,"Everton",1,38,63,55,37,18,1.65789473684211,1.44736842105263,0.973684210526316,0.473684210526316,5,5,20,20,8,121,-3,-0.3
2008,"Exeter City",4,46,79,65,50,15,1.71739130434783,1.41304347826087,1.08695652173913,0.326086956521739,70,2,24,92,62,88,8,-0.7
2008,"Fulham",1,38,53,39,34,5,1.39473684210526,1.02631578947368,0.894736842105263,0.131578947368421,7,7,20,20,12,102,-5,-1.2
2008,"Gillingham",4,46,75,58,55,3,1.6304347826087,1.26086956521739,1.19565217391304,0.0652173913043478,73,5,24,92,65,88,8,1.5
2008,"Grimsby Town",4,46,41,51,69,-18,0.891304347826087,1.10869565217391,1.5,-0.391304347826087,91,23,24,92,91,110,0,NA
2008,"Hartlepool United",3,46,50,66,79,-13,1.08695652173913,1.43478260869565,1.71739130434783,-0.282608695652174,64,20,24,68,59,89,5,NA
2008,"Hereford United",3,46,34,42,79,-37,0.739130434782609,0.91304347826087,1.71739130434783,-0.804347826086957,68,24,24,68,84,31,-16,NA
2008,"Huddersfield Town",3,46,68,62,65,-3,1.47826086956522,1.34782608695652,1.41304347826087,-0.0652173913043478,53,9,24,68,51,99,2,3.3
2008,"Hull City",1,38,35,39,64,-25,0.921052631578947,1.02631578947368,1.68421052631579,-0.657894736842105,17,17,20,20,19,104,-2,-1.6
2008,"Ipswich Town",2,46,66,62,53,9,1.43478260869565,1.34782608695652,1.15217391304348,0.195652173913043,29,9,24,44,36,75,-7,-1.5
2008,"Leeds United",3,46,84,77,49,28,1.82608695652174,1.67391304347826,1.06521739130435,0.608695652173913,48,4,24,68,46,93,2,2.5
2008,"Leicester City",3,46,96,84,39,45,2.08695652173913,1.82608695652174,0.847826086956522,0.978260869565217,45,1,24,68,25,115,20,3.6
2008,"Leyton Orient",3,46,56,45,57,-12,1.21739130434783,0.978260869565217,1.23913043478261,-0.260869565217391,59,15,24,68,63,102,-4,NA
2008,"Lincoln City",4,46,59,53,52,1,1.28260869565217,1.15217391304348,1.1304347826087,0.0217391304347826,83,15,24,92,88,107,-5,NA
2008,"Liverpool",1,38,86,77,27,50,2.26315789473684,2.02631578947368,0.710526315789474,1.31578947368421,2,2,20,20,7,116,-5,0
2008,"Luton Town",4,46,56,58,65,-7,1.21739130434783,1.26086956521739,1.41304347826087,-0.152173913043478,84,16,24,92,76,91,8,NA
2008,"Macclesfield",4,46,47,45,77,-32,1.02173913043478,0.978260869565217,1.67391304347826,-0.695652173913043,89,21,24,92,87,17,2,NA
2008,"Manchester City",1,38,50,58,50,8,1.31578947368421,1.52631578947368,1.31578947368421,0.210526315789474,10,10,20,20,5,117,5,0.9
2008,"Manchester United",1,38,90,68,24,44,2.36842105263158,1.78947368421053,0.631578947368421,1.15789473684211,1,1,20,20,2,117,-1,-0.5
2008,"Middlesbrough",1,38,32,28,57,-29,0.842105263157895,0.736842105263158,1.5,-0.763157894736842,19,19,20,20,31,110,-12,-0.8
2008,"Millwall",3,46,82,63,53,10,1.78260869565217,1.3695652173913,1.15217391304348,0.217391304347826,49,5,24,68,47,93,2,0.8
2008,"Milton Keynes Dons",3,46,87,83,47,36,1.89130434782609,1.80434782608696,1.02173913043478,0.782608695652174,47,3,24,68,56,16,-9,-2.4
2008,"Morecambe",4,46,63,53,56,-3,1.3695652173913,1.15217391304348,1.21739130434783,-0.0652173913043478,82,14,24,92,72,13,10,-0.4
2008,"Newcastle United",1,38,34,40,59,-19,0.894736842105263,1.05263157894737,1.55263157894737,-0.5,18,18,20,20,21,116,-3,0.4
2008,"Northampton Town",3,46,49,61,65,-4,1.06521739130435,1.32608695652174,1.41304347826087,-0.0869565217391304,65,21,24,68,79,93,-14,-1.8
2008,"Norwich City",2,46,46,57,70,-13,1,1.23913043478261,1.52173913043478,-0.282608695652174,42,22,24,44,45,93,-3,2.1
2008,"Nottingham Forest",2,46,53,50,65,-15,1.15217391304348,1.08695652173913,1.41304347826087,-0.326086956521739,39,19,24,44,23,117,16,1
2008,"Notts County",4,46,47,49,69,-20,1.02173913043478,1.06521739130435,1.5,-0.434782608695652,90,22,24,92,69,120,21,-0.1
2008,"Oldham Athletic",3,46,65,66,65,1,1.41304347826087,1.43478260869565,1.41304347826087,0.0217391304347826,54,10,24,68,61,102,-7,-2.8
2008,"Peterborough United",3,46,89,78,54,24,1.93478260869565,1.69565217391304,1.17391304347826,0.521739130434783,46,2,24,68,44,60,2,-0.5
2008,"Plymouth Argyle",2,46,51,44,57,-13,1.10869565217391,0.956521739130435,1.23913043478261,-0.282608695652174,41,21,24,44,43,93,-2,-2.3
2008,"Port Vale",4,46,48,44,66,-22,1.04347826086957,0.956521739130435,1.43478260869565,-0.478260869565217,88,20,24,92,78,107,10,0
2008,"Portsmouth",1,38,41,38,57,-19,1.07894736842105,1,1.5,-0.5,15,15,20,20,20,93,-5,-3.3
2008,"Preston North End",2,46,74,66,54,12,1.60869565217391,1.43478260869565,1.17391304347826,0.260869565217391,27,7,24,44,39,121,-12,-0.8
2008,"Queens Park Rangers",2,46,61,42,44,-2,1.32608695652174,0.91304347826087,0.956521739130435,-0.0434782608695652,31,11,24,44,34,93,-3,-0.8
2008,"Reading",2,46,77,72,40,32,1.67391304347826,1.56521739130435,0.869565217391304,0.695652173913043,24,4,24,44,30,93,-6,-1.6
2008,"Rochdale",4,46,70,70,59,11,1.52173913043478,1.52173913043478,1.28260869565217,0.239130434782609,76,8,24,92,71,92,5,1.6
2008,"Rotherham United",4,46,75,60,46,14,1.6304347826087,1.30434782608696,1,0.304347826086957,74,6,24,92,73,88,1,3.2
2008,"Scunthorpe United",3,46,76,82,63,19,1.65217391304348,1.78260869565217,1.3695652173913,0.41304347826087,50,6,24,68,41,70,9,-1.7
2008,"Sheffield United",2,46,80,64,39,25,1.73913043478261,1.39130434782609,0.847826086956522,0.543478260869565,23,3,24,44,28,117,-5,0.1
2008,"Sheffield Wednesday",2,46,61,51,58,-7,1.32608695652174,1.10869565217391,1.26086956521739,-0.152173913043478,32,12,24,44,42,117,-10,0
2008,"Shrewsbury Town",4,46,69,61,44,17,1.5,1.32608695652174,0.956521739130435,0.369565217391304,77,9,24,92,80,69,-3,1.5
2008,"Southampton",2,46,45,46,69,-23,0.978260869565217,1,1.5,-0.5,43,23,24,44,49,93,-6,2.7
2008,"Southend United",3,46,71,58,61,-3,1.54347826086957,1.26086956521739,1.32608695652174,-0.0652173913043478,52,8,24,68,67,93,-15,-1.3
2008,"Stockport County",3,46,60,59,57,2,1.30434782608696,1.28260869565217,1.23913043478261,0.0434782608695652,58,14,24,68,68,99,-10,NA
2008,"Stoke City",1,38,45,38,55,-17,1.18421052631579,1,1.44736842105263,-0.447368421052632,11,11,20,20,11,113,0,-2.6
2008,"Sunderland",1,38,36,34,54,-20,0.947368421052632,0.894736842105263,1.42105263157895,-0.526315789473684,16,16,20,20,13,119,3,-3.3
2008,"Swansea City",2,46,68,63,50,13,1.47826086956522,1.3695652173913,1.08695652173913,0.282608695652174,28,8,24,44,27,93,1,-0.2
2008,"Swindon Town",3,46,53,68,71,-3,1.15217391304348,1.47826086956522,1.54347826086957,-0.0652173913043478,60,16,24,68,50,93,10,-2.1
2008,"Tottenham Hotspur",1,38,51,45,45,0,1.34210526315789,1.18421052631579,1.18421052631579,0,8,8,20,20,4,101,4,0.4
2008,"Tranmere Rovers",3,46,74,62,49,13,1.60869565217391,1.34782608695652,1.06521739130435,0.282608695652174,51,7,24,68,64,89,-13,NA
2008,"Walsall",3,46,61,61,66,-5,1.32608695652174,1.32608695652174,1.43478260869565,-0.108695652173913,57,13,24,68,55,100,2,-0.9
2008,"Watford",2,46,58,68,72,-4,1.26086956521739,1.47826086956522,1.56521739130435,-0.0869565217391304,34,14,24,44,40,93,-6,2.3
2008,"West Bromwich Albion",1,38,32,36,67,-31,0.842105263157895,0.947368421052632,1.76315789473684,-0.815789473684211,20,20,20,20,22,121,-2,-0.4
2008,"West Ham United",1,38,51,42,45,-3,1.34210526315789,1.10526315789474,1.18421052631579,-0.0789473684210526,9,9,20,20,17,94,-8,-0.1
2008,"Wigan Athletic",1,38,45,34,45,-11,1.18421052631579,0.894736842105263,1.18421052631579,-0.289473684210526,12,12,20,20,16,42,-4,-2.6
2008,"Wolverhampton Wanderers",2,46,90,80,52,28,1.95652173913043,1.73913043478261,1.1304347826087,0.608695652173913,21,1,24,44,15,121,6,1.4
2008,"Wycombe Wanderers",4,46,78,54,33,21,1.69565217391304,1.17391304347826,0.717391304347826,0.456521739130435,72,4,24,92,66,27,6,1.1
2008,"Yeovil",3,46,51,41,66,-25,1.10869565217391,0.891304347826087,1.43478260869565,-0.543478260869565,62,18,24,68,60,16,2,-3
2009,"Accrington",4,46,61,62,74,-12,1.32608695652174,1.34782608695652,1.60869565217391,-0.260869565217391,83,15,24,92,73,14,10,2
2009,"AFC Bournemouth",4,46,83,61,44,17,1.80434782608696,1.32608695652174,0.956521739130435,0.369565217391304,70,2,24,92,50,90,20,6.3
2009,"Aldershot",4,46,72,69,56,13,1.56521739130435,1.5,1.21739130434783,0.282608695652174,74,6,24,92,81,57,-7,NA
2009,"Arsenal",1,38,75,83,41,42,1.97368421052632,2.18421052631579,1.07894736842105,1.10526315789474,3,3,20,20,4,116,-1,-0.2
2009,"Aston Villa",1,38,64,52,39,13,1.68421052631579,1.36842105263158,1.02631578947368,0.342105263157895,6,6,20,20,9,121,-3,-1.1
2009,"Barnet",4,46,48,47,63,-16,1.04347826086957,1.02173913043478,1.3695652173913,-0.347826086956522,89,21,24,92,90,21,-1,NA
2009,"Barnsley",2,46,54,53,69,-16,1.17391304347826,1.15217391304348,1.5,-0.347826086956522,37,17,24,44,37,111,0,-0.7
2009,"Birmingham City",1,38,50,38,47,-9,1.31578947368421,1,1.23684210526316,-0.236842105263158,9,9,20,20,18,117,-9,-2.2
2009,"Blackburn Rovers",1,38,50,41,55,-14,1.31578947368421,1.07894736842105,1.44736842105263,-0.368421052631579,10,10,20,20,15,121,-5,-2.7
2009,"Blackpool",2,46,70,74,58,16,1.52173913043478,1.60869565217391,1.26086956521739,0.347826086956522,26,6,24,44,19,112,7,-2.2
2009,"Bolton Wanderers",1,38,39,42,67,-25,1.02631578947368,1.10526315789474,1.76315789473684,-0.657894736842105,14,14,20,20,12,121,2,-5.1
2009,"Bradford City",4,46,62,59,62,-3,1.34782608695652,1.28260869565217,1.34782608695652,-0.0652173913043478,81,13,24,92,85,106,-4,1.1
2009,"Brentford",3,46,62,55,52,3,1.34782608695652,1.19565217391304,1.1304347826087,0.0652173913043478,53,9,24,68,55,93,-2,2.4
2009,"Brighton & Hove Albion",3,46,59,56,60,-4,1.28260869565217,1.21739130434783,1.30434782608696,-0.0869565217391304,57,13,24,68,45,93,12,4.7
2009,"Bristol City",2,46,63,56,65,-9,1.3695652173913,1.21739130434783,1.41304347826087,-0.195652173913043,29,9,24,44,35,108,-6,0.4
2009,"Bristol Rovers",3,46,62,59,70,-11,1.34782608695652,1.28260869565217,1.52173913043478,-0.239130434782609,54,10,24,68,67,92,-13,NA
2009,"Burnley",1,38,30,42,82,-40,0.789473684210526,1.10526315789474,2.15789473684211,-1.05263157894737,18,18,20,20,28,121,-10,0.7
2009,"Burton Albion",4,46,62,71,71,0,1.34782608695652,1.54347826086957,1.54347826086957,0,82,14,24,92,88,11,-6,2.3
2009,"Bury",4,46,69,54,59,-5,1.5,1.17391304347826,1.28260869565217,-0.108695652173913,77,9,24,92,70,114,7,NA
2009,"Cardiff City",2,46,76,73,54,19,1.65217391304348,1.58695652173913,1.17391304347826,0.41304347826087,24,4,24,44,23,93,1,-1
2009,"Carlisle United",3,46,58,63,66,-3,1.26086956521739,1.3695652173913,1.43478260869565,-0.0652173913043478,58,14,24,68,56,84,2,-2.8
2009,"Charlton Athletic",3,46,84,71,48,23,1.82608695652174,1.54347826086957,1.04347826086957,0.5,48,4,24,68,57,92,-9,1.6
2009,"Chelsea",1,38,86,103,32,71,2.26315789473684,2.71052631578947,0.842105263157895,1.86842105263158,1,1,20,20,2,104,-1,-0.1
2009,"Cheltenham",4,46,48,54,71,-17,1.04347826086957,1.17391304347826,1.54347826086957,-0.369565217391304,90,22,24,92,86,20,4,NA
2009,"Chesterfield",4,46,70,61,62,-1,1.52173913043478,1.32608695652174,1.34782608695652,-0.0217391304347826,76,8,24,92,69,100,7,NA
2009,"Colchester United",3,46,72,64,52,12,1.56521739130435,1.39130434782609,1.1304347826087,0.260869565217391,52,8,24,68,54,68,-2,-2.5
2009,"Coventry City",2,46,54,47,64,-17,1.17391304347826,1.02173913043478,1.39130434782609,-0.369565217391304,38,18,24,44,38,94,0,-0.9
2009,"Crewe Alexandra",4,46,55,68,73,-5,1.19565217391304,1.47826086956522,1.58695652173913,-0.108695652173913,86,18,24,92,78,96,8,1.5
2009,"Crystal Palace",2,46,59,50,53,-3,1.28260869565217,1.08695652173913,1.15217391304348,-0.0652173913043478,33,13,24,44,40,93,-7,2.1
2009,"Dagenham and Redbridge",4,46,72,69,58,11,1.56521739130435,1.5,1.26086956521739,0.239130434782609,75,7,24,92,66,9,9,NA
2009,"Darlington",4,46,30,33,87,-54,0.652173913043478,0.717391304347826,1.89130434782609,-1.17391304347826,92,24,24,92,NA,81,NA,NA
2009,"Derby County",2,46,56,53,63,-10,1.21739130434783,1.15217391304348,1.3695652173913,-0.217391304347826,35,15,24,44,39,121,-4,0
2009,"Doncaster Rovers",2,46,60,59,58,1,1.30434782608696,1.28260869565217,1.26086956521739,0.0217391304347826,32,12,24,44,41,88,-9,-2.4
2009,"Everton",1,38,61,60,49,11,1.60526315789474,1.57894736842105,1.28947368421053,0.289473684210526,8,8,20,20,7,121,1,-0.6
2009,"Exeter City",3,46,51,48,60,-12,1.10869565217391,1.04347826086957,1.30434782608696,-0.260869565217391,62,18,24,68,51,88,11,-1
2009,"Fulham",1,38,46,39,46,-7,1.21052631578947,1.02631578947368,1.21052631578947,-0.184210526315789,12,12,20,20,8,102,4,-1.5
2009,"Gillingham",3,46,50,48,64,-16,1.08695652173913,1.04347826086957,1.39130434782609,-0.347826086956522,65,21,24,68,76,88,-11,0.8
2009,"Grimsby Town",4,46,44,45,71,-26,0.956521739130435,0.978260869565217,1.54347826086957,-0.565217391304348,91,23,24,92,82,110,9,NA
2009,"Hartlepool United",3,46,53,59,67,-8,1.15217391304348,1.28260869565217,1.45652173913043,-0.173913043478261,59,15,24,68,60,89,-1,NA
2009,"Hereford United",4,46,59,54,65,-11,1.28260869565217,1.17391304347826,1.41304347826087,-0.239130434782609,84,16,24,92,84,31,0,NA
2009,"Huddersfield Town",3,46,80,82,56,26,1.73913043478261,1.78260869565217,1.21739130434783,0.565217391304348,51,7,24,68,47,99,4,1.2
2009,"Hull City",1,38,30,34,75,-41,0.789473684210526,0.894736842105263,1.97368421052632,-1.07894736842105,19,19,20,20,31,104,-12,-1.4
2009,"Ipswich Town",2,46,56,50,61,-11,1.21739130434783,1.08695652173913,1.32608695652174,-0.239130434782609,36,16,24,44,32,75,4,-1
2009,"Leeds United",3,46,86,77,44,33,1.8695652173913,1.67391304347826,0.956521739130435,0.717391304347826,46,2,24,68,27,93,19,2.4
2009,"Leicester City",2,46,76,61,45,16,1.65217391304348,1.32608695652174,0.978260869565217,0.347826086956522,25,5,24,44,29,115,-4,2.2
2009,"Leyton Orient",3,46,51,53,63,-10,1.10869565217391,1.15217391304348,1.3695652173913,-0.217391304347826,63,19,24,68,52,102,11,NA
2009,"Lincoln City",4,46,50,42,65,-23,1.08695652173913,0.91304347826087,1.41304347826087,-0.5,88,20,24,92,91,107,-3,NA
2009,"Liverpool",1,38,63,61,35,26,1.65789473684211,1.60526315789474,0.921052631578947,0.684210526315789,7,7,20,20,6,116,1,0.6
2009,"Macclesfield",4,46,54,49,58,-9,1.17391304347826,1.06521739130435,1.26086956521739,-0.195652173913043,87,19,24,92,83,17,4,NA
2009,"Manchester City",1,38,67,73,45,28,1.76315789473684,1.92105263157895,1.18421052631579,0.736842105263158,5,5,20,20,3,117,2,0.1
2009,"Manchester United",1,38,85,86,28,58,2.23684210526316,2.26315789473684,0.736842105263158,1.52631578947368,2,2,20,20,1,117,1,-0.6
2009,"Middlesbrough",2,46,62,58,50,8,1.34782608695652,1.26086956521739,1.08695652173913,0.173913043478261,31,11,24,44,33,110,-2,-1.1
2009,"Millwall",3,46,85,76,44,32,1.84782608695652,1.65217391304348,0.956521739130435,0.695652173913043,47,3,24,68,30,93,17,1.1
2009,"Milton Keynes Dons",3,46,60,60,68,-8,1.30434782608696,1.30434782608696,1.47826086956522,-0.173913043478261,56,12,24,68,49,16,7,-1
2009,"Morecambe",4,46,73,73,64,9,1.58695652173913,1.58695652173913,1.39130434782609,0.195652173913043,72,4,24,92,89,13,-17,-1.8
2009,"Newcastle United",2,46,102,90,35,55,2.21739130434783,1.95652173913043,0.760869565217391,1.19565217391304,21,1,24,44,13,116,8,0.8
2009,"Northampton Town",4,46,67,62,53,9,1.45652173913043,1.34782608695652,1.15217391304348,0.195652173913043,79,11,24,92,87,93,-8,0.5
2009,"Norwich City",3,46,95,89,47,42,2.06521739130435,1.93478260869565,1.02173913043478,0.91304347826087,45,1,24,68,22,93,23,2.5
2009,"Nottingham Forest",2,46,79,65,40,25,1.71739130434783,1.41304347826087,0.869565217391304,0.543478260869565,23,3,24,44,26,117,-3,-0.3
2009,"Notts County",4,46,93,96,31,65,2.02173913043478,2.08695652173913,0.673913043478261,1.41304347826087,69,1,24,92,64,120,5,NA
2009,"Oldham Athletic",3,46,52,39,57,-18,1.1304347826087,0.847826086956522,1.23913043478261,-0.391304347826087,61,17,24,68,61,102,0,-2.8
2009,"Peterborough United",2,46,34,46,80,-34,0.739130434782609,1,1.73913043478261,-0.739130434782609,44,24,24,44,48,60,-4,-0.5
2009,"Plymouth Argyle",2,46,41,43,68,-25,0.891304347826087,0.934782608695652,1.47826086956522,-0.543478260869565,43,23,24,44,63,93,-20,-3.5
2009,"Port Vale",4,46,68,61,50,11,1.47826086956522,1.32608695652174,1.08695652173913,0.239130434782609,78,10,24,92,79,107,-1,0.3
2009,"Portsmouth",1,38,28,34,66,-32,0.736842105263158,0.894736842105263,1.73684210526316,-0.842105263157895,20,20,20,20,36,93,-16,-3.8
2009,"Preston North End",2,46,54,58,73,-15,1.17391304347826,1.26086956521739,1.58695652173913,-0.326086956521739,39,19,24,44,42,121,-3,1.6
2009,"Queens Park Rangers",2,46,57,58,65,-7,1.23913043478261,1.26086956521739,1.41304347826087,-0.152173913043478,34,14,24,44,21,93,13,0.4
2009,"Reading",2,46,63,68,63,5,1.3695652173913,1.47826086956522,1.3695652173913,0.108695652173913,30,10,24,44,25,93,5,-0.8
2009,"Rochdale",4,46,82,82,48,34,1.78260869565217,1.78260869565217,1.04347826086957,0.739130434782609,71,3,24,92,53,92,18,1.1
2009,"Rotherham United",4,46,73,55,52,3,1.58695652173913,1.19565217391304,1.1304347826087,0.0652173913043478,73,5,24,92,77,88,-4,2.3
2009,"Scunthorpe United",2,46,52,62,84,-22,1.1304347826087,1.34782608695652,1.82608695652174,-0.478260869565217,41,21,24,44,43,70,-2,-4.6
2009,"Sheffield United",2,46,65,62,55,7,1.41304347826087,1.34782608695652,1.19565217391304,0.152173913043478,28,8,24,44,44,117,-16,2.2
2009,"Sheffield Wednesday",2,46,47,49,69,-20,1.02173913043478,1.06521739130435,1.5,-0.434782608695652,42,22,24,44,59,117,-17,1.4
2009,"Shrewsbury Town",4,46,63,55,54,1,1.3695652173913,1.19565217391304,1.17391304347826,0.0217391304347826,80,12,24,92,72,69,8,2.5
2009,"Southampton",3,46,83,85,47,38,1.80434782608696,1.84782608695652,1.02173913043478,0.826086956521739,49,5,24,68,46,93,3,3.1
2009,"Southend United",3,46,43,51,72,-21,0.934782608695652,1.10869565217391,1.56521739130435,-0.456521739130435,67,23,24,68,82,93,-15,0
2009,"Stockport County",3,46,25,35,95,-60,0.543478260869565,0.760869565217391,2.06521739130435,-1.30434782608696,68,24,24,68,92,99,-24,NA
2009,"Stoke City",1,38,47,34,48,-14,1.23684210526316,0.894736842105263,1.26315789473684,-0.368421052631579,11,11,20,20,14,113,-3,-3.2
2009,"Sunderland",1,38,44,48,56,-8,1.15789473684211,1.26315789473684,1.47368421052632,-0.210526315789474,13,13,20,20,10,119,3,-4.1
2009,"Swansea City",2,46,69,40,37,3,1.5,0.869565217391304,0.804347826086957,0.0652173913043478,27,7,24,44,24,93,3,0.3
2009,"Swindon Town",3,46,82,73,57,16,1.78260869565217,1.58695652173913,1.23913043478261,0.347826086956522,50,6,24,68,68,93,-18,-1.8
2009,"Torquay United",4,46,57,64,55,9,1.23913043478261,1.39130434782609,1.19565217391304,0.195652173913043,85,17,24,92,75,78,10,NA
2009,"Tottenham Hotspur",1,38,70,67,41,26,1.84210526315789,1.76315789473684,1.07894736842105,0.684210526315789,4,4,20,20,5,101,-1,-1.1
2009,"Tranmere Rovers",3,46,51,45,72,-27,1.10869565217391,0.978260869565217,1.56521739130435,-0.58695652173913,64,20,24,68,62,89,2,NA
2009,"Walsall",3,46,62,60,63,-3,1.34782608695652,1.30434782608696,1.3695652173913,-0.0652173913043478,55,11,24,68,65,100,-10,-3.3
2009,"Watford",2,46,54,61,68,-7,1.17391304347826,1.32608695652174,1.47826086956522,-0.152173913043478,40,20,24,44,34,93,6,2.1
2009,"West Bromwich Albion",2,46,91,89,48,41,1.97826086956522,1.93478260869565,1.04347826086957,0.891304347826087,22,2,24,44,11,121,11,0.1
2009,"West Ham United",1,38,35,47,66,-19,0.921052631578947,1.23684210526316,1.73684210526316,-0.5,17,17,20,20,20,94,-3,0.1
2009,"Wigan Athletic",1,38,36,37,79,-42,0.947368421052632,0.973684210526316,2.07894736842105,-1.10526315789474,16,16,20,20,16,42,0,-2.4
2009,"Wolverhampton Wanderers",1,38,38,32,56,-24,1,0.842105263157895,1.47368421052632,-0.631578947368421,15,15,20,20,17,121,-2,0.6
2009,"Wycombe Wanderers",3,46,45,56,76,-20,0.978260869565217,1.21739130434783,1.65217391304348,-0.434782608695652,66,22,24,68,71,27,-5,2.1
2009,"Yeovil",3,46,53,55,59,-4,1.15217391304348,1.19565217391304,1.28260869565217,-0.0869565217391304,60,16,24,68,58,16,2,NA
2010,"Accrington",4,46,73,73,55,18,1.58695652173913,1.58695652173913,1.19565217391304,0.391304347826087,73,5,24,92,81,14,-8,NA
2010,"AFC Bournemouth",3,46,71,75,54,21,1.54347826086957,1.6304347826087,1.17391304347826,0.456521739130435,50,6,24,68,55,90,-5,NA
2010,"Aldershot",4,46,61,54,54,0,1.32608695652174,1.17391304347826,1.17391304347826,0,81,13,24,92,80,57,1,NA
2010,"Arsenal",1,38,68,72,43,29,1.78947368421053,1.89473684210526,1.13157894736842,0.763157894736842,4,4,20,20,3,116,1,NA
2010,"Aston Villa",1,38,48,48,59,-11,1.26315789473684,1.26315789473684,1.55263157894737,-0.289473684210526,9,9,20,20,16,121,-7,NA
2010,"Barnet",4,46,48,58,77,-19,1.04347826086957,1.26086956521739,1.67391304347826,-0.41304347826087,90,22,24,92,89,21,1,NA
2010,"Barnsley",2,46,56,55,66,-11,1.21739130434783,1.19565217391304,1.43478260869565,-0.239130434782609,37,17,24,44,42,111,-5,NA
2010,"Birmingham City",1,38,39,37,58,-21,1.02631578947368,0.973684210526316,1.52631578947368,-0.552631578947368,18,18,20,20,24,117,-6,NA
2010,"Blackburn Rovers",1,38,43,46,59,-13,1.13157894736842,1.21052631578947,1.55263157894737,-0.342105263157895,15,15,20,20,19,121,-4,NA
2010,"Blackpool",1,38,39,55,78,-23,1.02631578947368,1.44736842105263,2.05263157894737,-0.605263157894737,19,19,20,20,25,112,-6,NA
2010,"Bolton Wanderers",1,38,46,52,56,-4,1.21052631578947,1.36842105263158,1.47368421052632,-0.105263157894737,12,12,20,20,18,121,-6,NA
2010,"Bradford City",4,46,52,43,68,-25,1.1304347826087,0.934782608695652,1.47826086956522,-0.543478260869565,85,17,24,92,86,106,-1,NA
2010,"Brentford",3,46,61,55,62,-7,1.32608695652174,1.19565217391304,1.34782608695652,-0.152173913043478,55,11,24,68,53,93,2,NA
2010,"Brighton & Hove Albion",3,46,95,85,40,45,2.06521739130435,1.84782608695652,0.869565217391304,0.978260869565217,45,1,24,68,29,93,16,NA
2010,"Bristol City",2,46,60,62,65,-3,1.30434782608696,1.34782608695652,1.41304347826087,-0.0652173913043478,35,15,24,44,41,108,-6,NA
2010,"Bristol Rovers",3,46,45,48,82,-34,0.978260869565217,1.04347826086957,1.78260869565217,-0.739130434782609,67,23,24,68,82,92,-15,NA
2010,"Burnley",2,46,68,65,61,4,1.47826086956522,1.41304347826087,1.32608695652174,0.0869565217391304,28,8,24,44,33,121,-5,NA
2010,"Burton Albion",4,46,51,56,70,-14,1.10869565217391,1.21739130434783,1.52173913043478,-0.304347826086957,88,20,24,92,85,11,3,NA
2010,"Bury",4,46,81,82,50,32,1.76086956521739,1.78260869565217,1.08695652173913,0.695652173913043,70,2,24,92,56,114,14,NA
2010,"Cardiff City",2,46,80,76,54,22,1.73913043478261,1.65217391304348,1.17391304347826,0.478260869565217,23,3,24,44,26,93,-3,NA
2010,"Carlisle United",3,46,59,60,62,-2,1.28260869565217,1.30434782608696,1.34782608695652,-0.0434782608695652,56,12,24,68,52,84,4,NA
2010,"Charlton Athletic",3,46,59,62,66,-4,1.28260869565217,1.34782608695652,1.43478260869565,-0.0869565217391304,57,13,24,68,45,92,12,NA
2010,"Chelsea",1,38,71,69,33,36,1.86842105263158,1.81578947368421,0.868421052631579,0.947368421052632,2,2,20,20,6,104,-4,NA
2010,"Cheltenham",4,46,52,56,77,-21,1.1304347826087,1.21739130434783,1.67391304347826,-0.456521739130435,86,18,24,92,74,20,12,NA
2010,"Chesterfield",4,46,86,85,51,34,1.8695652173913,1.84782608695652,1.10869565217391,0.739130434782609,69,1,24,92,66,100,3,NA
2010,"Colchester United",3,46,62,57,63,-6,1.34782608695652,1.23913043478261,1.3695652173913,-0.130434782608696,54,10,24,68,54,68,0,NA
2010,"Coventry City",2,46,55,54,58,-4,1.19565217391304,1.17391304347826,1.26086956521739,-0.0869565217391304,38,18,24,44,43,94,-5,NA
2010,"Crewe Alexandra",4,46,65,87,65,22,1.41304347826087,1.89130434782609,1.41304347826087,0.478260869565217,78,10,24,92,75,96,3,NA
2010,"Crystal Palace",2,46,48,44,69,-25,1.04347826086957,0.956521739130435,1.5,-0.543478260869565,40,20,24,44,37,93,3,NA
2010,"Dagenham and Redbridge",3,46,47,52,70,-18,1.02173913043478,1.1304347826087,1.52173913043478,-0.391304347826087,66,22,24,68,87,9,-21,NA
2010,"Derby County",2,46,49,58,71,-13,1.06521739130435,1.26086956521739,1.54347826086957,-0.282608695652174,39,19,24,44,31,121,8,NA
2010,"Doncaster Rovers",2,46,48,55,81,-26,1.04347826086957,1.19565217391304,1.76086956521739,-0.565217391304348,41,21,24,44,44,88,-3,NA
2010,"Everton",1,38,54,51,45,6,1.42105263157895,1.34210526315789,1.18421052631579,0.157894736842105,7,7,20,20,7,121,0,NA
2010,"Exeter City",3,46,70,66,73,-7,1.52173913043478,1.43478260869565,1.58695652173913,-0.152173913043478,51,7,24,68,67,88,-16,NA
2010,"Fulham",1,38,49,49,43,6,1.28947368421053,1.28947368421053,1.13157894736842,0.157894736842105,8,8,20,20,8,102,0,NA
2010,"Gillingham",4,46,68,67,57,10,1.47826086956522,1.45652173913043,1.23913043478261,0.217391304347826,76,8,24,92,76,88,0,NA
2010,"Hartlepool United",3,46,57,47,65,-18,1.23913043478261,1.02173913043478,1.41304347826087,-0.391304347826087,60,16,24,68,57,89,3,NA
2010,"Hereford United",4,46,53,50,66,-16,1.15217391304348,1.08695652173913,1.43478260869565,-0.347826086956522,84,16,24,92,91,31,-7,NA
2010,"Huddersfield Town",3,46,87,77,48,29,1.89130434782609,1.67391304347826,1.04347826086957,0.630434782608696,47,3,24,68,48,99,-1,NA
2010,"Hull City",2,46,65,52,51,1,1.41304347826087,1.1304347826087,1.10869565217391,0.0217391304347826,31,11,24,44,28,104,3,NA
2010,"Ipswich Town",2,46,62,62,68,-6,1.34782608695652,1.34782608695652,1.47826086956522,-0.130434782608696,32,12,24,44,34,75,-2,NA
2010,"Leeds United",2,46,72,81,70,11,1.56521739130435,1.76086956521739,1.52173913043478,0.239130434782609,27,7,24,44,35,93,-8,NA
2010,"Leicester City",2,46,67,76,71,5,1.45652173913043,1.65217391304348,1.54347826086957,0.108695652173913,29,9,24,44,30,115,-1,NA
2010,"Leyton Orient",3,46,70,71,62,9,1.52173913043478,1.54347826086957,1.34782608695652,0.195652173913043,52,8,24,68,63,102,-11,NA
2010,"Lincoln City",4,46,47,45,81,-36,1.02173913043478,0.978260869565217,1.76086956521739,-0.782608695652174,91,23,24,92,75,107,16,NA
2010,"Liverpool",1,38,58,59,44,15,1.52631578947368,1.55263157894737,1.15789473684211,0.394736842105263,6,6,20,20,9,116,-3,NA
2010,"Macclesfield",4,46,55,59,73,-14,1.19565217391304,1.28260869565217,1.58695652173913,-0.304347826086957,83,15,24,92,92,17,-9,NA
2010,"Manchester City",1,38,71,60,33,27,1.86842105263158,1.57894736842105,0.868421052631579,0.710526315789474,3,3,20,20,1,117,2,NA
2010,"Manchester United",1,38,80,78,37,41,2.10526315789474,2.05263157894737,0.973684210526316,1.07894736842105,1,1,20,20,2,117,-1,NA
2010,"Middlesbrough",2,46,62,68,68,0,1.34782608695652,1.47826086956522,1.47826086956522,0,33,13,24,44,27,110,6,NA
2010,"Millwall",2,46,67,62,48,14,1.45652173913043,1.34782608695652,1.04347826086957,0.304347826086957,30,10,24,44,36,93,-6,NA
2010,"Milton Keynes Dons",3,46,77,67,60,7,1.67391304347826,1.45652173913043,1.30434782608696,0.152173913043478,49,5,24,68,49,16,0,NA
2010,"Morecambe",4,46,51,54,73,-19,1.10869565217391,1.17391304347826,1.58695652173913,-0.41304347826087,89,21,24,92,83,13,6,NA
2010,"Newcastle United",1,38,46,56,57,-1,1.21052631578947,1.47368421052632,1.5,-0.0263157894736842,13,13,20,20,5,116,8,NA
2010,"Northampton Town",4,46,52,63,71,-8,1.1304347826087,1.3695652173913,1.54347826086957,-0.173913043478261,87,19,24,92,88,93,-1,NA
2010,"Norwich City",2,46,84,83,58,25,1.82608695652174,1.80434782608696,1.26086956521739,0.543478260869565,22,2,24,44,10,93,12,NA
2010,"Nottingham Forest",2,46,75,69,50,19,1.6304347826087,1.5,1.08695652173913,0.41304347826087,26,6,24,44,38,117,-12,NA
2010,"Notts County",3,46,50,46,60,-14,1.08695652173913,1,1.30434782608696,-0.304347826086957,64,20,24,68,50,120,14,NA
2010,"Oldham Athletic",3,46,56,53,60,-7,1.21739130434783,1.15217391304348,1.30434782608696,-0.152173913043478,61,17,24,68,59,102,2,NA
2010,"Oxford United",4,46,63,58,60,-2,1.3695652173913,1.26086956521739,1.30434782608696,-0.0434782608695652,80,12,24,92,78,54,2,NA
2010,"Peterborough United",3,46,79,106,75,31,1.71739130434783,2.30434782608696,1.6304347826087,0.673913043478261,48,4,24,68,39,60,9,NA
2010,"Plymouth Argyle",3,46,52,51,74,-23,1.1304347826087,1.10869565217391,1.60869565217391,-0.5,63,19,24,68,90,93,-27,NA
2010,"Port Vale",4,46,65,54,49,5,1.41304347826087,1.17391304347826,1.06521739130435,0.108695652173913,79,11,24,92,77,107,2,NA
2010,"Portsmouth",2,46,58,53,60,-7,1.26086956521739,1.15217391304348,1.30434782608696,-0.152173913043478,36,16,24,44,40,93,-4,NA
2010,"Preston North End",2,46,42,54,79,-25,0.91304347826087,1.17391304347826,1.71739130434783,-0.543478260869565,42,22,24,44,60,121,-18,NA
2010,"Queens Park Rangers",2,46,88,71,32,39,1.91304347826087,1.54347826086957,0.695652173913043,0.847826086956522,21,1,24,44,17,93,4,NA
2010,"Reading",2,46,77,77,51,26,1.67391304347826,1.67391304347826,1.10869565217391,0.565217391304348,25,5,24,44,21,93,4,NA
2010,"Rochdale",3,46,68,63,55,8,1.47826086956522,1.3695652173913,1.19565217391304,0.173913043478261,53,9,24,68,68,92,-15,NA
2010,"Rotherham United",4,46,66,75,60,15,1.43478260869565,1.6304347826087,1.30434782608696,0.326086956521739,77,9,24,92,79,88,-2,NA
2010,"Scunthorpe United",2,46,42,43,87,-44,0.91304347826087,0.934782608695652,1.89130434782609,-0.956521739130435,43,23,24,44,62,70,-19,NA
2010,"Sheffield United",2,46,42,44,79,-35,0.91304347826087,0.956521739130435,1.71739130434783,-0.760869565217391,44,24,24,44,47,117,-3,NA
2010,"Sheffield Wednesday",3,46,58,67,67,0,1.26086956521739,1.45652173913043,1.45652173913043,0,59,15,24,68,46,117,13,NA
2010,"Shrewsbury Town",4,46,79,72,49,23,1.71739130434783,1.56521739130435,1.06521739130435,0.5,72,4,24,92,70,69,2,NA
2010,"Southampton",3,46,92,86,38,48,2,1.8695652173913,0.826086956521739,1.04347826086957,46,2,24,68,22,93,24,NA
2010,"Southend United",4,46,61,62,56,6,1.32608695652174,1.34782608695652,1.21739130434783,0.130434782608696,82,14,24,92,72,93,10,NA
2010,"Stevenage Borough",4,46,69,62,45,17,1.5,1.34782608695652,0.978260869565217,0.369565217391304,74,6,24,92,51,10,23,NA
2010,"Stockport County",4,46,41,48,96,-48,0.891304347826087,1.04347826086957,2.08695652173913,-1.04347826086957,92,24,24,92,NA,99,NA,NA
2010,"Stoke City",1,38,46,46,48,-2,1.21052631578947,1.21052631578947,1.26315789473684,-0.0526315789473684,14,14,20,20,13,113,1,NA
2010,"Sunderland",1,38,47,45,56,-11,1.23684210526316,1.18421052631579,1.47368421052632,-0.289473684210526,10,10,20,20,14,119,-4,NA
2010,"Swansea City",2,46,80,69,42,27,1.73913043478261,1.5,0.91304347826087,0.58695652173913,24,4,24,44,11,93,13,NA
2010,"Swindon Town",3,46,41,50,72,-22,0.891304347826087,1.08695652173913,1.56521739130435,-0.478260869565217,68,24,24,68,69,93,-1,NA
2010,"Torquay United",4,46,69,74,53,21,1.5,1.60869565217391,1.15217391304348,0.456521739130435,75,7,24,92,73,78,2,NA
2010,"Tottenham Hotspur",1,38,62,55,46,9,1.63157894736842,1.44736842105263,1.21052631578947,0.236842105263158,5,5,20,20,4,101,1,NA
2010,"Tranmere Rovers",3,46,56,53,60,-7,1.21739130434783,1.15217391304348,1.30434782608696,-0.152173913043478,62,18,24,68,58,89,4,NA
2010,"Walsall",3,46,48,56,75,-19,1.04347826086957,1.21739130434783,1.6304347826087,-0.41304347826087,65,21,24,68,64,100,1,NA
2010,"Watford",2,46,61,77,71,6,1.32608695652174,1.67391304347826,1.54347826086957,0.130434782608696,34,14,24,44,32,93,2,NA
2010,"West Bromwich Albion",1,38,47,56,71,-15,1.23684210526316,1.47368421052632,1.86842105263158,-0.394736842105263,11,11,20,20,12,121,-1,NA
2010,"West Ham United",1,38,33,43,70,-27,0.868421052631579,1.13157894736842,1.84210526315789,-0.710526315789474,20,20,20,20,23,94,-3,NA
2010,"Wigan Athletic",1,38,42,40,61,-21,1.10526315789474,1.05263157894737,1.60526315789474,-0.552631578947368,16,16,20,20,15,42,1,NA
2010,"Wolverhampton Wanderers",1,38,40,46,66,-20,1.05263157894737,1.21052631578947,1.73684210526316,-0.526315789473684,17,17,20,20,20,121,-3,NA
2010,"Wycombe Wanderers",4,46,80,69,50,19,1.73913043478261,1.5,1.08695652173913,0.41304347826087,71,3,24,92,65,27,6,NA
2010,"Yeovil",3,46,59,56,66,-10,1.28260869565217,1.21739130434783,1.43478260869565,-0.217391304347826,58,14,24,68,61,16,-3,NA
2011,"Accrington",4,46,57,54,66,-12,1.23913043478261,1.17391304347826,1.43478260869565,-0.260869565217391,81,13,24,92,86,14,-5,NA
2011,"AFC Bournemouth",3,46,58,48,52,-4,1.26086956521739,1.04347826086957,1.1304347826087,-0.0869565217391304,55,11,24,68,46,90,9,NA
2011,"AFC Wimbledon",4,46,54,62,78,-16,1.17391304347826,1.34782608695652,1.69565217391304,-0.347826086956522,84,16,24,92,87,9,-3,NA
2011,"Aldershot",4,46,66,54,52,2,1.43478260869565,1.17391304347826,1.1304347826087,0.0434782608695652,80,12,24,92,92,57,-12,NA
2011,"Arsenal",1,38,70,74,49,25,1.84210526315789,1.94736842105263,1.28947368421053,0.657894736842105,3,3,20,20,4,116,-1,NA
2011,"Aston Villa",1,38,38,37,53,-16,1,0.973684210526316,1.39473684210526,-0.421052631578947,16,16,20,20,14,121,2,NA
2011,"Barnet",4,46,46,52,79,-27,1,1.1304347826087,1.71739130434783,-0.58695652173913,89,21,24,92,90,21,-1,NA
2011,"Barnsley",2,46,48,49,74,-25,1.04347826086957,1.06521739130435,1.60869565217391,-0.543478260869565,42,22,24,44,41,111,1,NA
2011,"Birmingham City",2,46,76,78,51,27,1.65217391304348,1.69565217391304,1.10869565217391,0.58695652173913,24,4,24,44,30,117,-6,NA
2011,"Blackburn Rovers",1,38,31,48,78,-30,0.815789473684211,1.26315789473684,2.05263157894737,-0.789473684210526,19,19,20,20,37,121,-18,NA
2011,"Blackpool",2,46,75,79,59,20,1.6304347826087,1.71739130434783,1.28260869565217,0.434782608695652,25,5,24,44,35,112,-10,NA
2011,"Bolton Wanderers",1,38,36,46,77,-31,0.947368421052632,1.21052631578947,2.02631578947368,-0.815789473684211,18,18,20,20,26,121,-8,NA
2011,"Bradford City",4,46,50,54,59,-5,1.08695652173913,1.17391304347826,1.28260869565217,-0.108695652173913,86,18,24,92,75,106,11,NA
2011,"Brentford",3,46,67,63,52,11,1.45652173913043,1.3695652173913,1.1304347826087,0.239130434782609,53,9,24,68,47,93,6,NA
2011,"Brighton & Hove Albion",2,46,66,52,52,0,1.43478260869565,1.1304347826087,1.1304347826087,0,29,9,24,44,24,93,5,NA
2011,"Bristol City",2,46,49,44,68,-24,1.06521739130435,0.956521739130435,1.47826086956522,-0.521739130434783,41,21,24,44,44,108,-3,NA
2011,"Bristol Rovers",4,46,57,60,70,-10,1.23913043478261,1.30434782608696,1.52173913043478,-0.217391304347826,82,14,24,92,81,92,1,NA
2011,"Burnley",2,46,62,61,58,3,1.34782608695652,1.32608695652174,1.26086956521739,0.0652173913043478,33,13,24,44,31,121,2,NA
2011,"Burton Albion",4,46,54,54,81,-27,1.17391304347826,1.17391304347826,1.76086956521739,-0.58695652173913,85,17,24,92,72,11,13,NA
2011,"Bury",3,46,56,60,79,-19,1.21739130434783,1.30434782608696,1.71739130434783,-0.41304347826087,56,12,24,68,67,114,-11,NA
2011,"Cardiff City",2,46,75,66,53,13,1.6304347826087,1.43478260869565,1.15217391304348,0.282608695652174,26,6,24,44,21,93,5,NA
2011,"Carlisle United",3,46,69,65,66,-1,1.5,1.41304347826087,1.43478260869565,-0.0217391304347826,52,8,24,68,60,84,-8,NA
2011,"Charlton Athletic",3,46,101,82,36,46,2.19565217391304,1.78260869565217,0.782608695652174,1,45,1,24,68,29,92,16,NA
2011,"Chelsea",1,38,64,65,46,19,1.68421052631579,1.71052631578947,1.21052631578947,0.5,6,6,20,20,3,104,3,NA
2011,"Cheltenham",4,46,77,66,50,16,1.67391304347826,1.43478260869565,1.08695652173913,0.347826086956522,74,6,24,92,73,20,1,NA
2011,"Chesterfield",3,46,42,56,81,-25,0.91304347826087,1.21739130434783,1.76086956521739,-0.543478260869565,66,22,24,68,76,100,-10,NA
2011,"Colchester United",3,46,59,61,66,-5,1.28260869565217,1.32608695652174,1.43478260869565,-0.108695652173913,54,10,24,68,63,68,-9,NA
2011,"Coventry City",2,46,40,41,65,-24,0.869565217391304,0.891304347826087,1.41304347826087,-0.521739130434783,43,23,24,44,56,94,-13,NA
2011,"Crawley Town",4,46,84,76,54,22,1.82608695652174,1.65217391304348,1.17391304347826,0.478260869565217,71,3,24,92,53,9,18,NA
2011,"Crewe Alexandra",4,46,72,67,59,8,1.56521739130435,1.45652173913043,1.28260869565217,0.173913043478261,75,7,24,92,58,96,17,NA
2011,"Crystal Palace",2,46,56,46,51,-5,1.21739130434783,1,1.10869565217391,-0.108695652173913,37,17,24,44,25,93,12,NA
2011,"Dagenham and Redbridge",4,46,50,50,72,-22,1.08695652173913,1.08695652173913,1.56521739130435,-0.478260869565217,87,19,24,92,91,9,-4,NA
2011,"Derby County",2,46,64,50,58,-8,1.39130434782609,1.08695652173913,1.26086956521739,-0.173913043478261,31,11,24,44,32,121,-1,NA
2011,"Doncaster Rovers",2,46,36,43,80,-37,0.782608695652174,0.934782608695652,1.73913043478261,-0.804347826086957,44,24,24,44,45,88,-1,NA
2011,"Everton",1,38,56,50,40,10,1.47368421052632,1.31578947368421,1.05263157894737,0.263157894736842,7,7,20,20,6,121,1,NA
2011,"Exeter City",3,46,42,46,75,-29,0.91304347826087,1,1.6304347826087,-0.630434782608696,67,23,24,68,78,88,-11,NA
2011,"Fulham",1,38,52,48,51,-3,1.36842105263158,1.26315789473684,1.34210526315789,-0.0789473684210526,8,8,20,20,12,102,-4,NA
2011,"Gillingham",4,46,70,79,62,17,1.52173913043478,1.71739130434783,1.34782608695652,0.369565217391304,76,8,24,92,69,88,7,NA
2011,"Hartlepool United",3,46,56,50,55,-5,1.21739130434783,1.08695652173913,1.19565217391304,-0.108695652173913,57,13,24,68,68,89,-11,NA
2011,"Hereford United",4,46,44,50,70,-20,0.956521739130435,1.08695652173913,1.52173913043478,-0.434782608695652,91,23,24,92,NA,31,NA,NA
2011,"Huddersfield Town",3,46,81,79,47,32,1.76086956521739,1.71739130434783,1.02173913043478,0.695652173913043,48,4,24,68,38,99,10,NA
2011,"Hull City",2,46,68,47,44,3,1.47826086956522,1.02173913043478,0.956521739130435,0.0652173913043478,28,8,24,44,22,104,6,NA
2011,"Ipswich Town",2,46,61,69,77,-8,1.32608695652174,1.5,1.67391304347826,-0.173913043478261,34,14,24,44,34,75,0,NA
2011,"Leeds United",2,46,61,65,68,-3,1.32608695652174,1.41304347826087,1.47826086956522,-0.0652173913043478,35,15,24,44,33,93,2,NA
2011,"Leicester City",2,46,66,66,55,11,1.43478260869565,1.43478260869565,1.19565217391304,0.239130434782609,30,10,24,44,27,115,3,NA
2011,"Leyton Orient",3,46,50,48,75,-27,1.08695652173913,1.04347826086957,1.6304347826087,-0.58695652173913,63,19,24,68,51,102,12,NA
2011,"Liverpool",1,38,52,47,40,7,1.36842105263158,1.23684210526316,1.05263157894737,0.184210526315789,9,9,20,20,7,116,2,NA
2011,"Macclesfield",4,46,37,39,64,-25,0.804347826086957,0.847826086956522,1.39130434782609,-0.543478260869565,92,24,24,92,90,17,2,NA
2011,"Manchester City",1,38,89,93,29,64,2.34210526315789,2.44736842105263,0.763157894736842,1.68421052631579,1,1,20,20,2,117,-1,NA
2011,"Manchester United",1,38,89,89,33,56,2.34210526315789,2.34210526315789,0.868421052631579,1.47368421052632,2,2,20,20,1,117,1,NA
2011,"Middlesbrough",2,46,70,52,51,1,1.52173913043478,1.1304347826087,1.10869565217391,0.0217391304347826,27,7,24,44,36,110,-9,NA
2011,"Millwall",2,46,57,55,57,-2,1.23913043478261,1.19565217391304,1.23913043478261,-0.0434782608695652,36,16,24,44,40,93,-4,NA
2011,"Milton Keynes Dons",3,46,80,84,47,37,1.73913043478261,1.82608695652174,1.02173913043478,0.804347826086957,49,5,24,68,52,16,-3,NA
2011,"Morecambe",4,46,56,63,57,6,1.21739130434783,1.3695652173913,1.23913043478261,0.130434782608696,83,15,24,92,84,13,-1,NA
2011,"Newcastle United",1,38,65,56,51,5,1.71052631578947,1.47368421052632,1.34210526315789,0.131578947368421,5,5,20,20,15,116,-10,NA
2011,"Northampton Town",4,46,48,56,79,-23,1.04347826086957,1.21739130434783,1.71739130434783,-0.5,88,20,24,92,74,93,14,NA
2011,"Norwich City",1,38,47,52,66,-14,1.23684210526316,1.36842105263158,1.73684210526316,-0.368421052631579,10,10,20,20,11,93,-1,NA
2011,"Nottingham Forest",2,46,50,48,63,-15,1.08695652173913,1.04347826086957,1.3695652173913,-0.326086956521739,38,18,24,44,28,117,10,NA
2011,"Notts County",3,46,73,75,63,12,1.58695652173913,1.6304347826087,1.3695652173913,0.260869565217391,50,6,24,68,57,120,-7,NA
2011,"Oldham Athletic",3,46,54,50,66,-16,1.17391304347826,1.08695652173913,1.43478260869565,-0.347826086956522,59,15,24,68,64,102,-5,NA
2011,"Oxford United",4,46,68,59,48,11,1.47826086956522,1.28260869565217,1.04347826086957,0.239130434782609,78,10,24,92,77,54,1,NA
2011,"Peterborough United",2,46,50,67,77,-10,1.08695652173913,1.45652173913043,1.67391304347826,-0.217391304347826,39,19,24,44,42,60,-3,NA
2011,"Plymouth Argyle",4,46,46,47,64,-17,1,1.02173913043478,1.39130434782609,-0.369565217391304,90,22,24,92,89,93,1,NA
2011,"Port Vale",4,46,69,68,60,8,1.5,1.47826086956522,1.30434782608696,0.173913043478261,77,9,24,92,71,107,6,NA
2011,"Portsmouth",2,46,50,50,59,-9,1.08695652173913,1.08695652173913,1.28260869565217,-0.195652173913043,40,20,24,44,66,93,-26,NA
2011,"Preston North End",3,46,54,54,68,-14,1.17391304347826,1.17391304347826,1.47826086956522,-0.304347826086957,60,16,24,68,59,121,1,NA
2011,"Queens Park Rangers",1,38,37,43,66,-23,0.973684210526316,1.13157894736842,1.73684210526316,-0.605263157894737,17,17,20,20,20,93,-3,NA
2011,"Reading",2,46,89,69,41,28,1.93478260869565,1.5,0.891304347826087,0.608695652173913,21,1,24,44,19,93,2,NA
2011,"Rochdale",3,46,38,47,81,-34,0.826086956521739,1.02173913043478,1.76086956521739,-0.739130434782609,68,24,24,68,79,92,-11,NA
2011,"Rotherham United",4,46,67,67,63,4,1.45652173913043,1.45652173913043,1.3695652173913,0.0869565217391304,79,11,24,92,70,88,9,NA
2011,"Scunthorpe United",3,46,52,55,59,-4,1.1304347826087,1.19565217391304,1.28260869565217,-0.0869565217391304,62,18,24,68,65,70,-3,NA
2011,"Sheffield United",3,46,90,92,51,41,1.95652173913043,2,1.10869565217391,0.891304347826087,47,3,24,68,49,117,-2,NA
2011,"Sheffield Wednesday",3,46,93,81,48,33,2.02173913043478,1.76086956521739,1.04347826086957,0.717391304347826,46,2,24,68,39,117,7,NA
2011,"Shrewsbury Town",4,46,88,66,41,25,1.91304347826087,1.43478260869565,0.891304347826087,0.543478260869565,70,2,24,92,61,69,9,NA
2011,"Southampton",2,46,88,85,46,39,1.91304347826087,1.84782608695652,1,0.847826086956522,22,2,24,44,16,93,6,NA
2011,"Southend United",4,46,83,77,48,29,1.80434782608696,1.67391304347826,1.04347826086957,0.630434782608696,72,4,24,92,80,93,-8,NA
2011,"Stevenage Borough",3,46,73,69,44,25,1.58695652173913,1.5,0.956521739130435,0.543478260869565,51,7,24,68,62,10,-11,NA
2011,"Stoke City",1,38,45,36,53,-17,1.18421052631579,0.947368421052632,1.39473684210526,-0.447368421052632,13,13,20,20,13,113,0,NA
2011,"Sunderland",1,38,45,45,46,-1,1.18421052631579,1.18421052631579,1.21052631578947,-0.0263157894736842,14,14,20,20,17,119,-3,NA
2011,"Swansea City",1,38,47,44,51,-7,1.23684210526316,1.15789473684211,1.34210526315789,-0.184210526315789,11,11,20,20,9,93,2,NA
2011,"Swindon Town",4,46,93,75,32,43,2.02173913043478,1.6304347826087,0.695652173913043,0.934782608695652,69,1,24,92,50,93,19,NA
2011,"Torquay United",4,46,81,63,50,13,1.76086956521739,1.3695652173913,1.08695652173913,0.282608695652174,73,5,24,92,88,78,-15,NA
2011,"Tottenham Hotspur",1,38,69,66,41,25,1.81578947368421,1.73684210526316,1.07894736842105,0.657894736842105,4,4,20,20,5,101,-1,NA
2011,"Tranmere Rovers",3,46,56,49,53,-4,1.21739130434783,1.06521739130435,1.15217391304348,-0.0869565217391304,58,14,24,68,55,89,3,NA
2011,"Walsall",3,46,50,51,57,-6,1.08695652173913,1.10869565217391,1.23913043478261,-0.130434782608696,64,20,24,68,54,100,10,NA
2011,"Watford",2,46,64,56,64,-8,1.39130434782609,1.21739130434783,1.39130434782609,-0.173913043478261,32,12,24,44,23,93,9,NA
2011,"West Bromwich Albion",1,38,47,45,52,-7,1.23684210526316,1.18421052631579,1.36842105263158,-0.184210526315789,12,12,20,20,8,121,4,NA
2011,"West Ham United",2,46,86,81,48,33,1.8695652173913,1.76086956521739,1.04347826086957,0.717391304347826,23,3,24,44,10,94,13,NA
2011,"Wigan Athletic",1,38,43,42,62,-20,1.13157894736842,1.10526315789474,1.63157894736842,-0.526315789473684,15,15,20,20,18,42,-3,NA
2011,"Wolverhampton Wanderers",1,38,25,40,82,-42,0.657894736842105,1.05263157894737,2.15789473684211,-1.10526315789474,20,20,20,20,43,121,-23,NA
2011,"Wycombe Wanderers",3,46,43,65,88,-23,0.934782608695652,1.41304347826087,1.91304347826087,-0.5,65,21,24,68,83,27,-18,NA
2011,"Yeovil",3,46,54,59,80,-21,1.17391304347826,1.28260869565217,1.73913043478261,-0.456521739130435,61,17,24,68,48,16,13,NA
2012,"Accrington",4,46,54,51,68,-17,1.17391304347826,1.10869565217391,1.47826086956522,-0.369565217391304,86,18,24,92,83,14,3,NA
2012,"AFC Bournemouth",3,46,83,76,53,23,1.80434782608696,1.65217391304348,1.15217391304348,0.5,46,2,24,68,30,90,16,NA
2012,"AFC Wimbledon",4,46,53,54,76,-22,1.15217391304348,1.17391304347826,1.65217391304348,-0.478260869565217,87,19,24,92,84,9,3,NA
2012,"Aldershot",4,46,48,42,60,-18,1.04347826086957,0.91304347826087,1.30434782608696,-0.391304347826087,92,24,24,92,NA,57,NA,NA
2012,"Arsenal",1,38,73,72,37,35,1.92105263157895,1.89473684210526,0.973684210526316,0.921052631578947,4,4,20,20,4,116,0,NA
2012,"Aston Villa",1,38,41,47,69,-22,1.07894736842105,1.23684210526316,1.81578947368421,-0.578947368421053,14,14,20,20,14,121,0,NA
2012,"Barnet",4,46,51,47,59,-12,1.10869565217391,1.02173913043478,1.28260869565217,-0.260869565217391,90,22,24,92,83,21,7,NA
2012,"Barnsley",2,46,55,56,70,-14,1.19565217391304,1.21739130434783,1.52173913043478,-0.304347826086957,41,21,24,44,43,111,-2,NA
2012,"Birmingham City",2,46,61,63,69,-6,1.32608695652174,1.3695652173913,1.5,-0.130434782608696,30,10,24,44,41,117,-11,NA
2012,"Blackburn Rovers",2,46,58,55,62,-7,1.26086956521739,1.19565217391304,1.34782608695652,-0.152173913043478,37,17,24,44,28,121,9,NA
2012,"Blackpool",2,46,59,62,63,-1,1.28260869565217,1.34782608695652,1.3695652173913,-0.0217391304347826,35,15,24,44,40,112,-5,NA
2012,"Bolton Wanderers",2,46,68,69,61,8,1.47826086956522,1.5,1.32608695652174,0.173913043478261,26,6,24,44,34,121,-8,NA
2012,"Bradford City",4,46,69,63,52,11,1.5,1.3695652173913,1.1304347826087,0.239130434782609,75,7,24,92,56,106,19,NA
2012,"Brentford",3,46,79,62,47,15,1.71739130434783,1.34782608695652,1.02173913043478,0.326086956521739,47,3,24,68,46,93,1,NA
2012,"Brighton & Hove Albion",2,46,75,69,43,26,1.6304347826087,1.5,0.934782608695652,0.565217391304348,24,4,24,44,26,93,-2,NA
2012,"Bristol City",2,46,41,59,84,-25,0.891304347826087,1.28260869565217,1.82608695652174,-0.543478260869565,44,24,24,44,57,108,-13,NA
2012,"Bristol Rovers",4,46,60,60,69,-9,1.30434782608696,1.30434782608696,1.5,-0.195652173913043,81,13,24,92,90,92,-9,NA
2012,"Burnley",2,46,61,62,60,2,1.32608695652174,1.34782608695652,1.30434782608696,0.0434782608695652,31,11,24,44,22,121,9,NA
2012,"Burton Albion",4,46,76,71,65,6,1.65217391304348,1.54347826086957,1.41304347826087,0.130434782608696,72,4,24,92,73,11,-1,NA
2012,"Bury",3,46,41,45,73,-28,0.891304347826087,0.978260869565217,1.58695652173913,-0.608695652173913,67,23,24,68,80,114,-13,NA
2012,"Cardiff City",2,46,87,72,45,27,1.89130434782609,1.56521739130435,0.978260869565217,0.58695652173913,21,1,24,44,20,93,1,NA
2012,"Carlisle United",3,46,55,56,77,-21,1.19565217391304,1.21739130434783,1.67391304347826,-0.456521739130435,60,16,24,68,66,84,-6,NA
2012,"Charlton Athletic",2,46,65,65,59,6,1.41304347826087,1.41304347826087,1.28260869565217,0.130434782608696,29,9,24,44,38,92,-9,NA
2012,"Chelsea",1,38,75,75,39,36,1.97368421052632,1.97368421052632,1.02631578947368,0.947368421052632,3,3,20,20,3,104,0,NA
2012,"Cheltenham",4,46,75,58,51,7,1.6304347826087,1.26086956521739,1.10869565217391,0.152173913043478,73,5,24,92,85,20,-12,NA
2012,"Chesterfield",4,46,67,60,45,15,1.45652173913043,1.30434782608696,0.978260869565217,0.326086956521739,76,8,24,92,69,100,7,NA
2012,"Colchester United",3,46,51,47,68,-21,1.10869565217391,1.02173913043478,1.47826086956522,-0.456521739130435,63,19,24,68,61,68,2,NA
2012,"Coventry City",3,46,65,66,59,7,1.41304347826087,1.43478260869565,1.28260869565217,0.152173913043478,56,12,24,68,53,94,3,NA
2012,"Crawley Town",3,46,68,59,58,1,1.47826086956522,1.28260869565217,1.26086956521739,0.0217391304347826,53,9,24,68,59,9,-6,NA
2012,"Crewe Alexandra",3,46,64,54,62,-8,1.39130434782609,1.17391304347826,1.34782608695652,-0.173913043478261,58,14,24,68,63,96,-5,NA
2012,"Crystal Palace",2,46,72,73,62,11,1.56521739130435,1.58695652173913,1.34782608695652,0.239130434782609,25,5,24,44,11,93,14,NA
2012,"Dagenham and Redbridge",4,46,51,55,62,-7,1.10869565217391,1.19565217391304,1.34782608695652,-0.152173913043478,91,23,24,92,77,9,14,NA
2012,"Derby County",2,46,61,65,62,3,1.32608695652174,1.41304347826087,1.34782608695652,0.0652173913043478,32,12,24,44,23,121,9,NA
2012,"Doncaster Rovers",3,46,84,62,44,18,1.82608695652174,1.34782608695652,0.956521739130435,0.391304347826087,45,1,24,68,42,88,3,NA
2012,"Everton",1,38,63,55,40,15,1.65789473684211,1.44736842105263,1.05263157894737,0.394736842105263,6,6,20,20,5,121,1,NA
2012,"Exeter City",4,46,64,63,62,1,1.39130434782609,1.3695652173913,1.34782608695652,0.0217391304347826,78,10,24,92,86,88,-8,NA
2012,"Fleetwood Town",4,46,60,55,57,-2,1.30434782608696,1.19565217391304,1.23913043478261,-0.0434782608695652,82,14,24,92,72,8,10,NA
2012,"Fulham",1,38,43,50,60,-10,1.13157894736842,1.31578947368421,1.57894736842105,-0.263157894736842,12,12,20,20,19,102,-7,NA
2012,"Gillingham",4,46,83,66,39,27,1.80434782608696,1.43478260869565,0.847826086956522,0.58695652173913,69,1,24,92,62,88,7,NA
2012,"Hartlepool United",3,46,41,39,67,-28,0.891304347826087,0.847826086956522,1.45652173913043,-0.608695652173913,68,24,24,68,88,89,-20,NA
2012,"Huddersfield Town",2,46,58,53,73,-20,1.26086956521739,1.15217391304348,1.58695652173913,-0.434782608695652,38,18,24,44,36,99,2,NA
2012,"Hull City",2,46,79,61,52,9,1.71739130434783,1.32608695652174,1.1304347826087,0.195652173913043,22,2,24,44,16,104,6,NA
2012,"Ipswich Town",2,46,60,48,61,-13,1.30434782608696,1.04347826086957,1.32608695652174,-0.282608695652174,34,14,24,44,29,75,5,NA
2012,"Leeds United",2,46,61,57,66,-9,1.32608695652174,1.23913043478261,1.43478260869565,-0.195652173913043,33,13,24,44,35,93,-2,NA
2012,"Leicester City",2,46,68,71,48,23,1.47826086956522,1.54347826086957,1.04347826086957,0.5,27,7,24,44,21,115,6,NA
2012,"Leyton Orient",3,46,71,55,48,7,1.54347826086957,1.19565217391304,1.04347826086957,0.152173913043478,51,7,24,68,47,102,4,NA
2012,"Liverpool",1,38,61,71,43,28,1.60526315789474,1.86842105263158,1.13157894736842,0.736842105263158,7,7,20,20,2,116,5,NA
2012,"Manchester City",1,38,78,66,34,32,2.05263157894737,1.73684210526316,0.894736842105263,0.842105263157895,2,2,20,20,1,117,1,NA
2012,"Manchester United",1,38,89,86,43,43,2.34210526315789,2.26315789473684,1.13157894736842,1.13157894736842,1,1,20,20,7,117,-6,NA
2012,"Middlesbrough",2,46,59,61,70,-9,1.28260869565217,1.32608695652174,1.52173913043478,-0.195652173913043,36,16,24,44,32,110,4,NA
2012,"Millwall",2,46,56,51,62,-11,1.21739130434783,1.10869565217391,1.34782608695652,-0.239130434782609,40,20,24,44,39,93,1,NA
2012,"Milton Keynes Dons",3,46,70,62,45,17,1.52173913043478,1.34782608695652,0.978260869565217,0.369565217391304,52,8,24,68,55,16,-3,NA
2012,"Morecambe",4,46,58,55,61,-6,1.26086956521739,1.19565217391304,1.32608695652174,-0.130434782608696,84,16,24,92,87,13,-3,NA
2012,"Newcastle United",1,38,41,45,68,-23,1.07894736842105,1.18421052631579,1.78947368421053,-0.605263157894737,15,15,20,20,10,116,5,NA
2012,"Northampton Town",4,46,73,64,55,9,1.58695652173913,1.39130434782609,1.19565217391304,0.195652173913043,74,6,24,92,89,93,-15,NA
2012,"Norwich City",1,38,44,41,58,-17,1.15789473684211,1.07894736842105,1.52631578947368,-0.447368421052632,11,11,20,20,18,93,-7,NA
2012,"Nottingham Forest",2,46,67,63,59,4,1.45652173913043,1.3695652173913,1.28260869565217,0.0869565217391304,28,8,24,44,31,117,-3,NA
2012,"Notts County",3,46,65,61,49,12,1.41304347826087,1.32608695652174,1.06521739130435,0.260869565217391,57,13,24,68,64,120,-7,NA
2012,"Oldham Athletic",3,46,51,46,59,-13,1.10869565217391,1,1.28260869565217,-0.282608695652174,64,20,24,68,60,102,4,NA
2012,"Oxford United",4,46,65,60,61,-1,1.41304347826087,1.30434782608696,1.32608695652174,-0.0217391304347826,77,9,24,92,76,54,1,NA
2012,"Peterborough United",2,46,54,66,75,-9,1.17391304347826,1.43478260869565,1.6304347826087,-0.195652173913043,42,22,24,44,50,60,-8,NA
2012,"Plymouth Argyle",4,46,52,46,55,-9,1.1304347826087,1,1.19565217391304,-0.195652173913043,89,21,24,92,79,93,10,NA
2012,"Port Vale",4,46,78,87,52,35,1.69565217391304,1.89130434782609,1.1304347826087,0.760869565217391,71,3,24,92,54,107,17,NA
2012,"Portsmouth",3,46,42,51,69,-18,0.91304347826087,1.10869565217391,1.5,-0.391304347826087,66,22,24,68,81,93,-15,NA
2012,"Preston North End",3,46,59,54,49,5,1.28260869565217,1.17391304347826,1.06521739130435,0.108695652173913,59,15,24,68,49,121,10,NA
2012,"Queens Park Rangers",1,38,25,30,60,-30,0.657894736842105,0.789473684210526,1.57894736842105,-0.789473684210526,20,20,20,20,24,93,-4,NA
2012,"Reading",1,38,28,43,73,-30,0.736842105263158,1.13157894736842,1.92105263157895,-0.789473684210526,19,19,20,20,27,93,-8,NA
2012,"Rochdale",4,46,61,68,70,-2,1.32608695652174,1.47826086956522,1.52173913043478,-0.0434782608695652,79,11,24,92,70,92,9,NA
2012,"Rotherham United",4,46,79,74,59,15,1.71739130434783,1.60869565217391,1.28260869565217,0.326086956521739,70,2,24,92,48,88,22,NA
2012,"Scunthorpe United",3,46,48,49,73,-24,1.04347826086957,1.06521739130435,1.58695652173913,-0.521739130434783,65,21,24,68,71,70,-6,NA
2012,"Sheffield United",3,46,75,56,42,14,1.6304347826087,1.21739130434783,0.91304347826087,0.304347826086957,49,5,24,68,51,117,-2,NA
2012,"Sheffield Wednesday",2,46,58,53,61,-8,1.26086956521739,1.15217391304348,1.32608695652174,-0.173913043478261,39,19,24,44,37,117,2,NA
2012,"Shrewsbury Town",3,46,55,54,60,-6,1.19565217391304,1.17391304347826,1.30434782608696,-0.130434782608696,61,17,24,68,67,69,-6,NA
2012,"Southampton",1,38,41,49,60,-11,1.07894736842105,1.28947368421053,1.57894736842105,-0.289473684210526,16,16,20,20,8,93,8,NA
2012,"Southend United",4,46,61,61,55,6,1.32608695652174,1.32608695652174,1.19565217391304,0.130434782608696,80,12,24,92,74,93,6,NA
2012,"Stevenage Borough",3,46,54,47,64,-17,1.17391304347826,1.02173913043478,1.39130434782609,-0.369565217391304,62,18,24,68,68,10,-6,NA
2012,"Stoke City",1,38,42,34,45,-11,1.10526315789474,0.894736842105263,1.18421052631579,-0.289473684210526,13,13,20,20,9,113,4,NA
2012,"Sunderland",1,38,39,41,54,-13,1.02631578947368,1.07894736842105,1.42105263157895,-0.342105263157895,17,17,20,20,15,119,2,NA
2012,"Swansea City",1,38,46,47,51,-4,1.21052631578947,1.23684210526316,1.34210526315789,-0.105263157894737,9,9,20,20,12,93,-3,NA
2012,"Swindon Town",3,46,74,72,39,33,1.60869565217391,1.56521739130435,0.847826086956522,0.717391304347826,50,6,24,68,52,93,-2,NA
2012,"Torquay United",4,46,53,55,62,-7,1.15217391304348,1.19565217391304,1.34782608695652,-0.152173913043478,88,20,24,92,92,78,-4,NA
2012,"Tottenham Hotspur",1,38,72,66,46,20,1.89473684210526,1.73684210526316,1.21052631578947,0.526315789473684,5,5,20,20,6,101,-1,NA
2012,"Tranmere Rovers",3,46,67,58,48,10,1.45652173913043,1.26086956521739,1.04347826086957,0.217391304347826,55,11,24,68,65,89,-10,NA
2012,"Walsall",3,46,68,65,58,7,1.47826086956522,1.41304347826087,1.26086956521739,0.152173913043478,54,10,24,68,58,100,-4,NA
2012,"Watford",2,46,77,85,58,27,1.67391304347826,1.84782608695652,1.26086956521739,0.58695652173913,23,3,24,44,33,93,-10,NA
2012,"West Bromwich Albion",1,38,49,53,57,-4,1.28947368421053,1.39473684210526,1.5,-0.105263157894737,8,8,20,20,17,121,-9,NA
2012,"West Ham United",1,38,46,45,53,-8,1.21052631578947,1.18421052631579,1.39473684210526,-0.210526315789474,10,10,20,20,13,94,-3,NA
2012,"Wigan Athletic",1,38,36,47,73,-26,0.947368421052632,1.23684210526316,1.92105263157895,-0.684210526315789,18,18,20,20,25,42,-7,NA
2012,"Wolverhampton Wanderers",2,46,51,55,69,-14,1.10869565217391,1.19565217391304,1.5,-0.304347826086957,43,23,24,44,45,121,-2,NA
2012,"Wycombe Wanderers",4,46,60,50,60,-10,1.30434782608696,1.08695652173913,1.30434782608696,-0.217391304347826,83,15,24,92,91,27,-8,NA
2012,"Yeovil",3,46,77,71,56,15,1.67391304347826,1.54347826086957,1.21739130434783,0.326086956521739,48,4,24,68,44,16,4,NA
2012,"York City",4,46,55,50,60,-10,1.19565217391304,1.08695652173913,1.30434782608696,-0.217391304347826,85,17,24,92,75,72,10,NA
2013,"Accrington",4,46,57,54,56,-2,1.23913043478261,1.17391304347826,1.21739130434783,-0.0434782608695652,83,15,24,92,85,14,-2,NA
2013,"AFC Bournemouth",2,46,66,67,66,1,1.43478260869565,1.45652173913043,1.43478260869565,0.0217391304347826,30,10,24,44,21,90,9,NA
2013,"AFC Wimbledon",4,46,56,49,57,-8,1.21739130434783,1.06521739130435,1.23913043478261,-0.173913043478261,84,16,24,92,83,9,1,NA
2013,"Arsenal",1,38,79,68,41,27,2.07894736842105,1.78947368421053,1.07894736842105,0.710526315789474,4,4,20,20,3,116,1,NA
2013,"Aston Villa",1,38,38,39,61,-22,1,1.02631578947368,1.60526315789474,-0.578947368421053,14,14,20,20,16,121,-2,NA
2013,"Barnsley",2,46,39,44,77,-33,0.847826086956522,0.956521739130435,1.67391304347826,-0.717391304347826,43,23,24,44,55,111,-12,NA
2013,"Birmingham City",2,46,44,58,74,-16,0.956521739130435,1.26086956521739,1.60869565217391,-0.347826086956522,41,21,24,44,30,117,11,NA
2013,"Blackburn Rovers",2,46,70,70,62,8,1.52173913043478,1.52173913043478,1.34782608695652,0.173913043478261,28,8,24,44,29,121,-1,NA
2013,"Blackpool",2,46,46,38,66,-28,1,0.826086956521739,1.43478260869565,-0.608695652173913,40,20,24,44,44,112,-4,NA
2013,"Bolton Wanderers",2,46,59,59,60,-1,1.28260869565217,1.28260869565217,1.30434782608696,-0.0217391304347826,34,14,24,44,38,121,-4,NA
2013,"Bradford City",3,46,59,57,54,3,1.28260869565217,1.23913043478261,1.17391304347826,0.0652173913043478,56,12,24,68,51,106,5,NA
2013,"Brentford",3,46,94,72,43,29,2.04347826086957,1.56521739130435,0.934782608695652,0.630434782608696,46,2,24,68,25,93,21,NA
2013,"Brighton & Hove Albion",2,46,72,55,40,15,1.56521739130435,1.19565217391304,0.869565217391304,0.326086956521739,26,6,24,44,41,93,-15,NA
2013,"Bristol City",3,46,58,70,67,3,1.26086956521739,1.52173913043478,1.45652173913043,0.0652173913043478,57,13,24,68,45,108,12,NA
2013,"Bristol Rovers",4,46,50,43,54,-11,1.08695652173913,0.934782608695652,1.17391304347826,-0.239130434782609,90,22,24,92,72,92,18,NA
2013,"Burnley",2,46,93,72,37,35,2.02173913043478,1.56521739130435,0.804347826086957,0.760869565217391,22,2,24,44,19,121,3,NA
2013,"Burton Albion",4,46,72,47,42,5,1.56521739130435,1.02173913043478,0.91304347826087,0.108695652173913,73,5,24,92,69,11,4,NA
2013,"Bury",4,46,59,59,51,8,1.28260869565217,1.28260869565217,1.10869565217391,0.173913043478261,80,12,24,92,71,114,9,NA
2013,"Cardiff City",1,38,30,32,74,-42,0.789473684210526,0.842105263157895,1.94736842105263,-1.10526315789474,20,20,20,20,31,93,-11,NA
2013,"Carlisle United",3,46,45,43,76,-33,0.978260869565217,0.934782608695652,1.65217391304348,-0.717391304347826,66,22,24,68,88,84,-22,NA
2013,"Charlton Athletic",2,46,51,41,61,-20,1.10869565217391,0.891304347826087,1.32608695652174,-0.434782608695652,38,18,24,44,32,92,6,NA
2013,"Chelsea",1,38,82,71,27,44,2.15789473684211,1.86842105263158,0.710526315789474,1.15789473684211,3,3,20,20,1,104,2,NA
2013,"Cheltenham",4,46,55,53,63,-10,1.19565217391304,1.15217391304348,1.3695652173913,-0.217391304347826,85,17,24,92,91,20,-6,NA
2013,"Chesterfield",4,46,84,71,40,31,1.82608695652174,1.54347826086957,0.869565217391304,0.673913043478261,69,1,24,92,50,100,19,NA
2013,"Colchester United",3,46,53,53,61,-8,1.15217391304348,1.15217391304348,1.32608695652174,-0.173913043478261,61,17,24,68,63,68,-2,NA
2013,"Coventry City",3,46,61,74,77,-3,1.32608695652174,1.60869565217391,1.67391304347826,-0.0652173913043478,53,9,24,68,61,94,-8,NA
2013,"Crawley Town",3,46,57,48,54,-6,1.23913043478261,1.04347826086957,1.17391304347826,-0.130434782608696,59,15,24,68,65,9,-6,NA
2013,"Crewe Alexandra",3,46,51,54,80,-26,1.10869565217391,1.17391304347826,1.73913043478261,-0.565217391304348,63,19,24,68,64,96,-1,NA
2013,"Crystal Palace",1,38,45,33,48,-15,1.18421052631579,0.868421052631579,1.26315789473684,-0.394736842105263,11,11,20,20,10,93,1,NA
2013,"Dagenham and Redbridge",4,46,60,53,59,-6,1.30434782608696,1.15217391304348,1.28260869565217,-0.130434782608696,77,9,24,92,82,9,-5,NA
2013,"Derby County",2,46,85,84,52,32,1.84782608695652,1.82608695652174,1.1304347826087,0.695652173913043,23,3,24,44,28,121,-5,NA
2013,"Doncaster Rovers",2,46,44,39,70,-31,0.956521739130435,0.847826086956522,1.52173913043478,-0.673913043478261,42,22,24,44,57,88,-15,NA
2013,"Everton",1,38,72,61,39,22,1.89473684210526,1.60526315789474,1.02631578947368,0.578947368421053,5,5,20,20,11,121,-6,NA
2013,"Exeter City",4,46,55,54,57,-3,1.19565217391304,1.17391304347826,1.23913043478261,-0.0652173913043478,86,18,24,92,78,88,8,NA
2013,"Fleetwood Town",4,46,76,66,52,14,1.65217391304348,1.43478260869565,1.1304347826087,0.304347826086957,72,4,24,92,52,8,20,NA
2013,"Fulham",1,38,32,40,85,-45,0.842105263157895,1.05263157894737,2.23684210526316,-1.18421052631579,19,19,20,20,37,102,-18,NA
2013,"Gillingham",3,46,53,60,79,-19,1.15217391304348,1.30434782608696,1.71739130434783,-0.41304347826087,62,18,24,68,56,88,6,NA
2013,"Hartlepool United",4,46,53,50,56,-6,1.15217391304348,1.08695652173913,1.21739130434783,-0.130434782608696,88,20,24,92,90,89,-2,NA
2013,"Huddersfield Town",2,46,53,58,65,-7,1.15217391304348,1.26086956521739,1.41304347826087,-0.152173913043478,36,16,24,44,36,99,0,NA
2013,"Hull City",1,38,37,38,53,-15,0.973684210526316,1,1.39473684210526,-0.394736842105263,16,16,20,20,18,104,-2,NA
2013,"Ipswich Town",2,46,68,60,54,6,1.47826086956522,1.30434782608696,1.17391304347826,0.130434782608696,29,9,24,44,26,75,3,NA
2013,"Leeds United",2,46,57,59,67,-8,1.23913043478261,1.28260869565217,1.45652173913043,-0.173913043478261,35,15,24,44,35,93,0,NA
2013,"Leicester City",2,46,102,83,43,40,2.21739130434783,1.80434782608696,0.934782608695652,0.869565217391304,21,1,24,44,14,115,7,NA
2013,"Leyton Orient",3,46,86,85,45,40,1.8695652173913,1.84782608695652,0.978260869565217,0.869565217391304,47,3,24,68,67,102,-20,NA
2013,"Liverpool",1,38,84,101,50,51,2.21052631578947,2.65789473684211,1.31578947368421,1.34210526315789,2,2,20,20,6,116,-4,NA
2013,"Manchester City",1,38,86,102,37,65,2.26315789473684,2.68421052631579,0.973684210526316,1.71052631578947,1,1,20,20,2,117,-1,NA
2013,"Manchester United",1,38,64,64,43,21,1.68421052631579,1.68421052631579,1.13157894736842,0.552631578947368,7,7,20,20,4,117,3,NA
2013,"Mansfield Town",4,46,60,49,58,-9,1.30434782608696,1.06521739130435,1.26086956521739,-0.195652173913043,78,10,24,92,89,77,-11,NA
2013,"Middlesbrough",2,46,64,62,50,12,1.39130434782609,1.34782608695652,1.08695652173913,0.260869565217391,32,12,24,44,24,110,8,NA
2013,"Millwall",2,46,48,46,74,-28,1.04347826086957,1,1.60869565217391,-0.608695652173913,39,19,24,44,42,93,-3,NA
2013,"Milton Keynes Dons",3,46,60,63,65,-2,1.30434782608696,1.3695652173913,1.41304347826087,-0.0434782608695652,55,11,24,68,46,16,9,NA
2013,"Morecambe",4,46,54,52,64,-12,1.17391304347826,1.1304347826087,1.39130434782609,-0.260869565217391,87,19,24,92,79,13,8,NA
2013,"Newcastle United",1,38,49,43,59,-16,1.28947368421053,1.13157894736842,1.55263157894737,-0.421052631578947,10,10,20,20,15,116,-5,NA
2013,"Newport County",4,46,58,56,59,-3,1.26086956521739,1.21739130434783,1.28260869565217,-0.0652173913043478,82,14,24,92,77,67,5,NA
2013,"Northampton Town",4,46,53,42,57,-15,1.15217391304348,0.91304347826087,1.23913043478261,-0.326086956521739,89,21,24,92,80,93,9,NA
2013,"Norwich City",1,38,33,28,62,-34,0.868421052631579,0.736842105263158,1.63157894736842,-0.894736842105263,18,18,20,20,23,93,-5,NA
2013,"Nottingham Forest",2,46,65,67,64,3,1.41304347826087,1.45652173913043,1.39130434782609,0.0652173913043478,31,11,24,44,34,117,-3,NA
2013,"Notts County",3,46,50,64,77,-13,1.08695652173913,1.39130434782609,1.67391304347826,-0.282608695652174,64,20,24,68,66,120,-2,NA
2013,"Oldham Athletic",3,46,56,50,59,-9,1.21739130434783,1.08695652173913,1.28260869565217,-0.195652173913043,60,16,24,68,59,102,1,NA
2013,"Oxford United",4,46,62,53,50,3,1.34782608695652,1.15217391304348,1.08695652173913,0.0652173913043478,76,8,24,92,81,54,-5,NA
2013,"Peterborough United",3,46,74,72,58,14,1.60869565217391,1.56521739130435,1.26086956521739,0.304347826086957,50,6,24,68,53,60,-3,NA
2013,"Plymouth Argyle",4,46,60,51,58,-7,1.30434782608696,1.10869565217391,1.26086956521739,-0.152173913043478,79,11,24,92,75,93,4,NA
2013,"Port Vale",3,46,61,59,73,-14,1.32608695652174,1.28260869565217,1.58695652173913,-0.304347826086957,54,10,24,68,62,107,-8,NA
2013,"Portsmouth",4,46,59,56,66,-10,1.28260869565217,1.21739130434783,1.43478260869565,-0.217391304347826,81,13,24,92,84,93,-3,NA
2013,"Preston North End",3,46,85,72,46,26,1.84782608695652,1.56521739130435,1,0.565217391304348,49,5,24,68,47,121,2,NA
2013,"Queens Park Rangers",2,46,80,60,44,16,1.73913043478261,1.30434782608696,0.956521739130435,0.347826086956522,24,4,24,44,20,93,4,NA
2013,"Reading",2,46,71,70,56,14,1.54347826086957,1.52173913043478,1.21739130434783,0.304347826086957,27,7,24,44,39,93,-12,NA
2013,"Rochdale",4,46,81,69,48,21,1.76086956521739,1.5,1.04347826086957,0.456521739130435,70,2,24,92,54,92,16,NA
2013,"Rotherham United",3,46,86,86,58,28,1.8695652173913,1.8695652173913,1.26086956521739,0.608695652173913,48,4,24,68,40,88,8,NA
2013,"Scunthorpe United",4,46,81,68,44,24,1.76086956521739,1.47826086956522,0.956521739130435,0.521739130434783,71,3,24,92,60,70,11,NA
2013,"Sheffield United",3,46,67,48,46,2,1.45652173913043,1.04347826086957,1,0.0434782608695652,51,7,24,68,49,117,2,NA
2013,"Sheffield Wednesday",2,46,53,63,65,-2,1.15217391304348,1.3695652173913,1.41304347826087,-0.0434782608695652,37,17,24,44,33,117,4,NA
2013,"Shrewsbury Town",3,46,42,44,65,-21,0.91304347826087,0.956521739130435,1.41304347826087,-0.456521739130435,67,23,24,68,70,69,-3,NA
2013,"Southampton",1,38,56,54,46,8,1.47368421052632,1.42105263157895,1.21052631578947,0.210526315789474,8,8,20,20,7,93,1,NA
2013,"Southend United",4,46,72,56,39,17,1.56521739130435,1.21739130434783,0.847826086956522,0.369565217391304,74,6,24,92,72,93,2,NA
2013,"Stevenage Borough",3,46,42,46,72,-26,0.91304347826087,1,1.56521739130435,-0.565217391304348,68,24,24,68,74,10,-6,NA
2013,"Stoke City",1,38,50,45,52,-7,1.31578947368421,1.18421052631579,1.36842105263158,-0.184210526315789,9,9,20,20,9,113,0,NA
2013,"Sunderland",1,38,38,41,60,-19,1,1.07894736842105,1.57894736842105,-0.5,15,15,20,20,17,119,-2,NA
2013,"Swansea City",1,38,42,54,54,0,1.10526315789474,1.42105263157895,1.42105263157895,0,12,12,20,20,8,93,4,NA
2013,"Swindon Town",3,46,66,63,59,4,1.43478260869565,1.3695652173913,1.28260869565217,0.0869565217391304,52,8,24,68,48,93,4,NA
2013,"Torquay United",4,46,45,42,66,-24,0.978260869565217,0.91304347826087,1.43478260869565,-0.521739130434783,92,24,24,92,NA,78,NA,NA
2013,"Tottenham Hotspur",1,38,69,55,51,4,1.81578947368421,1.44736842105263,1.34210526315789,0.105263157894737,6,6,20,20,5,101,1,NA
2013,"Tranmere Rovers",3,46,47,52,79,-27,1.02173913043478,1.1304347826087,1.71739130434783,-0.58695652173913,65,21,24,68,92,89,-27,NA
2013,"Walsall",3,46,58,49,49,0,1.26086956521739,1.06521739130435,1.06521739130435,0,58,14,24,68,58,100,0,NA
2013,"Watford",2,46,60,74,64,10,1.30434782608696,1.60869565217391,1.39130434782609,0.217391304347826,33,13,24,44,22,93,11,NA
2013,"West Bromwich Albion",1,38,36,43,59,-16,0.947368421052632,1.13157894736842,1.55263157894737,-0.421052631578947,17,17,20,20,13,121,4,NA
2013,"West Ham United",1,38,40,40,51,-11,1.05263157894737,1.05263157894737,1.34210526315789,-0.289473684210526,13,13,20,20,12,94,1,NA
2013,"Wigan Athletic",2,46,73,61,48,13,1.58695652173913,1.32608695652174,1.04347826086957,0.282608695652174,25,5,24,44,43,42,-18,NA
2013,"Wolverhampton Wanderers",3,46,103,89,31,58,2.23913043478261,1.93478260869565,0.673913043478261,1.26086956521739,45,1,24,68,27,121,18,NA
2013,"Wycombe Wanderers",4,46,50,46,54,-8,1.08695652173913,1,1.17391304347826,-0.173913043478261,91,23,24,92,73,27,18,NA
2013,"Yeovil",2,46,37,44,75,-31,0.804347826086957,0.956521739130435,1.6304347826087,-0.673913043478261,44,24,24,44,68,16,-24,NA
2013,"York City",4,46,71,52,41,11,1.54347826086957,1.1304347826087,0.891304347826087,0.239130434782609,75,7,24,92,86,72,-11,NA
2014,"Accrington",4,46,56,58,77,-19,1.21739130434783,1.26086956521739,1.67391304347826,-0.41304347826087,85,17,24,92,71,14,14,NA
2014,"AFC Bournemouth",2,46,90,98,45,53,1.95652173913043,2.1304347826087,0.978260869565217,1.15217391304348,21,1,24,44,15,90,6,NA
2014,"AFC Wimbledon",4,46,58,54,60,-6,1.26086956521739,1.17391304347826,1.30434782608696,-0.130434782608696,83,15,24,92,75,9,8,NA
2014,"Arsenal",1,38,75,71,36,35,1.97368421052632,1.86842105263158,0.947368421052632,0.921052631578947,3,3,20,20,2,116,1,NA
2014,"Aston Villa",1,38,38,31,57,-26,1,0.815789473684211,1.5,-0.684210526315789,16,16,20,20,20,121,-4,NA
2014,"Barnsley",3,46,62,62,61,1,1.34782608695652,1.34782608695652,1.32608695652174,0.0217391304347826,55,11,24,68,50,111,5,NA
2014,"Birmingham City",2,46,63,54,64,-10,1.3695652173913,1.17391304347826,1.39130434782609,-0.217391304347826,30,10,24,44,30,117,0,NA
2014,"Blackburn Rovers",2,46,67,66,59,7,1.45652173913043,1.43478260869565,1.28260869565217,0.152173913043478,29,9,24,44,35,121,-6,NA
2014,"Blackpool",2,46,26,36,91,-55,0.565217391304348,0.782608695652174,1.97826086956522,-1.19565217391304,44,24,24,44,65,112,-21,NA
2014,"Bolton Wanderers",2,46,51,54,67,-13,1.10869565217391,1.17391304347826,1.45652173913043,-0.282608695652174,38,18,24,44,44,121,-6,NA
2014,"Bradford City",3,46,65,55,55,0,1.41304347826087,1.19565217391304,1.19565217391304,0,51,7,24,68,49,106,2,NA
2014,"Brentford",2,46,78,78,59,19,1.69565217391304,1.69565217391304,1.28260869565217,0.41304347826087,25,5,24,44,29,93,-4,NA
2014,"Brighton & Hove Albion",2,46,47,44,54,-10,1.02173913043478,0.956521739130435,1.17391304347826,-0.217391304347826,41,21,24,44,22,93,19,NA
2014,"Bristol City",3,46,99,96,38,58,2.15217391304348,2.08695652173913,0.826086956521739,1.26086956521739,45,1,24,68,37,108,8,NA
2014,"Burnley",1,38,33,28,53,-25,0.868421052631579,0.736842105263158,1.39473684210526,-0.657894736842105,19,19,20,20,21,121,-2,NA
2014,"Burton Albion",4,46,94,69,39,30,2.04347826086957,1.5,0.847826086956522,0.652173913043478,69,1,24,92,46,11,23,NA
2014,"Bury",4,46,85,60,40,20,1.84782608695652,1.30434782608696,0.869565217391304,0.434782608695652,71,3,24,92,58,114,13,NA
2014,"Cambridge United",4,46,51,61,66,-5,1.10869565217391,1.32608695652174,1.43478260869565,-0.108695652173913,87,19,24,92,77,41,10,NA
2014,"Cardiff City",2,46,62,57,61,-4,1.34782608695652,1.23913043478261,1.32608695652174,-0.0869565217391304,31,11,24,44,28,93,3,NA
2014,"Carlisle United",4,46,50,56,74,-18,1.08695652173913,1.21739130434783,1.60869565217391,-0.391304347826087,88,20,24,92,78,84,10,NA
2014,"Charlton Athletic",2,46,60,54,60,-6,1.30434782608696,1.17391304347826,1.30434782608696,-0.130434782608696,32,12,24,44,42,92,-10,NA
2014,"Chelsea",1,38,87,73,32,41,2.28947368421053,1.92105263157895,0.842105263157895,1.07894736842105,1,1,20,20,10,104,-9,NA
2014,"Cheltenham",4,46,41,40,67,-27,0.891304347826087,0.869565217391304,1.45652173913043,-0.58695652173913,91,23,24,92,88,20,3,NA
2014,"Chesterfield",3,46,69,68,55,13,1.5,1.47826086956522,1.19565217391304,0.282608695652174,50,6,24,68,62,100,-12,NA
2014,"Colchester United",3,46,52,58,77,-19,1.1304347826087,1.26086956521739,1.67391304347826,-0.41304347826087,63,19,24,68,67,68,-4,NA
2014,"Coventry City",3,46,55,49,60,-11,1.19565217391304,1.06521739130435,1.30434782608696,-0.239130434782609,61,17,24,68,52,94,9,NA
2014,"Crawley Town",3,46,50,53,79,-26,1.08695652173913,1.15217391304348,1.71739130434783,-0.565217391304348,65,21,24,68,88,9,-23,NA
2014,"Crewe Alexandra",3,46,52,43,75,-32,1.1304347826087,0.934782608695652,1.6304347826087,-0.695652173913043,64,20,24,68,68,96,-4,NA
2014,"Crystal Palace",1,38,48,47,51,-4,1.26315789473684,1.23684210526316,1.34210526315789,-0.105263157894737,10,10,20,20,16,93,-6,NA
2014,"Dagenham and Redbridge",4,46,59,58,59,-1,1.28260869565217,1.26086956521739,1.28260869565217,-0.0217391304347826,82,14,24,92,91,9,-9,NA
2014,"Derby County",2,46,77,85,56,29,1.67391304347826,1.84782608695652,1.21739130434783,0.630434782608696,28,8,24,44,25,121,3,NA
2014,"Doncaster Rovers",3,46,61,58,62,-4,1.32608695652174,1.26086956521739,1.34782608695652,-0.0869565217391304,57,13,24,68,66,88,-9,NA
2014,"Everton",1,38,47,48,50,-2,1.23684210526316,1.26315789473684,1.31578947368421,-0.0526315789473684,11,11,20,20,11,121,0,NA
2014,"Exeter City",4,46,64,61,65,-4,1.39130434782609,1.32608695652174,1.41304347826087,-0.0869565217391304,78,10,24,92,80,88,-2,NA
2014,"Fleetwood Town",3,46,63,49,52,-3,1.3695652173913,1.06521739130435,1.1304347826087,-0.0652173913043478,52,8,24,68,63,8,-11,NA
2014,"Fulham",2,46,52,62,83,-21,1.1304347826087,1.34782608695652,1.80434782608696,-0.456521739130435,37,17,24,44,39,102,-2,NA
2014,"Gillingham",3,46,62,65,66,-1,1.34782608695652,1.41304347826087,1.43478260869565,-0.0217391304347826,56,12,24,68,53,88,3,NA
2014,"Hartlepool United",4,46,45,39,70,-31,0.978260869565217,0.847826086956522,1.52173913043478,-0.673913043478261,90,22,24,92,84,89,6,NA
2014,"Huddersfield Town",2,46,55,58,75,-17,1.19565217391304,1.26086956521739,1.6304347826087,-0.369565217391304,36,16,24,44,40,99,-4,NA
2014,"Hull City",1,38,35,33,51,-18,0.921052631578947,0.868421052631579,1.34210526315789,-0.473684210526316,18,18,20,20,24,104,-6,NA
2014,"Ipswich Town",2,46,78,72,54,18,1.69565217391304,1.56521739130435,1.17391304347826,0.391304347826087,26,6,24,44,27,75,-1,NA
2014,"Leeds United",2,46,56,50,61,-11,1.21739130434783,1.08695652173913,1.32608695652174,-0.239130434782609,35,15,24,44,33,93,2,NA
2014,"Leicester City",1,38,41,46,55,-9,1.07894736842105,1.21052631578947,1.44736842105263,-0.236842105263158,14,14,20,20,1,115,13,NA
2014,"Leyton Orient",3,46,49,59,69,-10,1.06521739130435,1.28260869565217,1.5,-0.217391304347826,67,23,24,68,76,102,-9,NA
2014,"Liverpool",1,38,62,52,48,4,1.63157894736842,1.36842105263158,1.26315789473684,0.105263157894737,6,6,20,20,8,116,-2,NA
2014,"Luton Town",4,46,68,54,44,10,1.47826086956522,1.17391304347826,0.956521739130435,0.217391304347826,76,8,24,92,79,91,-3,NA
2014,"Manchester City",1,38,79,83,38,45,2.07894736842105,2.18421052631579,1,1.18421052631579,2,2,20,20,4,117,-2,NA
2014,"Manchester United",1,38,70,62,37,25,1.84210526315789,1.63157894736842,0.973684210526316,0.657894736842105,4,4,20,20,5,117,-1,NA
2014,"Mansfield Town",4,46,48,38,62,-24,1.04347826086957,0.826086956521739,1.34782608695652,-0.521739130434783,89,21,24,92,81,77,8,NA
2014,"Middlesbrough",2,46,85,68,37,31,1.84782608695652,1.47826086956522,0.804347826086957,0.673913043478261,24,4,24,44,23,110,1,NA
2014,"Millwall",2,46,41,42,76,-34,0.891304347826087,0.91304347826087,1.65217391304348,-0.739130434782609,42,22,24,44,48,93,-6,NA
2014,"Milton Keynes Dons",3,46,91,101,44,57,1.97826086956522,2.19565217391304,0.956521739130435,1.23913043478261,46,2,24,68,43,16,3,NA
2014,"Morecambe",4,46,63,53,52,1,1.3695652173913,1.15217391304348,1.1304347826087,0.0217391304347826,79,11,24,92,89,13,-10,NA
2014,"Newcastle United",1,38,39,40,63,-23,1.02631578947368,1.05263157894737,1.65789473684211,-0.605263157894737,15,15,20,20,18,116,-3,NA
2014,"Newport County",4,46,65,51,54,-3,1.41304347826087,1.10869565217391,1.17391304347826,-0.0652173913043478,77,9,24,92,90,67,-13,NA
2014,"Northampton Town",4,46,61,67,62,5,1.32608695652174,1.45652173913043,1.34782608695652,0.108695652173913,80,12,24,92,69,93,11,NA
2014,"Norwich City",2,46,86,88,48,40,1.8695652173913,1.91304347826087,1.04347826086957,0.869565217391304,23,3,24,44,19,93,4,NA
2014,"Nottingham Forest",2,46,59,71,69,2,1.28260869565217,1.54347826086957,1.5,0.0434782608695652,34,14,24,44,36,117,-2,NA
2014,"Notts County",3,46,50,45,63,-18,1.08695652173913,0.978260869565217,1.3695652173913,-0.391304347826087,66,22,24,68,85,120,-19,NA
2014,"Oldham Athletic",3,46,57,54,67,-13,1.23913043478261,1.17391304347826,1.45652173913043,-0.282608695652174,59,15,24,68,61,102,-2,NA
2014,"Oxford United",4,46,61,50,49,1,1.32608695652174,1.08695652173913,1.06521739130435,0.0217391304347826,81,13,24,92,70,54,11,NA
2014,"Peterborough United",3,46,63,53,56,-3,1.3695652173913,1.15217391304348,1.21739130434783,-0.0652173913043478,53,9,24,68,57,60,-4,NA
2014,"Plymouth Argyle",4,46,71,55,37,18,1.54347826086957,1.19565217391304,0.804347826086957,0.391304347826087,75,7,24,92,73,93,2,NA
2014,"Port Vale",3,46,54,55,65,-10,1.17391304347826,1.19565217391304,1.41304347826087,-0.217391304347826,62,18,24,68,56,107,6,NA
2014,"Portsmouth",4,46,57,52,54,-2,1.23913043478261,1.1304347826087,1.17391304347826,-0.0434782608695652,84,16,24,92,74,93,10,NA
2014,"Preston North End",3,46,89,79,40,39,1.93478260869565,1.71739130434783,0.869565217391304,0.847826086956522,47,3,24,68,31,121,16,NA
2014,"Queens Park Rangers",1,38,30,42,73,-31,0.789473684210526,1.10526315789474,1.92105263157895,-0.815789473684211,20,20,20,20,32,93,-12,NA
2014,"Reading",2,46,50,48,69,-21,1.08695652173913,1.04347826086957,1.5,-0.456521739130435,39,19,24,44,38,93,1,NA
2014,"Rochdale",3,46,63,72,66,6,1.3695652173913,1.56521739130435,1.43478260869565,0.130434782608696,54,10,24,68,54,92,0,NA
2014,"Rotherham United",2,46,49,46,67,-21,1.06521739130435,1,1.45652173913043,-0.456521739130435,40,20,24,44,41,88,-1,NA
2014,"Scunthorpe United",3,46,56,62,75,-13,1.21739130434783,1.34782608695652,1.6304347826087,-0.282608695652174,60,16,24,68,51,70,9,NA
2014,"Sheffield United",3,46,71,66,53,13,1.54347826086957,1.43478260869565,1.15217391304348,0.282608695652174,49,5,24,68,55,117,-6,NA
2014,"Sheffield Wednesday",2,46,60,43,49,-6,1.30434782608696,0.934782608695652,1.06521739130435,-0.130434782608696,33,13,24,44,26,117,7,NA
2014,"Shrewsbury Town",4,46,89,67,31,36,1.93478260869565,1.45652173913043,0.673913043478261,0.782608695652174,70,2,24,92,64,69,6,NA
2014,"Southampton",1,38,60,54,33,21,1.57894736842105,1.42105263157895,0.868421052631579,0.552631578947368,7,7,20,20,6,93,1,NA
2014,"Southend United",4,46,84,54,38,16,1.82608695652174,1.17391304347826,0.826086956521739,0.347826086956522,72,4,24,92,59,93,13,NA
2014,"Stevenage Borough",4,46,72,62,54,8,1.56521739130435,1.34782608695652,1.17391304347826,0.173913043478261,74,6,24,92,86,10,-12,NA
2014,"Stoke City",1,38,54,48,45,3,1.42105263157895,1.26315789473684,1.18421052631579,0.0789473684210526,9,9,20,20,9,113,0,NA
2014,"Sunderland",1,38,38,31,53,-22,1,0.815789473684211,1.39473684210526,-0.578947368421053,17,17,20,20,17,119,0,NA
2014,"Swansea City",1,38,56,46,49,-3,1.47368421052632,1.21052631578947,1.28947368421053,-0.0789473684210526,8,8,20,20,12,93,-4,NA
2014,"Swindon Town",3,46,79,76,57,19,1.71739130434783,1.65217391304348,1.23913043478261,0.41304347826087,48,4,24,68,60,93,-12,NA
2014,"Tottenham Hotspur",1,38,64,58,53,5,1.68421052631579,1.52631578947368,1.39473684210526,0.131578947368421,5,5,20,20,3,101,2,NA
2014,"Tranmere Rovers",4,46,39,45,67,-22,0.847826086956522,0.978260869565217,1.45652173913043,-0.478260869565217,92,24,24,92,74,89,18,NA
2014,"Walsall",3,46,59,50,54,-4,1.28260869565217,1.08695652173913,1.17391304347826,-0.0869565217391304,58,14,24,68,47,100,11,NA
2014,"Watford",2,46,89,91,50,41,1.93478260869565,1.97826086956522,1.08695652173913,0.891304347826087,22,2,24,44,13,93,9,NA
2014,"West Bromwich Albion",1,38,44,38,51,-13,1.15789473684211,1,1.34210526315789,-0.342105263157895,13,13,20,20,14,121,-1,NA
2014,"West Ham United",1,38,47,44,47,-3,1.23684210526316,1.15789473684211,1.23684210526316,-0.0789473684210526,12,12,20,20,7,94,5,NA
2014,"Wigan Athletic",2,46,39,39,64,-25,0.847826086956522,0.847826086956522,1.39130434782609,-0.543478260869565,43,23,24,44,45,42,-2,NA
2014,"Wolverhampton Wanderers",2,46,78,70,56,14,1.69565217391304,1.52173913043478,1.21739130434783,0.304347826086957,27,7,24,44,34,121,-7,NA
2014,"Wycombe Wanderers",4,46,84,67,45,22,1.82608695652174,1.45652173913043,0.978260869565217,0.478260869565217,73,5,24,92,82,27,-9,NA
2014,"Yeovil",3,46,40,36,75,-39,0.869565217391304,0.782608695652174,1.6304347826087,-0.847826086956522,68,24,24,68,87,16,-19,NA
2014,"York City",4,46,52,46,51,-5,1.1304347826087,1,1.10869565217391,-0.108695652173913,86,18,24,92,92,72,-6,NA
2015,"Accrington",4,46,85,74,48,26,1.84782608695652,1.60869565217391,1.04347826086957,0.565217391304348,71,3,24,92,81,14,-10,NA
2015,"AFC Bournemouth",1,38,42,45,67,-22,1.10526315789474,1.18421052631579,1.76315789473684,-0.578947368421053,15,15,20,20,8,90,7,NA
2015,"AFC Wimbledon",4,46,75,64,50,14,1.6304347826087,1.39130434782609,1.08695652173913,0.304347826086957,75,7,24,92,59,9,16,NA
2015,"Arsenal",1,38,71,65,36,29,1.86842105263158,1.71052631578947,0.947368421052632,0.763157894736842,2,2,20,20,5,116,-3,NA
2015,"Aston Villa",1,38,17,27,76,-49,0.447368421052632,0.710526315789474,2,-1.28947368421053,20,20,20,20,31,121,-11,NA
2015,"Barnet",4,46,62,67,68,-1,1.34782608695652,1.45652173913043,1.47826086956522,-0.0217391304347826,83,15,24,92,83,21,0,NA
2015,"Barnsley",3,46,74,70,54,16,1.60869565217391,1.52173913043478,1.17391304347826,0.347826086956522,50,6,24,68,34,111,16,NA
2015,"Birmingham City",2,46,63,53,49,4,1.3695652173913,1.15217391304348,1.06521739130435,0.0869565217391304,30,10,24,44,38,117,-8,NA
2015,"Blackburn Rovers",2,46,55,46,46,0,1.19565217391304,1,1,0,35,15,24,44,41,121,-6,NA
2015,"Blackpool",3,46,46,40,63,-23,1,0.869565217391304,1.3695652173913,-0.5,65,21,24,68,75,112,-10,NA
2015,"Bolton Wanderers",2,46,30,41,81,-40,0.652173913043478,0.891304347826087,1.76086956521739,-0.869565217391304,44,24,24,44,46,121,-2,NA
2015,"Bradford City",3,46,80,55,40,15,1.73913043478261,1.19565217391304,0.869565217391304,0.326086956521739,49,5,24,68,49,106,0,NA
2015,"Brentford",2,46,65,72,67,5,1.41304347826087,1.56521739130435,1.45652173913043,0.108695652173913,29,9,24,44,30,93,-1,NA
2015,"Brighton & Hove Albion",2,46,89,72,42,30,1.93478260869565,1.56521739130435,0.91304347826087,0.652173913043478,22,2,24,44,22,93,0,NA
2015,"Bristol City",2,46,52,54,71,-17,1.1304347826087,1.17391304347826,1.54347826086957,-0.369565217391304,37,17,24,44,37,108,0,NA
2015,"Bristol Rovers",4,46,85,77,46,31,1.84782608695652,1.67391304347826,1,0.673913043478261,72,4,24,92,54,92,18,NA
2015,"Burnley",2,46,93,72,35,37,2.02173913043478,1.56521739130435,0.760869565217391,0.804347826086957,21,1,24,44,16,121,5,NA
2015,"Burton Albion",3,46,85,57,37,20,1.84782608695652,1.23913043478261,0.804347826086957,0.434782608695652,46,2,24,68,40,11,6,NA
2015,"Bury",3,46,60,56,73,-17,1.30434782608696,1.21739130434783,1.58695652173913,-0.369565217391304,58,14,24,68,63,114,-5,NA
2015,"Cambridge United",4,46,68,66,55,11,1.47826086956522,1.43478260869565,1.19565217391304,0.239130434782609,77,9,24,92,79,41,-2,NA
2015,"Cardiff City",2,46,68,56,51,5,1.47826086956522,1.21739130434783,1.10869565217391,0.108695652173913,28,8,24,44,32,93,-4,NA
2015,"Carlisle United",4,46,67,67,62,5,1.45652173913043,1.45652173913043,1.34782608695652,0.108695652173913,78,10,24,92,73,84,5,NA
2015,"Charlton Athletic",2,46,40,40,80,-40,0.869565217391304,0.869565217391304,1.73913043478261,-0.869565217391304,42,22,24,44,57,92,-15,NA
2015,"Chelsea",1,38,50,59,53,6,1.31578947368421,1.55263157894737,1.39473684210526,0.157894736842105,10,10,20,20,1,104,9,NA
2015,"Chesterfield",3,46,53,58,70,-12,1.15217391304348,1.26086956521739,1.52173913043478,-0.260869565217391,62,18,24,68,68,100,-6,NA
2015,"Colchester United",3,46,40,57,99,-42,0.869565217391304,1.23913043478261,2.15217391304348,-0.91304347826087,67,23,24,68,76,68,-9,NA
2015,"Coventry City",3,46,69,67,49,18,1.5,1.45652173913043,1.06521739130435,0.391304347826087,52,8,24,68,67,94,-15,NA
2015,"Crawley Town",4,46,47,45,78,-33,1.02173913043478,0.978260869565217,1.69565217391304,-0.717391304347826,88,20,24,92,87,9,1,NA
2015,"Crewe Alexandra",3,46,34,46,83,-37,0.739130434782609,1,1.80434782608696,-0.804347826086957,68,24,24,68,85,96,-17,NA
2015,"Crystal Palace",1,38,42,39,51,-12,1.10526315789474,1.02631578947368,1.34210526315789,-0.315789473684211,16,16,20,20,14,93,2,NA
2015,"Dagenham and Redbridge",4,46,34,46,81,-35,0.739130434782609,1,1.76086956521739,-0.760869565217391,91,23,24,92,NA,9,NA,NA
2015,"Derby County",2,46,78,66,43,23,1.69565217391304,1.43478260869565,0.934782608695652,0.5,25,5,24,44,29,121,-4,NA
2015,"Doncaster Rovers",3,46,46,48,64,-16,1,1.04347826086957,1.39130434782609,-0.347826086956522,66,22,24,68,71,88,-5,NA
2015,"Everton",1,38,47,59,55,4,1.23684210526316,1.55263157894737,1.44736842105263,0.105263157894737,11,11,20,20,7,121,4,NA
2015,"Exeter City",4,46,64,63,65,-2,1.39130434782609,1.3695652173913,1.41304347826087,-0.0434782608695652,80,12,24,92,74,88,6,NA
2015,"Fleetwood Town",3,46,51,52,56,-4,1.10869565217391,1.1304347826087,1.21739130434783,-0.0869565217391304,63,19,24,68,47,8,16,NA
2015,"Fulham",2,46,51,66,79,-13,1.10869565217391,1.43478260869565,1.71739130434783,-0.282608695652174,39,19,24,44,26,102,13,NA
2015,"Gillingham",3,46,69,71,56,15,1.5,1.54347826086957,1.21739130434783,0.326086956521739,53,9,24,68,64,88,-11,NA
2015,"Hartlepool United",4,46,51,49,72,-23,1.10869565217391,1.06521739130435,1.56521739130435,-0.5,84,16,24,92,91,89,-7,NA
2015,"Huddersfield Town",2,46,51,59,70,-11,1.10869565217391,1.28260869565217,1.52173913043478,-0.239130434782609,40,20,24,44,24,99,16,NA
2015,"Hull City",2,46,83,69,35,34,1.80434782608696,1.5,0.760869565217391,0.739130434782609,24,4,24,44,18,104,6,NA
2015,"Ipswich Town",2,46,69,53,51,2,1.5,1.15217391304348,1.10869565217391,0.0434782608695652,27,7,24,44,36,75,-9,NA
2015,"Leeds United",2,46,59,50,58,-8,1.28260869565217,1.08695652173913,1.26086956521739,-0.173913043478261,33,13,24,44,27,93,6,NA
2015,"Leicester City",1,38,81,68,36,32,2.13157894736842,1.78947368421053,0.947368421052632,0.842105263157895,1,1,20,20,12,115,-11,NA
2015,"Leyton Orient",4,46,69,60,61,-1,1.5,1.30434782608696,1.32608695652174,-0.0217391304347826,76,8,24,92,92,102,-16,NA
2015,"Liverpool",1,38,60,63,50,13,1.57894736842105,1.65789473684211,1.31578947368421,0.342105263157895,8,8,20,20,4,116,4,NA
2015,"Luton Town",4,46,66,63,61,2,1.43478260869565,1.3695652173913,1.32608695652174,0.0434782608695652,79,11,24,92,72,91,7,NA
2015,"Manchester City",1,38,66,71,41,30,1.73684210526316,1.86842105263158,1.07894736842105,0.789473684210526,4,4,20,20,3,117,1,NA
2015,"Manchester United",1,38,66,49,35,14,1.73684210526316,1.28947368421053,0.921052631578947,0.368421052631579,5,5,20,20,6,117,-1,NA
2015,"Mansfield Town",4,46,64,61,53,8,1.39130434782609,1.32608695652174,1.15217391304348,0.173913043478261,81,13,24,92,80,77,1,NA
2015,"Middlesbrough",2,46,89,63,31,32,1.93478260869565,1.3695652173913,0.673913043478261,0.695652173913043,23,3,24,44,19,110,4,NA
2015,"Millwall",3,46,81,73,49,24,1.76086956521739,1.58695652173913,1.06521739130435,0.521739130434783,48,4,24,68,50,93,-2,NA
2015,"Milton Keynes Dons",2,46,39,39,69,-30,0.847826086956522,0.847826086956522,1.5,-0.652173913043478,43,23,24,44,56,16,-13,NA
2015,"Morecambe",4,46,46,69,91,-22,1,1.5,1.97826086956522,-0.478260869565217,89,21,24,92,86,13,3,NA
2015,"Newcastle United",1,38,37,44,65,-21,0.973684210526316,1.15789473684211,1.71052631578947,-0.552631578947368,18,18,20,20,21,116,-3,NA
2015,"Newport County",4,46,43,43,64,-21,0.934782608695652,0.934782608695652,1.39130434782609,-0.456521739130435,90,22,24,92,90,67,0,NA
2015,"Northampton Town",4,46,99,82,46,36,2.15217391304348,1.78260869565217,1,0.782608695652174,69,1,24,92,60,93,9,NA
2015,"Norwich City",1,38,34,39,67,-28,0.894736842105263,1.02631578947368,1.76315789473684,-0.736842105263158,19,19,20,20,28,93,-9,NA
2015,"Nottingham Forest",2,46,55,43,47,-4,1.19565217391304,0.934782608695652,1.02173913043478,-0.0869565217391304,36,16,24,44,42,117,-6,NA
2015,"Notts County",4,46,51,54,83,-29,1.10869565217391,1.17391304347826,1.80434782608696,-0.630434782608696,85,17,24,92,84,120,1,NA
2015,"Oldham Athletic",3,46,54,44,58,-14,1.17391304347826,0.956521739130435,1.26086956521739,-0.304347826086957,61,17,24,68,61,102,0,NA
2015,"Oxford United",4,46,86,84,41,43,1.8695652173913,1.82608695652174,0.891304347826087,0.934782608695652,70,2,24,92,52,54,18,NA
2015,"Peterborough United",3,46,63,82,73,9,1.3695652173913,1.78260869565217,1.58695652173913,0.195652173913043,57,13,24,68,55,60,2,NA
2015,"Plymouth Argyle",4,46,81,72,46,26,1.76086956521739,1.56521739130435,1,0.565217391304348,73,5,24,92,69,93,4,NA
2015,"Port Vale",3,46,65,56,58,-2,1.41304347826087,1.21739130434783,1.26086956521739,-0.0434782608695652,56,12,24,68,65,107,-9,NA
2015,"Portsmouth",4,46,78,75,44,31,1.69565217391304,1.6304347826087,0.956521739130435,0.673913043478261,74,6,24,92,70,93,4,NA
2015,"Preston North End",2,46,62,45,45,0,1.34782608695652,0.978260869565217,0.978260869565217,0,31,11,24,44,33,121,-2,NA
2015,"Queens Park Rangers",2,46,60,54,54,0,1.30434782608696,1.17391304347826,1.17391304347826,0,32,12,24,44,39,93,-7,NA
2015,"Reading",2,46,52,52,59,-7,1.1304347826087,1.1304347826087,1.28260869565217,-0.152173913043478,38,18,24,44,23,93,15,NA
2015,"Rochdale",3,46,69,68,61,7,1.5,1.47826086956522,1.32608695652174,0.152173913043478,54,10,24,68,53,92,1,NA
2015,"Rotherham United",2,46,49,53,71,-18,1.06521739130435,1.15217391304348,1.54347826086957,-0.391304347826087,41,21,24,44,44,88,-3,NA
2015,"Scunthorpe United",3,46,74,60,47,13,1.60869565217391,1.30434782608696,1.02173913043478,0.282608695652174,51,7,24,68,48,70,3,NA
2015,"Sheffield United",3,46,66,64,59,5,1.43478260869565,1.39130434782609,1.28260869565217,0.108695652173913,55,11,24,68,45,117,10,NA
2015,"Sheffield Wednesday",2,46,74,66,45,21,1.60869565217391,1.43478260869565,0.978260869565217,0.456521739130435,26,6,24,44,25,117,1,NA
2015,"Shrewsbury Town",3,46,50,58,79,-21,1.08695652173913,1.26086956521739,1.71739130434783,-0.456521739130435,64,20,24,68,62,69,2,NA
2015,"Southampton",1,38,63,59,41,18,1.65789473684211,1.55263157894737,1.07894736842105,0.473684210526316,6,6,20,20,9,93,-3,NA
2015,"Southend United",3,46,59,58,64,-6,1.28260869565217,1.26086956521739,1.39130434782609,-0.130434782608696,59,15,24,68,51,93,8,NA
2015,"Stevenage Borough",4,46,48,52,67,-15,1.04347826086957,1.1304347826087,1.45652173913043,-0.326086956521739,86,18,24,92,78,10,8,NA
2015,"Stoke City",1,38,51,41,55,-14,1.34210526315789,1.07894736842105,1.44736842105263,-0.368421052631579,9,9,20,20,13,113,-4,NA
2015,"Sunderland",1,38,39,48,62,-14,1.02631578947368,1.26315789473684,1.63157894736842,-0.368421052631579,17,17,20,20,20,119,-3,NA
2015,"Swansea City",1,38,47,42,52,-10,1.23684210526316,1.10526315789474,1.36842105263158,-0.263157894736842,12,12,20,20,15,93,-3,NA
2015,"Swindon Town",3,46,59,64,71,-7,1.28260869565217,1.39130434782609,1.54347826086957,-0.152173913043478,60,16,24,68,66,93,-6,NA
2015,"Tottenham Hotspur",1,38,70,69,35,34,1.84210526315789,1.81578947368421,0.921052631578947,0.894736842105263,3,3,20,20,2,101,1,NA
2015,"Walsall",3,46,84,71,49,22,1.82608695652174,1.54347826086957,1.06521739130435,0.478260869565217,47,3,24,68,58,100,-11,NA
2015,"Watford",1,38,45,40,50,-10,1.18421052631579,1.05263157894737,1.31578947368421,-0.263157894736842,13,13,20,20,17,93,-4,NA
2015,"West Bromwich Albion",1,38,43,34,48,-14,1.13157894736842,0.894736842105263,1.26315789473684,-0.368421052631579,14,14,20,20,10,121,4,NA
2015,"West Ham United",1,38,62,65,51,14,1.63157894736842,1.71052631578947,1.34210526315789,0.368421052631579,7,7,20,20,11,94,-4,NA
2015,"Wigan Athletic",3,46,87,82,45,37,1.89130434782609,1.78260869565217,0.978260869565217,0.804347826086957,45,1,24,68,43,42,2,NA
2015,"Wolverhampton Wanderers",2,46,58,53,58,-5,1.26086956521739,1.15217391304348,1.26086956521739,-0.108695652173913,34,14,24,44,35,121,-1,NA
2015,"Wycombe Wanderers",4,46,64,45,44,1,1.39130434782609,0.978260869565217,0.956521739130435,0.0217391304347826,82,14,24,92,77,27,5,NA
2015,"Yeovil",4,46,48,43,59,-16,1.04347826086957,0.934782608695652,1.28260869565217,-0.347826086956522,87,19,24,92,89,16,-2,NA
2015,"York City",4,46,34,51,87,-36,0.739130434782609,1.10869565217391,1.89130434782609,-0.782608695652174,92,24,24,92,NA,72,NA,NA
2016,"Accrington",4,46,65,59,56,3,1.41304347826087,1.28260869565217,1.21739130434783,0.0652173913043478,81,13,24,92,69,14,12,NA
2016,"AFC Bournemouth",1,38,46,55,67,-12,1.21052631578947,1.44736842105263,1.76315789473684,-0.315789473684211,8,8,20,20,10,90,-2,NA
2016,"AFC Wimbledon",3,46,57,52,55,-3,1.23913043478261,1.1304347826087,1.19565217391304,-0.0652173913043478,59,15,24,68,62,9,-3,NA
2016,"Arsenal",1,38,75,77,44,33,1.97368421052632,2.02631578947368,1.15789473684211,0.868421052631579,5,5,20,20,6,116,-1,NA
2016,"Aston Villa",2,46,62,47,48,-1,1.34782608695652,1.02173913043478,1.04347826086957,-0.0217391304347826,31,11,24,44,24,121,7,NA
2016,"Barnet",4,46,57,57,64,-7,1.23913043478261,1.23913043478261,1.39130434782609,-0.152173913043478,83,15,24,92,90,21,-7,NA
2016,"Barnsley",2,46,58,64,67,-3,1.26086956521739,1.39130434782609,1.45652173913043,-0.0652173913043478,34,14,24,44,42,111,-8,NA
2016,"Birmingham City",2,46,53,45,64,-19,1.15217391304348,0.978260869565217,1.39130434782609,-0.41304347826087,38,18,24,44,39,117,-1,NA
2016,"Blackburn Rovers",2,46,51,53,65,-12,1.10869565217391,1.15217391304348,1.41304347826087,-0.260869565217391,41,21,24,44,46,121,-5,NA
2016,"Blackpool",4,46,70,69,46,23,1.52173913043478,1.5,1,0.5,75,7,24,92,56,112,19,NA
2016,"Bolton Wanderers",3,46,86,68,36,32,1.8695652173913,1.47826086956522,0.782608695652174,0.695652173913043,46,2,24,68,41,121,5,NA
2016,"Bradford City",3,46,79,62,43,19,1.71739130434783,1.34782608695652,0.934782608695652,0.41304347826087,49,5,24,68,54,106,-5,NA
2016,"Brentford",2,46,64,75,65,10,1.39130434782609,1.6304347826087,1.41304347826087,0.217391304347826,30,10,24,44,29,93,1,NA
2016,"Brighton & Hove Albion",2,46,93,74,40,34,2.02173913043478,1.60869565217391,0.869565217391304,0.739130434782609,22,2,24,44,15,93,7,NA
2016,"Bristol City",2,46,54,60,66,-6,1.17391304347826,1.30434782608696,1.43478260869565,-0.130434782608696,37,17,24,44,31,108,6,NA
2016,"Bristol Rovers",3,46,66,68,70,-2,1.43478260869565,1.47826086956522,1.52173913043478,-0.0434782608695652,54,10,24,68,57,92,-3,NA
2016,"Burnley",1,38,40,39,55,-16,1.05263157894737,1.02631578947368,1.44736842105263,-0.421052631578947,16,16,20,20,7,121,9,NA
2016,"Burton Albion",2,46,52,49,63,-14,1.1304347826087,1.06521739130435,1.3695652173913,-0.304347826086957,40,20,24,44,43,11,-3,NA
2016,"Bury",3,46,50,61,73,-12,1.08695652173913,1.32608695652174,1.58695652173913,-0.260869565217391,63,19,24,68,68,114,-5,NA
2016,"Cambridge United",4,46,66,58,50,8,1.43478260869565,1.26086956521739,1.08695652173913,0.173913043478261,79,11,24,92,79,41,0,NA
2016,"Cardiff City",2,46,62,60,61,-1,1.34782608695652,1.30434782608696,1.32608695652174,-0.0217391304347826,32,12,24,44,22,93,10,NA
2016,"Carlisle United",4,46,71,69,68,1,1.54347826086957,1.5,1.47826086956522,0.0217391304347826,73,5,24,92,78,84,-5,NA
2016,"Charlton Athletic",3,46,60,60,53,7,1.30434782608696,1.30434782608696,1.15217391304348,0.152173913043478,57,13,24,68,50,92,7,NA
2016,"Chelsea",1,38,93,85,33,52,2.44736842105263,2.23684210526316,0.868421052631579,1.36842105263158,1,1,20,20,5,104,-4,NA
2016,"Cheltenham",4,46,50,49,69,-20,1.08695652173913,1.06521739130435,1.5,-0.434782608695652,88,20,24,92,85,20,3,NA
2016,"Chesterfield",3,46,37,43,78,-35,0.804347826086957,0.934782608695652,1.69565217391304,-0.760869565217391,68,24,24,68,92,100,-24,NA
2016,"Colchester United",4,46,69,67,57,10,1.5,1.45652173913043,1.23913043478261,0.217391304347826,76,8,24,92,81,68,-5,NA
2016,"Coventry City",3,46,39,37,68,-31,0.847826086956522,0.804347826086957,1.47826086956522,-0.673913043478261,67,23,24,68,74,94,-7,NA
2016,"Crawley Town",4,46,51,53,71,-18,1.10869565217391,1.15217391304348,1.54347826086957,-0.391304347826087,87,19,24,92,82,9,5,NA
2016,"Crewe Alexandra",4,46,55,58,67,-9,1.19565217391304,1.26086956521739,1.45652173913043,-0.195652173913043,85,17,24,92,83,96,2,NA
2016,"Crystal Palace",1,38,41,50,63,-13,1.07894736842105,1.31578947368421,1.65789473684211,-0.342105263157895,14,14,20,20,11,93,3,NA
2016,"Derby County",2,46,67,54,50,4,1.45652173913043,1.17391304347826,1.08695652173913,0.0869565217391304,29,9,24,44,26,121,3,NA
2016,"Doncaster Rovers",4,46,85,85,55,30,1.84782608695652,1.84782608695652,1.19565217391304,0.652173913043478,71,3,24,92,59,88,12,NA
2016,"Everton",1,38,61,62,44,18,1.60526315789474,1.63157894736842,1.15789473684211,0.473684210526316,7,7,20,20,8,121,-1,NA
2016,"Exeter City",4,46,71,75,56,19,1.54347826086957,1.6304347826087,1.21739130434783,0.41304347826087,74,6,24,92,72,88,2,NA
2016,"Fleetwood Town",3,46,82,64,43,21,1.78260869565217,1.39130434782609,0.934782608695652,0.456521739130435,47,3,24,68,58,8,-11,NA
2016,"Fulham",2,46,80,85,57,28,1.73913043478261,1.84782608695652,1.23913043478261,0.608695652173913,26,6,24,44,23,102,3,NA
2016,"Gillingham",3,46,50,59,79,-20,1.08695652173913,1.28260869565217,1.71739130434783,-0.434782608695652,64,20,24,68,60,88,4,NA
2016,"Grimsby Town",4,46,62,59,63,-4,1.34782608695652,1.28260869565217,1.3695652173913,-0.0869565217391304,82,14,24,92,86,110,-4,NA
2016,"Hartlepool United",4,46,46,54,75,-21,1,1.17391304347826,1.6304347826087,-0.456521739130435,91,23,24,92,NA,89,NA,NA
2016,"Huddersfield Town",2,46,81,56,58,-2,1.76086956521739,1.21739130434783,1.26086956521739,-0.0434782608695652,24,4,24,44,16,99,8,NA
2016,"Hull City",1,38,34,37,80,-43,0.894736842105263,0.973684210526316,2.10526315789474,-1.13157894736842,18,18,20,20,38,104,-20,NA
2016,"Ipswich Town",2,46,55,48,58,-10,1.19565217391304,1.04347826086957,1.26086956521739,-0.217391304347826,36,16,24,44,32,75,4,NA
2016,"Leeds United",2,46,75,61,47,14,1.6304347826087,1.32608695652174,1.02173913043478,0.304347826086957,27,7,24,44,33,93,-6,NA
2016,"Leicester City",1,38,44,48,63,-15,1.15789473684211,1.26315789473684,1.65789473684211,-0.394736842105263,12,12,20,20,9,115,3,NA
2016,"Leyton Orient",4,46,36,47,87,-40,0.782608695652174,1.02173913043478,1.89130434782609,-0.869565217391304,92,24,24,92,84,102,8,NA
2016,"Liverpool",1,38,76,78,42,36,2,2.05263157894737,1.10526315789474,0.947368421052632,4,4,20,20,4,116,0,NA
2016,"Luton Town",4,46,77,70,43,27,1.67391304347826,1.52173913043478,0.934782608695652,0.58695652173913,72,4,24,92,70,91,2,NA
2016,"Manchester City",1,38,78,80,39,41,2.05263157894737,2.10526315789474,1.02631578947368,1.07894736842105,3,3,20,20,1,117,2,NA
2016,"Manchester United",1,38,69,54,29,25,1.81578947368421,1.42105263157895,0.763157894736842,0.657894736842105,6,6,20,20,2,117,4,NA
2016,"Mansfield Town",4,46,66,54,50,4,1.43478260869565,1.17391304347826,1.08695652173913,0.0869565217391304,80,12,24,92,76,77,4,NA
2016,"Middlesbrough",1,38,28,27,53,-26,0.736842105263158,0.710526315789474,1.39473684210526,-0.684210526315789,19,19,20,20,25,110,-6,NA
2016,"Millwall",3,46,73,66,57,9,1.58695652173913,1.43478260869565,1.23913043478261,0.195652173913043,50,6,24,68,28,93,22,NA
2016,"Milton Keynes Dons",3,46,61,60,58,2,1.32608695652174,1.30434782608696,1.26086956521739,0.0434782608695652,56,12,24,68,67,16,-11,NA
2016,"Morecambe",4,46,52,53,73,-20,1.1304347826087,1.15217391304348,1.58695652173913,-0.434782608695652,86,18,24,92,91,13,-5,NA
2016,"Newcastle United",2,46,94,85,40,45,2.04347826086957,1.84782608695652,0.869565217391304,0.978260869565217,21,1,24,44,12,116,9,NA
2016,"Newport County",4,46,48,51,73,-22,1.04347826086957,1.10869565217391,1.58695652173913,-0.478260869565217,90,22,24,92,80,67,10,NA
2016,"Northampton Town",3,46,53,60,73,-13,1.15217391304348,1.30434782608696,1.58695652173913,-0.282608695652174,60,16,24,68,66,93,-6,NA
2016,"Norwich City",2,46,70,85,69,16,1.52173913043478,1.84782608695652,1.5,0.347826086956522,28,8,24,44,34,93,-6,NA
2016,"Nottingham Forest",2,46,51,62,72,-10,1.10869565217391,1.34782608695652,1.56521739130435,-0.217391304347826,42,22,24,44,37,117,5,NA
2016,"Notts County",4,46,56,54,76,-22,1.21739130434783,1.17391304347826,1.65217391304348,-0.478260869565217,84,16,24,92,73,120,11,NA
2016,"Oldham Athletic",3,46,53,31,44,-13,1.15217391304348,0.673913043478261,0.956521739130435,-0.282608695652174,61,17,24,68,65,102,-4,NA
2016,"Oxford United",3,46,69,65,52,13,1.5,1.41304347826087,1.1304347826087,0.282608695652174,52,8,24,68,61,54,-9,NA
2016,"Peterborough United",3,46,62,62,62,0,1.34782608695652,1.34782608695652,1.34782608695652,0,55,11,24,68,53,60,2,NA
2016,"Plymouth Argyle",4,46,87,71,46,25,1.89130434782609,1.54347826086957,1,0.543478260869565,69,1,24,92,51,93,18,NA
2016,"Port Vale",3,46,49,45,70,-25,1.06521739130435,0.978260869565217,1.52173913043478,-0.543478260869565,65,21,24,68,89,107,-24,NA
2016,"Portsmouth",4,46,87,79,40,39,1.89130434782609,1.71739130434783,0.869565217391304,0.847826086956522,70,2,24,92,52,93,18,NA
2016,"Preston North End",2,46,62,64,63,1,1.34782608695652,1.39130434782609,1.3695652173913,0.0217391304347826,33,13,24,44,27,121,6,NA
2016,"Queens Park Rangers",2,46,53,52,66,-14,1.15217391304348,1.1304347826087,1.43478260869565,-0.304347826086957,39,19,24,44,36,93,3,NA
2016,"Reading",2,46,85,68,64,4,1.84782608695652,1.47826086956522,1.39130434782609,0.0869565217391304,23,3,24,44,40,93,-17,NA
2016,"Rochdale",3,46,69,71,62,9,1.5,1.54347826086957,1.34782608695652,0.195652173913043,53,9,24,68,64,92,-11,NA
2016,"Rotherham United",2,46,23,40,98,-58,0.5,0.869565217391304,2.1304347826087,-1.26086956521739,44,24,24,44,48,88,-4,NA
2016,"Scunthorpe United",3,46,82,80,54,26,1.78260869565217,1.73913043478261,1.17391304347826,0.565217391304348,48,4,24,68,49,70,-1,NA
2016,"Sheffield United",3,46,100,92,47,45,2.17391304347826,2,1.02173913043478,0.978260869565217,45,1,24,68,30,117,15,NA
2016,"Sheffield Wednesday",2,46,81,60,45,15,1.76086956521739,1.30434782608696,0.978260869565217,0.326086956521739,25,5,24,44,35,117,-10,NA
2016,"Shrewsbury Town",3,46,51,46,63,-17,1.10869565217391,1,1.3695652173913,-0.369565217391304,62,18,24,68,47,69,15,NA
2016,"Southampton",1,38,46,41,48,-7,1.21052631578947,1.07894736842105,1.26315789473684,-0.184210526315789,9,9,20,20,17,93,-8,NA
2016,"Southend United",3,46,72,70,53,17,1.56521739130435,1.52173913043478,1.15217391304348,0.369565217391304,51,7,24,68,55,93,-4,NA
2016,"Stevenage Borough",4,46,67,67,63,4,1.45652173913043,1.45652173913043,1.3695652173913,0.0869565217391304,78,10,24,92,84,10,-6,NA
2016,"Stoke City",1,38,44,41,56,-15,1.15789473684211,1.07894736842105,1.47368421052632,-0.394736842105263,13,13,20,20,18,113,-5,NA
2016,"Sunderland",1,38,24,29,69,-40,0.631578947368421,0.763157894736842,1.81578947368421,-1.05263157894737,20,20,20,20,44,119,-24,NA
2016,"Swansea City",1,38,41,45,70,-25,1.07894736842105,1.18421052631579,1.84210526315789,-0.657894736842105,15,15,20,20,19,93,-4,NA
2016,"Swindon Town",3,46,44,44,66,-22,0.956521739130435,0.956521739130435,1.43478260869565,-0.478260869565217,66,22,24,68,77,93,-11,NA
2016,"Tottenham Hotspur",1,38,86,86,26,60,2.26315789473684,2.26315789473684,0.684210526315789,1.57894736842105,2,2,20,20,3,101,-1,NA
2016,"Walsall",3,46,58,51,58,-7,1.26086956521739,1.10869565217391,1.26086956521739,-0.152173913043478,58,14,24,68,63,100,-5,NA
2016,"Watford",1,38,40,40,68,-28,1.05263157894737,1.05263157894737,1.78947368421053,-0.736842105263158,17,17,20,20,14,93,3,NA
2016,"West Bromwich Albion",1,38,45,43,51,-8,1.18421052631579,1.13157894736842,1.34210526315789,-0.210526315789474,10,10,20,20,20,121,-10,NA
2016,"West Ham United",1,38,45,47,64,-17,1.18421052631579,1.23684210526316,1.68421052631579,-0.447368421052632,11,11,20,20,13,94,-2,NA
2016,"Wigan Athletic",2,46,42,40,57,-17,0.91304347826087,0.869565217391304,1.23913043478261,-0.369565217391304,43,23,24,44,45,42,-2,NA
2016,"Wolverhampton Wanderers",2,46,58,54,58,-4,1.26086956521739,1.17391304347826,1.26086956521739,-0.0869565217391304,35,15,24,44,21,121,14,NA
2016,"Wycombe Wanderers",4,46,69,58,53,5,1.5,1.26086956521739,1.15217391304348,0.108695652173913,77,9,24,92,71,27,6,NA
2016,"Yeovil",4,46,50,49,64,-15,1.08695652173913,1.06521739130435,1.39130434782609,-0.326086956521739,89,21,24,92,87,16,2,NA
2017,"Accrington",4,46,93,76,46,30,2.02173913043478,1.65217391304348,1,0.652173913043478,69,1,24,92,57,14,12,NA
2017,"AFC Bournemouth",1,38,44,45,61,-16,1.15789473684211,1.18421052631579,1.60526315789474,-0.421052631578947,10,10,20,20,13,90,-3,NA
2017,"AFC Wimbledon",3,46,53,47,58,-11,1.15217391304348,1.02173913043478,1.26086956521739,-0.239130434782609,62,18,24,68,63,9,-1,NA
2017,"Arsenal",1,38,63,74,51,23,1.65789473684211,1.94736842105263,1.34210526315789,0.605263157894737,6,6,20,20,5,116,1,NA
2017,"Aston Villa",2,46,83,72,42,30,1.80434782608696,1.56521739130435,0.91304347826087,0.652173913043478,24,4,24,44,25,121,-1,NA
2017,"Barnet",4,46,46,46,65,-19,1,1,1.41304347826087,-0.41304347826087,90,22,24,92,NA,21,NA,NA
2017,"Barnsley",2,46,41,48,72,-24,0.891304347826087,1.04347826086957,1.56521739130435,-0.521739130434783,42,22,24,44,46,111,-4,NA
2017,"Birmingham City",2,46,46,38,68,-30,1,0.826086956521739,1.47826086956522,-0.652173913043478,39,19,24,44,34,117,5,NA
2017,"Blackburn Rovers",3,46,96,82,40,42,2.08695652173913,1.78260869565217,0.869565217391304,0.91304347826087,46,2,24,68,36,121,10,NA
2017,"Blackpool",3,46,60,60,55,5,1.30434782608696,1.30434782608696,1.19565217391304,0.108695652173913,56,12,24,68,54,112,2,NA
2017,"Bolton Wanderers",2,46,43,39,74,-35,0.934782608695652,0.847826086956522,1.60869565217391,-0.760869565217391,41,21,24,44,43,121,-2,NA
2017,"Bradford City",3,46,63,57,67,-10,1.3695652173913,1.23913043478261,1.45652173913043,-0.217391304347826,54,10,24,68,68,106,-14,NA
2017,"Brentford",2,46,69,62,52,10,1.5,1.34782608695652,1.1304347826087,0.217391304347826,29,9,24,44,31,93,-2,NA
2017,"Brighton & Hove Albion",1,38,40,34,54,-20,1.05263157894737,0.894736842105263,1.42105263157895,-0.526315789473684,15,15,20,20,17,93,-2,NA
2017,"Bristol City",2,46,67,67,58,9,1.45652173913043,1.45652173913043,1.26086956521739,0.195652173913043,31,11,24,44,28,108,3,NA
2017,"Bristol Rovers",3,46,59,60,66,-6,1.28260869565217,1.30434782608696,1.43478260869565,-0.130434782608696,57,13,24,68,59,92,-2,NA
2017,"Burnley",1,38,54,36,39,-3,1.42105263157895,0.947368421052632,1.02631578947368,-0.0789473684210526,7,7,20,20,15,121,-8,NA
2017,"Burton Albion",2,46,41,38,81,-43,0.891304347826087,0.826086956521739,1.76086956521739,-0.934782608695652,43,23,24,44,53,11,-10,NA
2017,"Bury",3,46,36,41,71,-30,0.782608695652174,0.891304347826087,1.54347826086957,-0.652173913043478,68,24,24,68,70,114,-2,NA
2017,"Cambridge United",4,46,64,56,60,-4,1.39130434782609,1.21739130434783,1.30434782608696,-0.0869565217391304,79,11,24,92,89,41,-10,NA
2017,"Cardiff City",2,46,90,69,39,30,1.95652173913043,1.5,0.847826086956522,0.652173913043478,22,2,24,44,18,93,4,NA
2017,"Carlisle United",4,46,67,62,54,8,1.45652173913043,1.34782608695652,1.17391304347826,0.173913043478261,78,10,24,92,79,84,-1,NA
2017,"Charlton Athletic",3,46,71,58,51,7,1.54347826086957,1.26086956521739,1.10869565217391,0.152173913043478,50,6,24,68,47,92,3,NA
2017,"Chelsea",1,38,70,62,38,24,1.84210526315789,1.63157894736842,1,0.631578947368421,5,5,20,20,3,104,2,NA
2017,"Cheltenham",4,46,51,67,73,-6,1.10869565217391,1.45652173913043,1.58695652173913,-0.130434782608696,85,17,24,92,84,20,1,NA
2017,"Chesterfield",4,46,38,47,83,-36,0.826086956521739,1.02173913043478,1.80434782608696,-0.782608695652174,92,24,24,92,NA,100,NA,NA
2017,"Colchester United",4,46,62,53,52,1,1.34782608695652,1.15217391304348,1.1304347826087,0.0217391304347826,81,13,24,92,76,68,5,NA
2017,"Coventry City",4,46,75,64,47,17,1.6304347826087,1.39130434782609,1.02173913043478,0.369565217391304,74,6,24,92,52,94,22,NA
2017,"Crawley Town",4,46,59,58,66,-8,1.28260869565217,1.26086956521739,1.43478260869565,-0.173913043478261,82,14,24,92,87,9,-5,NA
2017,"Crewe Alexandra",4,46,56,62,75,-13,1.21739130434783,1.34782608695652,1.6304347826087,-0.282608695652174,83,15,24,92,80,96,3,NA
2017,"Crystal Palace",1,38,44,45,55,-10,1.15789473684211,1.18421052631579,1.44736842105263,-0.263157894736842,11,11,20,20,12,93,-1,NA
2017,"Derby County",2,46,75,70,48,22,1.6304347826087,1.52173913043478,1.04347826086957,0.478260869565217,26,6,24,44,26,121,0,NA
2017,"Doncaster Rovers",3,46,56,52,52,0,1.21739130434783,1.1304347826087,1.1304347826087,0,59,15,24,68,50,88,9,NA
2017,"Everton",1,38,49,44,58,-14,1.28947368421053,1.15789473684211,1.52631578947368,-0.368421052631579,8,8,20,20,8,121,0,NA
2017,"Exeter City",4,46,80,64,54,10,1.73913043478261,1.39130434782609,1.17391304347826,0.217391304347826,72,4,24,92,77,88,-5,NA
2017,"Fleetwood Town",3,46,57,59,68,-9,1.23913043478261,1.28260869565217,1.47826086956522,-0.195652173913043,58,14,24,68,55,8,3,NA
2017,"Forest Green Rovers",4,46,47,54,77,-23,1.02173913043478,1.17391304347826,1.67391304347826,-0.5,88,20,24,92,73,3,15,NA
2017,"Fulham",2,46,88,79,46,33,1.91304347826087,1.71739130434783,1,0.717391304347826,23,3,24,44,19,102,4,NA
2017,"Gillingham",3,46,56,50,55,-5,1.21739130434783,1.08695652173913,1.19565217391304,-0.108695652173913,60,16,24,68,58,88,2,NA
2017,"Grimsby Town",4,46,51,42,66,-24,1.10869565217391,0.91304347826087,1.43478260869565,-0.521739130434783,86,18,24,92,85,110,1,NA
2017,"Huddersfield Town",1,38,37,28,58,-30,0.973684210526316,0.736842105263158,1.52631578947368,-0.789473684210526,16,16,20,20,20,99,-4,NA
2017,"Hull City",2,46,49,70,70,0,1.06521739130435,1.52173913043478,1.52173913043478,0,38,18,24,44,33,104,5,NA
2017,"Ipswich Town",2,46,60,57,60,-3,1.30434782608696,1.23913043478261,1.30434782608696,-0.0652173913043478,32,12,24,44,44,75,-12,NA
2017,"Leeds United",2,46,60,59,64,-5,1.30434782608696,1.28260869565217,1.39130434782609,-0.108695652173913,33,13,24,44,23,93,10,NA
2017,"Leicester City",1,38,47,56,60,-4,1.23684210526316,1.47368421052632,1.57894736842105,-0.105263157894737,9,9,20,20,9,115,0,NA
2017,"Lincoln City",4,46,75,64,48,16,1.6304347826087,1.39130434782609,1.04347826086957,0.347826086956522,75,7,24,92,69,107,6,NA
2017,"Liverpool",1,38,75,84,38,46,1.97368421052632,2.21052631578947,1,1.21052631578947,4,4,20,20,2,116,2,NA
2017,"Luton Town",4,46,88,94,46,48,1.91304347826087,2.04347826086957,1,1.04347826086957,70,2,24,92,45,91,25,NA
2017,"Manchester City",1,38,100,106,27,79,2.63157894736842,2.78947368421053,0.710526315789474,2.07894736842105,1,1,20,20,1,117,0,NA
2017,"Manchester United",1,38,81,68,28,40,2.13157894736842,1.78947368421053,0.736842105263158,1.05263157894737,2,2,20,20,6,117,-4,NA
2017,"Mansfield Town",4,46,72,67,52,15,1.56521739130435,1.45652173913043,1.1304347826087,0.326086956521739,76,8,24,92,72,77,4,NA
2017,"Middlesbrough",2,46,76,67,45,22,1.65217391304348,1.45652173913043,0.978260869565217,0.478260869565217,25,5,24,44,27,110,-2,NA
2017,"Millwall",2,46,72,56,45,11,1.56521739130435,1.21739130434783,0.978260869565217,0.239130434782609,28,8,24,44,41,93,-13,NA
2017,"Milton Keynes Dons",3,46,45,43,69,-26,0.978260869565217,0.934782608695652,1.5,-0.565217391304348,67,23,24,68,71,16,-4,NA
2017,"Morecambe",4,46,46,41,56,-15,1,0.891304347826087,1.21739130434783,-0.326086956521739,91,23,24,92,86,13,5,NA
2017,"Newcastle United",1,38,44,39,47,-8,1.15789473684211,1.02631578947368,1.23684210526316,-0.210526315789474,12,12,20,20,14,116,-2,NA
2017,"Newport County",4,46,64,56,58,-2,1.39130434782609,1.21739130434783,1.26086956521739,-0.0434782608695652,80,12,24,92,75,67,5,NA
2017,"Northampton Town",3,46,47,43,77,-34,1.02173913043478,0.934782608695652,1.67391304347826,-0.739130434782609,66,22,24,68,83,93,-17,NA
2017,"Norwich City",2,46,60,49,60,-11,1.30434782608696,1.06521739130435,1.30434782608696,-0.239130434782609,34,14,24,44,21,93,13,NA
2017,"Nottingham Forest",2,46,53,51,65,-14,1.15217391304348,1.10869565217391,1.41304347826087,-0.304347826086957,37,17,24,44,29,117,8,NA
2017,"Notts County",4,46,77,71,48,23,1.67391304347826,1.54347826086957,1.04347826086957,0.5,73,5,24,92,91,120,-18,NA
2017,"Oldham Athletic",3,46,50,58,75,-17,1.08695652173913,1.26086956521739,1.6304347826087,-0.369565217391304,65,21,24,68,82,102,-17,NA
2017,"Oxford United",3,46,56,61,66,-5,1.21739130434783,1.32608695652174,1.43478260869565,-0.108695652173913,61,17,24,68,56,54,5,NA
2017,"Peterborough United",3,46,64,68,60,8,1.39130434782609,1.47826086956522,1.30434782608696,0.173913043478261,53,9,24,68,51,60,2,NA
2017,"Plymouth Argyle",3,46,68,58,59,-1,1.47826086956522,1.26086956521739,1.28260869565217,-0.0217391304347826,51,7,24,68,64,93,-13,NA
2017,"Port Vale",4,46,47,49,67,-18,1.02173913043478,1.06521739130435,1.45652173913043,-0.391304347826087,89,21,24,92,88,107,1,NA
2017,"Portsmouth",3,46,66,57,56,1,1.43478260869565,1.23913043478261,1.21739130434783,0.0217391304347826,52,8,24,68,48,93,4,NA
2017,"Preston North End",2,46,73,57,46,11,1.58695652173913,1.23913043478261,1,0.239130434782609,27,7,24,44,35,121,-8,NA
2017,"Queens Park Rangers",2,46,56,58,70,-12,1.21739130434783,1.26086956521739,1.52173913043478,-0.260869565217391,36,16,24,44,39,93,-3,NA
2017,"Reading",2,46,44,48,70,-22,0.956521739130435,1.04347826086957,1.52173913043478,-0.478260869565217,40,20,24,44,40,93,0,NA
2017,"Rochdale",3,46,51,49,57,-8,1.10869565217391,1.06521739130435,1.23913043478261,-0.173913043478261,64,20,24,68,60,92,4,NA
2017,"Rotherham United",3,46,79,73,53,20,1.71739130434783,1.58695652173913,1.15217391304348,0.434782608695652,48,4,24,68,42,88,6,NA
2017,"Scunthorpe United",3,46,74,65,50,15,1.60869565217391,1.41304347826087,1.08695652173913,0.326086956521739,49,5,24,68,67,70,-18,NA
2017,"Sheffield United",2,46,69,62,55,7,1.5,1.34782608695652,1.19565217391304,0.152173913043478,30,10,24,44,22,117,8,NA
2017,"Sheffield Wednesday",2,46,57,59,60,-1,1.23913043478261,1.28260869565217,1.30434782608696,-0.0217391304347826,35,15,24,44,32,117,3,NA
2017,"Shrewsbury Town",3,46,87,60,39,21,1.89130434782609,1.30434782608696,0.847826086956522,0.456521739130435,47,3,24,68,62,69,-15,NA
2017,"Southampton",1,38,36,37,56,-19,0.947368421052632,0.973684210526316,1.47368421052632,-0.5,17,17,20,20,16,93,1,NA
2017,"Southend United",3,46,63,58,62,-4,1.3695652173913,1.26086956521739,1.34782608695652,-0.0869565217391304,55,11,24,68,65,93,-10,NA
2017,"Stevenage Borough",4,46,55,60,65,-5,1.19565217391304,1.30434782608696,1.41304347826087,-0.108695652173913,84,16,24,92,78,10,6,NA
2017,"Stoke City",1,38,33,35,68,-33,0.868421052631579,0.921052631578947,1.78947368421053,-0.868421052631579,18,18,20,20,37,113,-19,NA
2017,"Sunderland",2,46,37,52,80,-28,0.804347826086957,1.1304347826087,1.73913043478261,-0.608695652173913,44,24,24,44,49,119,-5,NA
2017,"Swansea City",1,38,33,28,56,-28,0.868421052631579,0.736842105263158,1.47368421052632,-0.736842105263158,19,19,20,20,30,93,-11,NA
2017,"Swindon Town",4,46,68,67,65,2,1.47826086956522,1.45652173913043,1.41304347826087,0.0434782608695652,77,9,24,92,81,93,-4,NA
2017,"Tottenham Hotspur",1,38,77,74,36,38,2.02631578947368,1.94736842105263,0.947368421052632,1,3,3,20,20,4,101,-1,NA
2017,"Walsall",3,46,52,53,66,-13,1.1304347826087,1.15217391304348,1.43478260869565,-0.282608695652174,63,19,24,68,66,100,-3,NA
2017,"Watford",1,38,41,44,64,-20,1.07894736842105,1.15789473684211,1.68421052631579,-0.526315789473684,14,14,20,20,11,93,3,NA
2017,"West Bromwich Albion",1,38,31,31,56,-25,0.815789473684211,0.815789473684211,1.47368421052632,-0.657894736842105,20,20,20,20,24,121,-4,NA
2017,"West Ham United",1,38,42,48,68,-20,1.10526315789474,1.26315789473684,1.78947368421053,-0.526315789473684,13,13,20,20,10,94,3,NA
2017,"Wigan Athletic",3,46,98,89,29,60,2.1304347826087,1.93478260869565,0.630434782608696,1.30434782608696,45,1,24,68,38,42,7,NA
2017,"Wolverhampton Wanderers",2,46,99,82,39,43,2.15217391304348,1.78260869565217,0.847826086956522,0.934782608695652,21,1,24,44,7,121,14,NA
2017,"Wycombe Wanderers",4,46,84,79,60,19,1.82608695652174,1.71739130434783,1.30434782608696,0.41304347826087,71,3,24,92,61,27,10,NA
2017,"Yeovil",4,46,48,59,75,-16,1.04347826086957,1.28260869565217,1.6304347826087,-0.347826086956522,87,19,24,92,92,16,-5,NA
2018,"Accrington",3,46,55,51,67,-16,1.19565217391304,1.10869565217391,1.45652173913043,-0.347826086956522,57,13,24,68,63,14,-6,NA
2018,"AFC Bournemouth",1,38,45,56,70,-14,1.18421052631579,1.47368421052632,1.84210526315789,-0.368421052631579,13,13,20,20,7,90,6,NA
2018,"AFC Wimbledon",3,46,50,42,63,-21,1.08695652173913,0.91304347826087,1.3695652173913,-0.456521739130435,63,19,24,68,64,9,-1,NA
2018,"Arsenal",1,38,70,73,51,22,1.84210526315789,1.92105263157895,1.34210526315789,0.578947368421053,5,5,20,20,5,116,0,NA
2018,"Aston Villa",2,46,76,82,61,21,1.65217391304348,1.78260869565217,1.32608695652174,0.456521739130435,25,5,24,44,17,121,8,NA
2018,"Barnsley",3,46,91,80,39,41,1.97826086956522,1.73913043478261,0.847826086956522,0.891304347826087,46,2,24,68,44,111,2,NA
2018,"Birmingham City",2,46,61,64,58,6,1.32608695652174,1.39130434782609,1.26086956521739,0.130434782608696,34,14,24,44,31,117,3,NA
2018,"Blackburn Rovers",2,46,60,64,69,-5,1.30434782608696,1.39130434782609,1.5,-0.108695652173913,36,16,24,44,37,121,-1,NA
2018,"Blackpool",3,46,62,50,52,-2,1.34782608695652,1.08695652173913,1.1304347826087,-0.0434782608695652,54,10,24,68,48,112,6,NA
2018,"Bolton Wanderers",2,46,32,29,78,-49,0.695652173913043,0.630434782608696,1.69565217391304,-1.06521739130435,43,23,24,44,65,121,-22,NA
2018,"Bradford City",3,46,41,49,77,-28,0.891304347826087,1.06521739130435,1.67391304347826,-0.608695652173913,68,24,24,68,70,106,-2,NA
2018,"Brentford",2,46,64,73,59,14,1.39130434782609,1.58695652173913,1.28260869565217,0.304347826086957,31,11,24,44,29,93,2,NA
2018,"Brighton & Hove Albion",1,38,36,35,60,-25,0.947368421052632,0.921052631578947,1.57894736842105,-0.657894736842105,17,17,20,20,10,93,7,NA
2018,"Bristol City",2,46,70,59,53,6,1.52173913043478,1.28260869565217,1.15217391304348,0.130434782608696,28,8,24,44,25,108,3,NA
2018,"Bristol Rovers",3,46,54,47,50,-3,1.17391304347826,1.02173913043478,1.08695652173913,-0.0652173913043478,59,15,24,68,53,92,6,NA
2018,"Burnley",1,38,40,45,68,-23,1.05263157894737,1.18421052631579,1.78947368421053,-0.605263157894737,15,15,20,20,11,121,4,NA
2018,"Burton Albion",3,46,63,66,57,9,1.3695652173913,1.43478260869565,1.23913043478261,0.195652173913043,53,9,24,68,59,11,-6,NA
2018,"Bury",4,46,79,82,56,26,1.71739130434783,1.78260869565217,1.21739130434783,0.565217391304348,70,2,24,92,NA,114,NA,NA
2018,"Cambridge United",4,46,47,40,66,-26,1.02173913043478,0.869565217391304,1.43478260869565,-0.565217391304348,89,21,24,92,80,41,9,NA
2018,"Cardiff City",1,38,34,34,69,-35,0.894736842105263,0.894736842105263,1.81578947368421,-0.921052631578947,18,18,20,20,34,93,-16,NA
2018,"Carlisle United",4,46,68,67,62,5,1.47826086956522,1.45652173913043,1.34782608695652,0.108695652173913,79,11,24,92,86,84,-7,NA
2018,"Charlton Athletic",3,46,88,73,40,33,1.91304347826087,1.58695652173913,0.869565217391304,0.717391304347826,47,3,24,68,32,92,15,NA
2018,"Chelsea",1,38,72,63,39,24,1.89473684210526,1.65789473684211,1.02631578947368,0.631578947368421,3,3,20,20,2,104,1,NA
2018,"Cheltenham",4,46,57,57,68,-11,1.23913043478261,1.23913043478261,1.47826086956522,-0.239130434782609,84,16,24,92,73,20,11,NA
2018,"Colchester United",4,46,70,65,53,12,1.52173913043478,1.41304347826087,1.15217391304348,0.260869565217391,76,8,24,92,77,68,-1,NA
2018,"Coventry City",3,46,65,54,54,0,1.41304347826087,1.17391304347826,1.17391304347826,0,52,8,24,68,47,94,5,NA
2018,"Crawley Town",4,46,53,51,68,-17,1.15217391304348,1.10869565217391,1.47826086956522,-0.369565217391304,87,19,24,92,81,9,6,NA
2018,"Crewe Alexandra",4,46,65,60,59,1,1.41304347826087,1.30434782608696,1.28260869565217,0.0217391304347826,80,12,24,92,71,96,9,NA
2018,"Crystal Palace",1,38,49,51,53,-2,1.28947368421053,1.34210526315789,1.39473684210526,-0.0526315789473684,12,12,20,20,12,93,0,NA
2018,"Derby County",2,46,74,69,54,15,1.60869565217391,1.5,1.17391304347826,0.326086956521739,26,6,24,44,35,121,-9,NA
2018,"Doncaster Rovers",3,46,73,76,58,18,1.58695652173913,1.65217391304348,1.26086956521739,0.391304347826087,50,6,24,68,56,88,-6,NA
2018,"Everton",1,38,54,54,46,8,1.42105263157895,1.42105263157895,1.21052631578947,0.210526315789474,8,8,20,20,14,121,-6,NA
2018,"Exeter City",4,46,70,60,49,11,1.52173913043478,1.30434782608696,1.06521739130435,0.239130434782609,77,9,24,92,72,88,5,NA
2018,"Fleetwood Town",3,46,61,58,52,6,1.32608695652174,1.26086956521739,1.1304347826087,0.130434782608696,55,11,24,68,51,8,4,NA
2018,"Forest Green Rovers",4,46,74,68,47,21,1.60869565217391,1.47826086956522,1.02173913043478,0.456521739130435,73,5,24,92,69,3,4,NA
2018,"Fulham",1,38,26,34,81,-47,0.684210526315789,0.894736842105263,2.13157894736842,-1.23684210526316,19,19,20,20,27,102,-8,NA
2018,"Gillingham",3,46,55,61,72,-11,1.19565217391304,1.32608695652174,1.56521739130435,-0.239130434782609,58,14,24,68,57,88,1,NA
2018,"Grimsby Town",4,46,56,45,56,-11,1.21739130434783,0.978260869565217,1.21739130434783,-0.239130434782609,85,17,24,92,85,110,0,NA
2018,"Huddersfield Town",1,38,16,22,76,-54,0.421052631578947,0.578947368421053,2,-1.42105263157895,20,20,20,20,39,99,-19,NA
2018,"Hull City",2,46,62,66,68,-2,1.34782608695652,1.43478260869565,1.47826086956522,-0.0434782608695652,33,13,24,44,33,104,0,NA
2018,"Ipswich Town",2,46,31,36,77,-41,0.673913043478261,0.782608695652174,1.67391304347826,-0.891304347826087,44,24,24,44,46,75,-2,NA
2018,"Leeds United",2,46,83,73,50,23,1.80434782608696,1.58695652173913,1.08695652173913,0.5,23,3,24,44,22,93,1,NA
2018,"Leicester City",1,38,52,51,48,3,1.36842105263158,1.34210526315789,1.26315789473684,0.0789473684210526,9,9,20,20,3,115,6,NA
2018,"Lincoln City",4,46,85,73,43,30,1.84782608695652,1.58695652173913,0.934782608695652,0.652173913043478,69,1,24,92,61,107,8,NA
2018,"Liverpool",1,38,97,89,22,67,2.55263157894737,2.34210526315789,0.578947368421053,1.76315789473684,2,2,20,20,1,116,1,NA
2018,"Luton Town",3,46,94,90,42,48,2.04347826086957,1.95652173913043,0.91304347826087,1.04347826086957,45,1,24,68,41,91,4,NA
2018,"Macclesfield",4,46,44,48,74,-26,0.956521739130435,1.04347826086957,1.60869565217391,-0.565217391304348,90,22,24,92,82,17,8,NA
2018,"Manchester City",1,38,98,95,23,72,2.57894736842105,2.5,0.605263157894737,1.89473684210526,1,1,20,20,4,117,-3,NA
2018,"Manchester United",1,38,66,65,54,11,1.73684210526316,1.71052631578947,1.42105263157895,0.289473684210526,6,6,20,20,8,117,-2,NA
2018,"Mansfield Town",4,46,76,69,41,28,1.65217391304348,1.5,0.891304347826087,0.608695652173913,72,4,24,92,83,77,-11,NA
2018,"Middlesbrough",2,46,73,49,41,8,1.58695652173913,1.06521739130435,0.891304347826087,0.173913043478261,27,7,24,44,42,110,-15,NA
2018,"Millwall",2,46,44,48,64,-16,0.956521739130435,1.04347826086957,1.39130434782609,-0.347826086956522,41,21,24,44,36,93,5,NA
2018,"Milton Keynes Dons",4,46,79,71,49,22,1.71739130434783,1.54347826086957,1.06521739130435,0.478260869565217,71,3,24,92,66,16,5,NA
2018,"Morecambe",4,46,54,54,70,-16,1.17391304347826,1.17391304347826,1.52173913043478,-0.347826086956522,86,18,24,92,90,13,-4,NA
2018,"Newcastle United",1,38,45,42,48,-6,1.18421052631579,1.10526315789474,1.26315789473684,-0.157894736842105,14,14,20,20,13,116,1,NA
2018,"Newport County",4,46,71,59,59,0,1.54347826086957,1.28260869565217,1.28260869565217,0,75,7,24,92,76,67,-1,NA
2018,"Northampton Town",4,46,61,64,63,1,1.32608695652174,1.39130434782609,1.3695652173913,0.0217391304347826,83,15,24,92,74,93,9,NA
2018,"Norwich City",2,46,94,93,57,36,2.04347826086957,2.02173913043478,1.23913043478261,0.782608695652174,21,1,24,44,20,93,1,NA
2018,"Nottingham Forest",2,46,66,61,54,7,1.43478260869565,1.32608695652174,1.17391304347826,0.152173913043478,29,9,24,44,26,117,3,NA
2018,"Notts County",4,46,41,48,84,-36,0.891304347826087,1.04347826086957,1.82608695652174,-0.782608695652174,91,23,24,92,NA,120,NA,NA
2018,"Oldham Athletic",4,46,62,67,60,7,1.34782608695652,1.45652173913043,1.30434782608696,0.152173913043478,82,14,24,92,89,102,-7,NA
2018,"Oxford United",3,46,60,58,64,-6,1.30434782608696,1.26086956521739,1.39130434782609,-0.130434782608696,56,12,24,68,52,54,4,NA
2018,"Peterborough United",3,46,72,71,62,9,1.56521739130435,1.54347826086957,1.34782608695652,0.195652173913043,51,7,24,68,49,60,2,NA
2018,"Plymouth Argyle",3,46,50,56,80,-24,1.08695652173913,1.21739130434783,1.73913043478261,-0.521739130434783,64,20,24,68,78,93,-14,NA
2018,"Port Vale",4,46,49,39,55,-16,1.06521739130435,0.847826086956522,1.19565217391304,-0.347826086956522,88,20,24,92,75,107,13,NA
2018,"Portsmouth",3,46,88,83,51,32,1.91304347826087,1.80434782608696,1.10869565217391,0.695652173913043,48,4,24,68,58,93,-10,NA
2018,"Preston North End",2,46,61,67,67,0,1.32608695652174,1.45652173913043,1.45652173913043,0,35,15,24,44,23,121,12,NA
2018,"Queens Park Rangers",2,46,51,53,71,-18,1.10869565217391,1.15217391304348,1.54347826086957,-0.391304347826087,39,19,24,44,30,93,9,NA
2018,"Reading",2,46,47,49,66,-17,1.02173913043478,1.06521739130435,1.43478260869565,-0.369565217391304,40,20,24,44,38,93,2,NA
2018,"Rochdale",3,46,54,54,87,-33,1.17391304347826,1.17391304347826,1.89130434782609,-0.717391304347826,60,16,24,68,60,92,0,NA
2018,"Rotherham United",2,46,40,52,83,-31,0.869565217391304,1.1304347826087,1.80434782608696,-0.673913043478261,42,22,24,44,50,88,-8,NA
2018,"Scunthorpe United",3,46,46,53,83,-30,1,1.15217391304348,1.80434782608696,-0.652173913043478,67,23,24,68,87,70,-20,NA
2018,"Sheffield United",2,46,89,78,41,37,1.93478260869565,1.69565217391304,0.891304347826087,0.804347826086957,22,2,24,44,6,117,16,NA
2018,"Sheffield Wednesday",2,46,64,60,62,-2,1.39130434782609,1.30434782608696,1.34782608695652,-0.0434782608695652,32,12,24,44,28,117,4,NA
2018,"Shrewsbury Town",3,46,52,51,59,-8,1.1304347826087,1.10869565217391,1.28260869565217,-0.173913043478261,62,18,24,68,55,69,7,NA
2018,"Southampton",1,38,39,45,65,-20,1.02631578947368,1.18421052631579,1.71052631578947,-0.526315789473684,16,16,20,20,18,93,-2,NA
2018,"Southend United",3,46,50,55,68,-13,1.08695652173913,1.19565217391304,1.47826086956522,-0.282608695652174,65,21,24,68,67,93,-2,NA
2018,"Stevenage Borough",4,46,70,59,55,4,1.52173913043478,1.28260869565217,1.19565217391304,0.0869565217391304,78,10,24,92,91,10,-13,NA
2018,"Stoke City",2,46,55,45,52,-7,1.19565217391304,0.978260869565217,1.1304347826087,-0.152173913043478,37,17,24,44,43,113,-6,NA
2018,"Sunderland",3,46,85,80,47,33,1.84782608695652,1.73913043478261,1.02173913043478,0.717391304347826,49,5,24,68,54,119,-5,NA
2018,"Swansea City",2,46,65,65,62,3,1.41304347826087,1.41304347826087,1.34782608695652,0.0652173913043478,30,10,24,44,24,93,6,NA
2018,"Swindon Town",4,46,64,59,56,3,1.39130434782609,1.28260869565217,1.21739130434783,0.0652173913043478,81,13,24,92,68,93,13,NA
2018,"Tottenham Hotspur",1,38,71,67,39,28,1.86842105263158,1.76315789473684,1.02631578947368,0.736842105263158,4,4,20,20,15,101,-11,NA
2018,"Tranmere Rovers",4,46,73,63,50,13,1.58695652173913,1.3695652173913,1.08695652173913,0.282608695652174,74,6,24,92,62,89,12,NA
2018,"Walsall",3,46,47,49,71,-22,1.02173913043478,1.06521739130435,1.54347826086957,-0.478260869565217,66,22,24,68,88,100,-22,NA
2018,"Watford",1,38,50,52,59,-7,1.31578947368421,1.36842105263158,1.55263157894737,-0.184210526315789,11,11,20,20,19,93,-8,NA
2018,"West Bromwich Albion",2,46,80,87,62,25,1.73913043478261,1.89130434782609,1.34782608695652,0.543478260869565,24,4,24,44,21,121,3,NA
2018,"West Ham United",1,38,52,52,55,-3,1.36842105263158,1.36842105263158,1.44736842105263,-0.0789473684210526,10,10,20,20,16,94,-6,NA
2018,"Wigan Athletic",2,46,52,51,64,-13,1.1304347826087,1.10869565217391,1.39130434782609,-0.282608695652174,38,18,24,44,40,42,-2,NA
2018,"Wolverhampton Wanderers",1,38,57,47,46,1,1.5,1.23684210526316,1.21052631578947,0.0263157894736842,7,7,20,20,9,121,-2,NA
2018,"Wycombe Wanderers",3,46,53,55,67,-12,1.15217391304348,1.19565217391304,1.45652173913043,-0.260869565217391,61,17,24,68,45,27,16,NA
2018,"Yeovil",4,46,40,41,66,-25,0.869565217391304,0.891304347826087,1.43478260869565,-0.543478260869565,92,24,24,92,NA,16,NA,NA
2019,"Accrington",3,17,15,17,27,-10,0.882352941176471,1,1.58823529411765,-0.588235294117647,63,19,23,67,NA,14,NA,NA
2019,"AFC Bournemouth",1,12,16,15,15,0,1.33333333333333,1.25,1.25,0,7,7,20,20,NA,90,NA,NA
2019,"AFC Wimbledon",3,17,13,20,28,-8,0.764705882352941,1.17647058823529,1.64705882352941,-0.470588235294118,64,20,23,67,NA,9,NA,NA
2019,"Arsenal",1,12,17,16,17,-1,1.41666666666667,1.33333333333333,1.41666666666667,-0.0833333333333333,5,5,20,20,NA,116,NA,NA
2019,"Aston Villa",1,12,11,17,20,-3,0.916666666666667,1.41666666666667,1.66666666666667,-0.25,17,17,20,20,NA,121,NA,NA
2019,"Barnsley",2,16,9,16,33,-17,0.5625,1,2.0625,-1.0625,44,24,24,44,NA,111,NA,NA
2019,"Birmingham City",2,16,22,16,21,-5,1.375,1,1.3125,-0.3125,31,11,24,44,NA,117,NA,NA
2019,"Blackburn Rovers",2,16,18,20,24,-4,1.125,1.25,1.5,-0.25,37,17,24,44,NA,121,NA,NA
2019,"Blackpool",3,17,28,24,19,5,1.64705882352941,1.41176470588235,1.11764705882353,0.294117647058824,48,4,23,67,NA,112,NA,NA
2019,"Bolton Wanderers",3,14,13,8,29,-21,0.928571428571429,0.571428571428571,2.07142857142857,-1.5,65,21,23,67,NA,121,NA,NA
2019,"Bradford City",4,16,30,24,15,9,1.875,1.5,0.9375,0.5625,70,3,24,91,NA,106,NA,NA
2019,"Brentford",2,16,24,21,13,8,1.5,1.3125,0.8125,0.5,29,9,24,44,NA,93,NA,NA
2019,"Brighton & Hove Albion",1,12,15,15,17,-2,1.25,1.25,1.41666666666667,-0.166666666666667,10,10,20,20,NA,93,NA,NA
2019,"Bristol City",2,16,28,25,21,4,1.75,1.5625,1.3125,0.25,25,5,24,44,NA,108,NA,NA
2019,"Bristol Rovers",3,16,25,19,19,0,1.5625,1.1875,1.1875,0,53,9,23,67,NA,92,NA,NA
2019,"Burnley",1,12,15,17,18,-1,1.25,1.41666666666667,1.5,-0.0833333333333333,11,11,20,20,NA,121,NA,NA
2019,"Burton Albion",3,14,20,18,15,3,1.42857142857143,1.28571428571429,1.07142857142857,0.214285714285714,59,15,23,67,NA,11,NA,NA
2019,"Cambridge United",4,18,23,23,19,4,1.27777777777778,1.27777777777778,1.05555555555556,0.222222222222222,80,13,24,91,NA,41,NA,NA
2019,"Cardiff City",2,16,21,23,23,0,1.3125,1.4375,1.4375,0,34,14,24,44,NA,93,NA,NA
2019,"Carlisle United",4,18,18,19,31,-12,1,1.05555555555556,1.72222222222222,-0.666666666666667,86,19,24,91,NA,84,NA,NA
2019,"Charlton Athletic",2,16,22,22,19,3,1.375,1.375,1.1875,0.1875,32,12,24,44,NA,92,NA,NA
2019,"Chelsea",1,12,26,27,17,10,2.16666666666667,2.25,1.41666666666667,0.833333333333333,2,2,20,20,NA,104,NA,NA
2019,"Cheltenham",4,16,29,27,14,13,1.8125,1.6875,0.875,0.8125,73,6,24,91,NA,20,NA,NA
2019,"Colchester United",4,17,26,22,16,6,1.52941176470588,1.29411764705882,0.941176470588235,0.352941176470588,77,10,24,91,NA,68,NA,NA
2019,"Coventry City",3,17,29,22,19,3,1.70588235294118,1.29411764705882,1.11764705882353,0.176470588235294,47,3,23,67,NA,94,NA,NA
2019,"Crawley Town",4,18,21,25,30,-5,1.16666666666667,1.38888888888889,1.66666666666667,-0.277777777777778,81,14,24,91,NA,9,NA,NA
2019,"Crewe Alexandra",4,17,30,27,22,5,1.76470588235294,1.58823529411765,1.29411764705882,0.294117647058824,71,4,24,91,NA,96,NA,NA
2019,"Crystal Palace",1,12,15,10,16,-6,1.25,0.833333333333333,1.33333333333333,-0.5,12,12,20,20,NA,93,NA,NA
2019,"Derby County",2,16,21,18,21,-3,1.3125,1.125,1.3125,-0.1875,35,15,24,44,NA,121,NA,NA
2019,"Doncaster Rovers",3,14,23,24,16,8,1.64285714285714,1.71428571428571,1.14285714285714,0.571428571428571,56,12,23,67,NA,88,NA,NA
2019,"Everton",1,12,14,13,18,-5,1.16666666666667,1.08333333333333,1.5,-0.416666666666667,14,14,20,20,NA,121,NA,NA
2019,"Exeter City",4,18,30,23,20,3,1.66666666666667,1.27777777777778,1.11111111111111,0.166666666666667,72,5,24,91,NA,88,NA,NA
2019,"Fleetwood Town",3,15,26,27,19,8,1.73333333333333,1.8,1.26666666666667,0.533333333333333,51,7,23,67,NA,8,NA,NA
2019,"Forest Green Rovers",4,17,31,20,11,9,1.82352941176471,1.17647058823529,0.647058823529412,0.529411764705882,69,2,24,91,NA,3,NA,NA
2019,"Fulham",2,16,26,24,17,7,1.625,1.5,1.0625,0.4375,27,7,24,44,NA,102,NA,NA
2019,"Gillingham",3,17,21,21,20,1,1.23529411764706,1.23529411764706,1.17647058823529,0.0588235294117647,57,13,23,67,NA,88,NA,NA
2019,"Grimsby Town",4,15,19,20,20,0,1.26666666666667,1.33333333333333,1.33333333333333,0,85,18,24,91,NA,110,NA,NA
2019,"Huddersfield Town",2,16,16,18,24,-6,1,1.125,1.5,-0.375,39,19,24,44,NA,99,NA,NA
2019,"Hull City",2,16,22,23,21,2,1.375,1.4375,1.3125,0.125,33,13,24,44,NA,104,NA,NA
2019,"Ipswich Town",3,15,33,25,10,15,2.2,1.66666666666667,0.666666666666667,1,46,2,23,67,NA,75,NA,NA
2019,"Leeds United",2,16,31,21,9,12,1.9375,1.3125,0.5625,0.75,22,2,24,44,NA,93,NA,NA
2019,"Leicester City",1,12,26,29,8,21,2.16666666666667,2.41666666666667,0.666666666666667,1.75,3,3,20,20,NA,115,NA,NA
2019,"Leyton Orient",4,18,20,24,30,-6,1.11111111111111,1.33333333333333,1.66666666666667,-0.333333333333333,84,17,24,91,NA,102,NA,NA
2019,"Lincoln City",3,17,18,18,22,-4,1.05882352941176,1.05882352941176,1.29411764705882,-0.235294117647059,61,17,23,67,NA,107,NA,NA
2019,"Liverpool",1,12,34,28,10,18,2.83333333333333,2.33333333333333,0.833333333333333,1.5,1,1,20,20,NA,116,NA,NA
2019,"Luton Town",2,16,14,22,30,-8,0.875,1.375,1.875,-0.5,41,21,24,44,NA,91,NA,NA
2019,"Macclesfield",4,17,21,17,20,-3,1.23529411764706,1,1.17647058823529,-0.176470588235294,82,15,24,91,NA,17,NA,NA
2019,"Manchester City",1,12,25,35,13,22,2.08333333333333,2.91666666666667,1.08333333333333,1.83333333333333,4,4,20,20,NA,117,NA,NA
2019,"Manchester United",1,12,16,16,12,4,1.33333333333333,1.33333333333333,1,0.333333333333333,8,8,20,20,NA,117,NA,NA
2019,"Mansfield Town",4,18,21,26,25,1,1.16666666666667,1.44444444444444,1.38888888888889,0.0555555555555556,83,16,24,91,NA,77,NA,NA
2019,"Middlesbrough",2,16,13,13,21,-8,0.8125,0.8125,1.3125,-0.5,42,22,24,44,NA,110,NA,NA
2019,"Millwall",2,16,21,19,22,-3,1.3125,1.1875,1.375,-0.1875,36,16,24,44,NA,93,NA,NA
2019,"Milton Keynes Dons",3,17,13,13,26,-13,0.764705882352941,0.764705882352941,1.52941176470588,-0.764705882352941,66,22,23,67,NA,16,NA,NA
2019,"Morecambe",4,18,14,16,30,-14,0.777777777777778,0.888888888888889,1.66666666666667,-0.777777777777778,90,23,24,91,NA,13,NA,NA
2019,"Newcastle United",1,12,15,11,18,-7,1.25,0.916666666666667,1.5,-0.583333333333333,13,13,20,20,NA,116,NA,NA
2019,"Newport County",4,16,27,17,13,4,1.6875,1.0625,0.8125,0.25,76,9,24,91,NA,67,NA,NA
2019,"Northampton Town",4,18,28,26,19,7,1.55555555555556,1.44444444444444,1.05555555555556,0.388888888888889,74,7,24,91,NA,93,NA,NA
2019,"Norwich City",1,12,7,11,28,-17,0.583333333333333,0.916666666666667,2.33333333333333,-1.41666666666667,20,20,20,20,NA,93,NA,NA
2019,"Nottingham Forest",2,15,28,20,13,7,1.86666666666667,1.33333333333333,0.866666666666667,0.466666666666667,26,6,24,44,NA,117,NA,NA
2019,"Oldham Athletic",4,17,16,18,26,-8,0.941176470588235,1.05882352941176,1.52941176470588,-0.470588235294118,89,22,24,91,NA,102,NA,NA
2019,"Oxford United",3,16,26,33,19,14,1.625,2.0625,1.1875,0.875,52,8,23,67,NA,54,NA,NA
2019,"Peterborough United",3,17,28,39,23,16,1.64705882352941,2.29411764705882,1.35294117647059,0.941176470588235,49,5,23,67,NA,60,NA,NA
2019,"Plymouth Argyle",4,17,26,25,20,5,1.52941176470588,1.47058823529412,1.17647058823529,0.294117647058824,78,11,24,91,NA,93,NA,NA
2019,"Port Vale",4,18,28,24,23,1,1.55555555555556,1.33333333333333,1.27777777777778,0.0555555555555556,75,8,24,91,NA,107,NA,NA
2019,"Portsmouth",3,15,21,20,16,4,1.4,1.33333333333333,1.06666666666667,0.266666666666667,58,14,23,67,NA,93,NA,NA
2019,"Preston North End",2,16,31,31,17,14,1.9375,1.9375,1.0625,0.875,23,3,24,44,NA,121,NA,NA
2019,"Queens Park Rangers",2,16,24,26,30,-4,1.5,1.625,1.875,-0.25,30,10,24,44,NA,93,NA,NA
2019,"Reading",2,15,18,19,20,-1,1.2,1.26666666666667,1.33333333333333,-0.0666666666666667,38,18,24,44,NA,93,NA,NA
2019,"Rochdale",3,18,19,21,30,-9,1.05555555555556,1.16666666666667,1.66666666666667,-0.5,60,16,23,67,NA,92,NA,NA
2019,"Rotherham United",3,16,27,25,13,12,1.6875,1.5625,0.8125,0.75,50,6,23,67,NA,88,NA,NA
2019,"Salford City",4,18,24,23,28,-5,1.33333333333333,1.27777777777778,1.55555555555556,-0.277777777777778,79,12,24,91,NA,1,NA,NA
2019,"Scunthorpe United",4,18,18,23,25,-2,1,1.27777777777778,1.38888888888889,-0.111111111111111,87,20,24,91,NA,70,NA,NA
2019,"Sheffield United",1,12,17,13,9,4,1.41666666666667,1.08333333333333,0.75,0.333333333333333,6,6,20,20,NA,117,NA,NA
2019,"Sheffield Wednesday",2,16,25,21,14,7,1.5625,1.3125,0.875,0.4375,28,8,24,44,NA,117,NA,NA
2019,"Shrewsbury Town",3,16,24,13,15,-2,1.5,0.8125,0.9375,-0.125,55,11,23,67,NA,69,NA,NA
2019,"Southampton",1,12,8,11,29,-18,0.666666666666667,0.916666666666667,2.41666666666667,-1.5,18,18,20,20,NA,93,NA,NA
2019,"Southend United",3,17,5,17,48,-31,0.294117647058824,1,2.82352941176471,-1.82352941176471,67,23,23,67,NA,93,NA,NA
2019,"Stevenage Borough",4,17,13,12,21,-9,0.764705882352941,0.705882352941177,1.23529411764706,-0.529411764705882,91,24,24,91,NA,10,NA,NA
2019,"Stoke City",2,16,11,17,29,-12,0.6875,1.0625,1.8125,-0.75,43,23,24,44,NA,113,NA,NA
2019,"Sunderland",3,15,25,22,16,6,1.66666666666667,1.46666666666667,1.06666666666667,0.4,54,10,23,67,NA,119,NA,NA
2019,"Swansea City",2,16,29,22,16,6,1.8125,1.375,1,0.375,24,4,24,44,NA,93,NA,NA
2019,"Swindon Town",4,18,33,31,22,9,1.83333333333333,1.72222222222222,1.22222222222222,0.5,68,1,24,91,NA,93,NA,NA
2019,"Tottenham Hotspur",1,12,14,18,17,1,1.16666666666667,1.5,1.41666666666667,0.0833333333333333,15,15,20,20,NA,101,NA,NA
2019,"Tranmere Rovers",3,16,16,20,30,-10,1,1.25,1.875,-0.625,62,18,23,67,NA,89,NA,NA
2019,"Walsall",4,18,18,14,26,-12,1,0.777777777777778,1.44444444444444,-0.666666666666667,88,21,24,91,NA,100,NA,NA
2019,"Watford",1,12,8,8,23,-15,0.666666666666667,0.666666666666667,1.91666666666667,-1.25,19,19,20,20,NA,93,NA,NA
2019,"West Bromwich Albion",2,16,33,29,17,12,2.0625,1.8125,1.0625,0.75,21,1,24,44,NA,121,NA,NA
2019,"West Ham United",1,12,13,14,20,-6,1.08333333333333,1.16666666666667,1.66666666666667,-0.5,16,16,20,20,NA,94,NA,NA
2019,"Wigan Athletic",2,16,15,13,24,-11,0.9375,0.8125,1.5,-0.6875,40,20,24,44,NA,42,NA,NA
2019,"Wolverhampton Wanderers",1,12,16,16,15,1,1.33333333333333,1.33333333333333,1.25,0.0833333333333333,9,9,20,20,NA,121,NA,NA
2019,"Wycombe Wanderers",3,17,36,27,14,13,2.11764705882353,1.58823529411765,0.823529411764706,0.764705882352941,45,1,23,67,NA,27,NA,NA
